marketPrice,marketPriceDate,averageListPrice,averageListQty,benchmarkTradePrice,mk_price_minus_bmk_price,list_price_minus_bmk_price,benchmarkTradeDate,wineName,region,vintage,importdate,lwin_11,lwin_7
625,03/05/2021,687,10,470,155,217,29/03/2018,"Chateau Batailley 5eme Cru Classe, Pauillac",Bordeaux,2000,04/05/2021,10063222000,1006322
1480,03/05/2021,1618,73,1356,124,262,20/04/2021,"Gaja, Barbaresco",Piedmont,2017,10/05/2021,10996052017,1099605
1110,04/05/2021,1181,12,1204,-94,-23,03/05/2021,"Tignanello, Toscana",Tuscany,2015,10/05/2021,10953912015,1095391
5400,10/08/2021,5709,6,5096,304,613,08/07/2021,"Chateau Angelus Premier Grand Cru Classe B, Saint-Emilion Grand Cru",Bordeaux,2000,11/08/2021,10060452000,1006045
5400,10/08/2021,5709,6,5096,304,613,08/07/2021,"Chateau Angelus Premier Grand Cru Classe B, Saint-Emilion Grand Cru",Bordeaux,2000,11/08/2021,10060452000,1006045
3910,07/05/2021,4793,77,3800,110,993,07/04/2021,"Chateau Margaux Premier Cru Classe, Margaux",Bordeaux,2006,10/05/2021,10127812006,1012781
5400,09/08/2021,5709,6,5096,304,613,08/07/2021,"Chateau Angelus Premier Grand Cru Classe B, Saint-Emilion Grand Cru",Bordeaux,2000,10/08/2021,10060452000,1006045
3700,07/05/2021,4213,150,3700,0,513,06/05/2021,"Chateau Margaux Premier Cru Classe, Margaux",Bordeaux,2017,10/05/2021,10127812017,1012781
8000,07/05/2021,8606,8,6974,1026,1632,14/03/2021,"Domaine Leflaive, Chevalier-Montrachet Grand Cru",Burgundy,2017,10/05/2021,10734012017,1073401
6250,07/05/2021,7028,45,6116,134,912,07/05/2021,"Chateau Margaux Premier Cru Classe, Margaux",Bordeaux,2005,10/05/2021,10127812005,1012781
4400,07/05/2021,4882,23,4400,0,482,29/09/2020,"Chateau Margaux Premier Cru Classe, Margaux",Bordeaux,2001,10/05/2021,10127812001,1012781
3720,07/05/2021,4079,50,3480,240,599,10/04/2021,"Chateau Margaux Premier Cru Classe, Margaux",Bordeaux,2014,10/05/2021,10127812014,1012781
5400,09/08/2021,5709,6,5096,304,613,08/07/2021,"Chateau Angelus Premier Grand Cru Classe B, Saint-Emilion Grand Cru",Bordeaux,2000,10/08/2021,10060452000,1006045
5400,06/08/2021,5709,6,5096,304,613,08/07/2021,"Chateau Angelus Premier Grand Cru Classe B, Saint-Emilion Grand Cru",Bordeaux,2000,08/08/2021,10060452000,1006045
3920,07/05/2021,4494,74,3880,40,614,22/03/2021,"Chateau Margaux Premier Cru Classe, Margaux",Bordeaux,2008,10/05/2021,10127812008,1012781
5400,06/08/2021,5448,9,5096,304,352,08/07/2021,"Chateau Angelus Premier Grand Cru Classe B, Saint-Emilion Grand Cru",Bordeaux,2000,07/08/2021,10060452000,1006045
460,07/05/2021,487,154,420,40,67,23/03/2021,"Tua Rita, Giusto di Notri, Toscana",Tuscany,2016,10/05/2021,11058072016,1105807
3700,07/05/2021,4001,24,3520,180,481,07/04/2021,"Chateau Margaux Premier Cru Classe, Margaux",Bordeaux,2013,10/05/2021,10127812013,1012781
5400,06/08/2021,5709,6,5096,304,613,08/07/2021,"Chateau Angelus Premier Grand Cru Classe B, Saint-Emilion Grand Cru",Bordeaux,2000,08/08/2021,10060452000,1006045
780,07/05/2021,836,6,682,98,154,15/09/2020,"Chateau Calon Segur 3eme Cru Classe, Saint-Estephe",Bordeaux,2013,10/05/2021,10074752013,1007475
5400,06/08/2021,5448,9,5096,304,352,08/07/2021,"Chateau Angelus Premier Grand Cru Classe B, Saint-Emilion Grand Cru",Bordeaux,2000,07/08/2021,10060452000,1006045
1040,04/05/2021,1198,49,950,90,248,03/05/2021,"Chateau Calon Segur 3eme Cru Classe, Saint-Estephe",Bordeaux,2018,10/05/2021,10074752018,1007475
738,03/05/2021,887,104,760,-22,127,29/04/2021,"Chateau Calon Segur 3eme Cru Classe, Saint-Estephe",Bordeaux,2017,10/05/2021,10074752017,1007475
10500,07/05/2021,12366,62,9844,656,2522,29/03/2021,"Chateau Margaux Premier Cru Classe, Margaux",Bordeaux,2015,10/05/2021,10127812015,1012781
3900,07/05/2021,4500,27,3684,216,816,10/06/2020,"Chateau Margaux Premier Cru Classe, Margaux",Bordeaux,2002,10/05/2021,10127812002,1012781
6250,07/05/2021,7443,53,5922,328,1521,13/04/2021,"Chateau Margaux Premier Cru Classe, Margaux",Bordeaux,2010,10/05/2021,10127812010,1012781
1082,04/05/2021,1203,64,1048,34,155,27/04/2021,"Chateau Calon Segur 3eme Cru Classe, Saint-Estephe",Bordeaux,2016,10/05/2021,10074752016,1007475
5400,05/08/2021,5448,9,5096,304,352,08/07/2021,"Chateau Angelus Premier Grand Cru Classe B, Saint-Emilion Grand Cru",Bordeaux,2000,06/08/2021,10060452000,1006045
625,03/05/2021,687,10,470,155,217,29/03/2018,"Chateau Batailley 5eme Cru Classe, Pauillac",Bordeaux,2000,04/05/2021,10063222000,1006322
870,05/07/2021,966,5,705,165,261,01/02/2021,"Chateau Calon Segur 3eme Cru Classe, Saint-Estephe",Bordeaux,2002,06/07/2021,10074752002,1007475
8100,05/07/2021,9036,12,8100,0,936,21/06/2021,"Chateau Margaux Premier Cru Classe, Margaux",Bordeaux,2000,06/07/2021,10127812000,1012781
900,05/07/2021,1156,20,800,100,356,21/11/2019,"Chateau Calon Segur 3eme Cru Classe, Saint-Estephe",Bordeaux,2003,06/07/2021,10074752003,1007475
4450,05/07/2021,4717,21,4400,50,317,29/09/2020,"Chateau Margaux Premier Cru Classe, Margaux",Bordeaux,2001,06/07/2021,10127812001,1012781
3900,05/07/2021,4469,26,3684,216,785,10/06/2020,"Chateau Margaux Premier Cru Classe, Margaux",Bordeaux,2002,06/07/2021,10127812002,1012781
3826,05/07/2021,4507,54,4116,-290,391,25/02/2021,"Chateau Margaux Premier Cru Classe, Margaux",Bordeaux,2004,06/07/2021,10127812004,1012781
5400,05/08/2021,5448,9,5096,304,352,08/07/2021,"Chateau Angelus Premier Grand Cru Classe B, Saint-Emilion Grand Cru",Bordeaux,2000,06/08/2021,10060452000,1006045
5400,04/08/2021,5448,9,5096,304,352,08/07/2021,"Chateau Angelus Premier Grand Cru Classe B, Saint-Emilion Grand Cru",Bordeaux,2000,05/08/2021,10060452000,1006045
800,05/07/2021,922,18,745,55,177,16/11/2020,"Chateau Calon Segur 3eme Cru Classe, Saint-Estephe",Bordeaux,2004,06/07/2021,10074752004,1007475
1850,02/07/2021,1831,1,1180,670,651,10/03/2017,"Gaja, Barbaresco",Piedmont,2005,03/07/2021,10996052005,1099605
1408,29/06/2021,1605,2,1150,258,455,21/04/2019,"Tignanello, Toscana",Tuscany,2005,03/07/2021,10953912005,1095391
907,05/07/2021,924,18,805,102,119,20/11/2019,"Chateau Calon Segur 3eme Cru Classe, Saint-Estephe",Bordeaux,2001,06/07/2021,10074752001,1007475
450,03/05/2021,450,1,220,230,230,17/06/2015,"Chateau Batailley 5eme Cru Classe, Pauillac",Bordeaux,2002,04/05/2021,10063222002,1006322
5400,04/08/2021,5448,9,5096,304,352,08/07/2021,"Chateau Angelus Premier Grand Cru Classe B, Saint-Emilion Grand Cru",Bordeaux,2000,05/08/2021,10060452000,1006045
550,03/05/2021,532,3,420,130,112,09/07/2019,"Chateau Batailley 5eme Cru Classe, Pauillac",Bordeaux,2003,10/05/2021,10063222003,1006322
6400,05/07/2021,7276,24,6776,-376,500,10/06/2021,"Chateau Margaux Premier Cru Classe, Margaux",Bordeaux,2005,06/07/2021,10127812005,1012781
5400,03/08/2021,5448,9,5096,304,352,08/07/2021,"Chateau Angelus Premier Grand Cru Classe B, Saint-Emilion Grand Cru",Bordeaux,2000,03/08/2021,10060452000,1006045
1000,05/07/2021,1160,87,988,12,172,28/05/2021,"Chateau Calon Segur 3eme Cru Classe, Saint-Estephe",Bordeaux,2005,06/07/2021,10074752005,1007475
5400,03/08/2021,5448,9,5096,304,352,08/07/2021,"Chateau Angelus Premier Grand Cru Classe B, Saint-Emilion Grand Cru",Bordeaux,2000,04/08/2021,10060452000,1006045
900,05/07/2021,927,41,863,37,64,10/05/2021,"Chateau Calon Segur 3eme Cru Classe, Saint-Estephe",Bordeaux,2006,06/07/2021,10074752006,1007475
3900,05/07/2021,4647,89,3822,78,825,20/06/2021,"Chateau Margaux Premier Cru Classe, Margaux",Bordeaux,2006,06/07/2021,10127812006,1012781
1800,02/07/2021,1733,2,1300,500,433,30/05/2019,"Gaja, Barbaresco",Piedmont,2007,03/07/2021,10996052007,1099605
2437,02/07/2021,2719,1,1768,669,951,22/05/2020,"Gaja, Barbaresco",Piedmont,2000,03/07/2021,10996052000,1099605
1596,02/07/2021,1596,1,1145,451,451,22/10/2015,"Gaja, Barbaresco",Piedmont,2003,03/07/2021,10996052003,1099605
2500,02/07/2021,2632,3,2220,280,412,14/06/2021,"Gaja, Barbaresco",Piedmont,2001,03/07/2021,10996052001,1099605
574,02/07/2021,574,1,351,223,223,25/07/2016,"Tua Rita, Giusto di Notri, Toscana",Tuscany,2004,03/07/2021,11058072004,1105807
520,02/07/2021,563,3,460,60,103,05/05/2020,"Tua Rita, Giusto di Notri, Toscana",Tuscany,2008,03/07/2021,11058072008,1105807
660,02/07/2021,727,5,390,270,337,18/08/2017,"Tua Rita, Giusto di Notri, Toscana",Tuscany,2006,03/07/2021,11058072006,1105807
540,02/07/2021,527,2,300,240,227,03/11/2011,"Tua Rita, Giusto di Notri, Toscana",Tuscany,2007,03/07/2021,11058072007,1105807
1700,02/07/2021,1847,4,1378,322,469,29/07/2020,"Tignanello, Toscana",Tuscany,2001,03/07/2021,10953912001,1095391
1408,02/07/2021,1389,4,1238,170,151,02/11/2020,"Tignanello, Toscana",Tuscany,2006,03/07/2021,10953912006,1095391
6400,02/07/2021,7556,51,5950,450,1606,23/06/2021,"Chateau Margaux Premier Cru Classe, Margaux",Bordeaux,2010,03/07/2021,10127812010,1012781
550,03/05/2021,533,3,420,130,113,09/07/2019,"Chateau Batailley 5eme Cru Classe, Pauillac",Bordeaux,2003,04/05/2021,10063222003,1006322
990,02/07/2021,1134,16,990,0,144,16/06/2021,"Chateau Calon Segur 3eme Cru Classe, Saint-Estephe",Bordeaux,2010,03/07/2021,10074752010,1007475
5400,02/08/2021,5448,9,5096,304,352,08/07/2021,"Chateau Angelus Premier Grand Cru Classe B, Saint-Emilion Grand Cru",Bordeaux,2000,03/08/2021,10060452000,1006045
525,03/05/2021,496,2,300,225,196,15/12/2019,"Chateau Batailley 5eme Cru Classe, Pauillac",Bordeaux,2004,08/05/2021,10063222004,1006322
3560,05/07/2021,4185,37,3525,35,660,18/06/2021,"Chateau Margaux Premier Cru Classe, Margaux",Bordeaux,2007,06/07/2021,10127812007,1012781
5400,02/08/2021,5448,9,5096,304,352,08/07/2021,"Chateau Angelus Premier Grand Cru Classe B, Saint-Emilion Grand Cru",Bordeaux,2000,03/08/2021,10060452000,1006045
750,02/07/2021,988,36,790,-40,198,01/06/2020,"Chateau Calon Segur 3eme Cru Classe, Saint-Estephe",Bordeaux,2011,03/07/2021,10074752011,1007475
5400,30/07/2021,5463,11,5096,304,367,08/07/2021,"Chateau Angelus Premier Grand Cru Classe B, Saint-Emilion Grand Cru",Bordeaux,2000,31/07/2021,10060452000,1006045
3900,05/07/2021,4288,82,3750,150,538,28/06/2021,"Chateau Margaux Premier Cru Classe, Margaux",Bordeaux,2008,06/07/2021,10127812008,1012781
6830,05/07/2021,7757,50,7086,-256,671,11/06/2021,"Chateau Margaux Premier Cru Classe, Margaux",Bordeaux,2009,06/07/2021,10127812009,1012781
1024,02/07/2021,1255,4,1072,-48,183,20/01/2021,"Tignanello, Toscana",Tuscany,2009,03/07/2021,10953912009,1095391
1326,02/07/2021,1560,4,1170,156,390,24/06/2021,"Tignanello, Toscana",Tuscany,2010,03/07/2021,10953912010,1095391
975,05/07/2021,1230,49,1026,-51,204,24/06/2021,"Chateau Calon Segur 3eme Cru Classe, Saint-Estephe",Bordeaux,2009,06/07/2021,10074752009,1007475
525,03/05/2021,488,2,300,225,188,15/12/2019,"Chateau Batailley 5eme Cru Classe, Pauillac",Bordeaux,2004,04/05/2021,10063222004,1006322
5400,30/07/2021,5463,11,5096,304,367,08/07/2021,"Chateau Angelus Premier Grand Cru Classe B, Saint-Emilion Grand Cru",Bordeaux,2000,31/07/2021,10060452000,1006045
5400,29/07/2021,5422,12,5096,304,326,08/07/2021,"Chateau Angelus Premier Grand Cru Classe B, Saint-Emilion Grand Cru",Bordeaux,2000,30/07/2021,10060452000,1006045
9950,07/05/2021,9718,3,8000,1950,1718,30/01/2020,"Domaine Leflaive, Chevalier-Montrachet Grand Cru",Burgundy,2014,08/05/2021,10734012014,1073401
5400,29/07/2021,5422,12,5096,304,326,08/07/2021,"Chateau Angelus Premier Grand Cru Classe B, Saint-Emilion Grand Cru",Bordeaux,2000,30/07/2021,10060452000,1006045
8100,02/07/2021,9025,14,8100,0,925,21/06/2021,"Chateau Margaux Premier Cru Classe, Margaux",Bordeaux,2000,04/07/2021,10127812000,1012781
4438,02/07/2021,4717,21,4400,38,317,29/09/2020,"Chateau Margaux Premier Cru Classe, Margaux",Bordeaux,2001,04/07/2021,10127812001,1012781
5400,28/07/2021,5412,11,5096,304,316,08/07/2021,"Chateau Angelus Premier Grand Cru Classe B, Saint-Emilion Grand Cru",Bordeaux,2000,29/07/2021,10060452000,1006045
5400,28/07/2021,5412,11,5096,304,316,08/07/2021,"Chateau Angelus Premier Grand Cru Classe B, Saint-Emilion Grand Cru",Bordeaux,2000,29/07/2021,10060452000,1006045
907,02/07/2021,924,18,805,102,119,20/11/2019,"Chateau Calon Segur 3eme Cru Classe, Saint-Estephe",Bordeaux,2001,04/07/2021,10074752001,1007475
8000,07/05/2021,8252,20,7950,50,302,12/03/2021,"Chateau Margaux Premier Cru Classe, Margaux",Bordeaux,2000,08/05/2021,10127812000,1012781
1050,07/05/2021,1348,39,940,110,408,18/03/2021,"Chateau Calon Segur 3eme Cru Classe, Saint-Estephe",Bordeaux,2000,08/05/2021,10074752000,1007475
6600,07/05/2021,7959,74,6412,188,1547,25/03/2021,"Chateau Margaux Premier Cru Classe, Margaux",Bordeaux,2009,08/05/2021,10127812009,1012781
530,03/05/2021,622,49,450,80,172,28/10/2020,"Chateau Batailley 5eme Cru Classe, Pauillac",Bordeaux,2005,04/05/2021,10063222005,1006322
980,07/05/2021,1121,18,1000,-20,121,12/04/2021,"Chateau Calon Segur 3eme Cru Classe, Saint-Estephe",Bordeaux,2010,08/05/2021,10074752010,1007475
5848,15/07/2021,5403,11,5096,752,307,08/07/2021,"Chateau Angelus Premier Grand Cru Classe B, Saint-Emilion Grand Cru",Bordeaux,2000,17/07/2021,10060452000,1006045
3910,07/05/2021,4777,80,3800,110,977,07/04/2021,"Chateau Margaux Premier Cru Classe, Margaux",Bordeaux,2006,08/05/2021,10127812006,1012781
3700,07/05/2021,3996,24,3520,180,476,07/04/2021,"Chateau Margaux Premier Cru Classe, Margaux",Bordeaux,2013,08/05/2021,10127812013,1012781
5848,15/07/2021,5356,13,5096,752,260,08/07/2021,"Chateau Angelus Premier Grand Cru Classe B, Saint-Emilion Grand Cru",Bordeaux,2000,16/07/2021,10060452000,1006045
958,07/05/2021,1057,9,860,98,197,08/03/2021,"Tignanello, Toscana",Tuscany,2011,08/05/2021,10953912011,1095391
880,07/05/2021,958,9,725,155,233,13/04/2021,"Chateau Calon Segur 3eme Cru Classe, Saint-Estephe",Bordeaux,2007,08/05/2021,10074752007,1007475
850,07/05/2021,1101,94,860,-10,241,19/04/2021,"Chateau Calon Segur 3eme Cru Classe, Saint-Estephe",Bordeaux,2015,08/05/2021,10074752015,1007475
530,03/05/2021,621,50,450,80,171,04/05/2021,"Chateau Batailley 5eme Cru Classe, Pauillac",Bordeaux,2005,05/05/2021,10063222005,1006322
1280,07/05/2021,1225,11,1172,108,53,07/04/2021,"Tignanello, Toscana",Tuscany,2010,08/05/2021,10953912010,1095391
530,03/05/2021,622,49,450,80,172,28/10/2020,"Chateau Batailley 5eme Cru Classe, Pauillac",Bordeaux,2005,04/05/2021,10063222005,1006322
3700,06/05/2021,4089,28,3592,108,497,06/05/2021,"Chateau Margaux Premier Cru Classe, Margaux",Bordeaux,2007,08/05/2021,10127812007,1012781
4850,06/05/2021,5732,22,4800,50,932,11/03/2021,"Chateau Margaux Premier Cru Classe, Margaux",Bordeaux,2003,08/05/2021,10127812003,1012781
840,07/05/2021,1015,50,800,40,215,30/12/2020,"Chateau Calon Segur 3eme Cru Classe, Saint-Estephe",Bordeaux,2006,08/05/2021,10074752006,1007475
3758,02/07/2021,4298,75,3690,68,608,13/04/2021,"Chateau Margaux Premier Cru Classe, Margaux",Bordeaux,2011,03/07/2021,10127812011,1012781
5848,15/07/2021,5415,10,5096,752,319,08/07/2021,"Chateau Angelus Premier Grand Cru Classe B, Saint-Emilion Grand Cru",Bordeaux,2000,20/07/2021,10060452000,1006045
5848,15/07/2021,5413,10,5096,752,317,08/07/2021,"Chateau Angelus Premier Grand Cru Classe B, Saint-Emilion Grand Cru",Bordeaux,2000,23/07/2021,10060452000,1006045
5848,15/07/2021,5413,10,5096,752,317,08/07/2021,"Chateau Angelus Premier Grand Cru Classe B, Saint-Emilion Grand Cru",Bordeaux,2000,23/07/2021,10060452000,1006045
750,03/05/2021,994,32,790,-40,204,01/06/2020,"Chateau Calon Segur 3eme Cru Classe, Saint-Estephe",Bordeaux,2011,04/05/2021,10074752011,1007475
5848,15/07/2021,5356,13,5096,752,260,08/07/2021,"Chateau Angelus Premier Grand Cru Classe B, Saint-Emilion Grand Cru",Bordeaux,2000,16/07/2021,10060452000,1006045
8000,03/05/2021,8246,15,7950,50,296,12/03/2021,"Chateau Margaux Premier Cru Classe, Margaux",Bordeaux,2000,04/05/2021,10127812000,1012781
5848,15/07/2021,5403,11,5096,752,307,08/07/2021,"Chateau Angelus Premier Grand Cru Classe B, Saint-Emilion Grand Cru",Bordeaux,2000,17/07/2021,10060452000,1006045
6200,03/05/2021,7359,44,6400,-200,959,15/04/2021,"Chateau Margaux Premier Cru Classe, Margaux",Bordeaux,2005,04/05/2021,10127812005,1012781
5848,15/07/2021,5415,10,5096,752,319,08/07/2021,"Chateau Angelus Premier Grand Cru Classe B, Saint-Emilion Grand Cru",Bordeaux,2000,20/07/2021,10060452000,1006045
840,03/05/2021,943,15,781,59,162,16/11/2020,"Chateau Calon Segur 3eme Cru Classe, Saint-Estephe",Bordeaux,2008,04/05/2021,10074752008,1007475
960,03/05/2021,1197,13,850,110,347,28/01/2021,"Tignanello, Toscana",Tuscany,2012,04/05/2021,10953912012,1095391
780,03/05/2021,834,6,682,98,152,15/09/2020,"Chateau Calon Segur 3eme Cru Classe, Saint-Estephe",Bordeaux,2013,04/05/2021,10074752013,1007475
4943,07/07/2021,5355,13,5096,-153,259,08/07/2021,"Chateau Angelus Premier Grand Cru Classe B, Saint-Emilion Grand Cru",Bordeaux,2000,09/07/2021,10060452000,1006045
1050,03/05/2021,1343,43,940,110,403,18/03/2021,"Chateau Calon Segur 3eme Cru Classe, Saint-Estephe",Bordeaux,2000,04/05/2021,10074752000,1007475
890,03/05/2021,1099,29,805,85,294,20/11/2019,"Chateau Calon Segur 3eme Cru Classe, Saint-Estephe",Bordeaux,2001,04/05/2021,10074752001,1007475
1000,03/05/2021,1183,72,975,25,208,12/04/2021,"Chateau Calon Segur 3eme Cru Classe, Saint-Estephe",Bordeaux,2005,04/05/2021,10074752005,1007475
4943,07/07/2021,5355,13,4500,443,855,14/05/2021,"Chateau Angelus Premier Grand Cru Classe B, Saint-Emilion Grand Cru",Bordeaux,2000,08/07/2021,10060452000,1006045
1100,03/05/2021,1433,9,1010,90,423,18/12/2020,"Tignanello, Toscana",Tuscany,2008,04/05/2021,10953912008,1095391
3700,03/05/2021,3956,24,3520,180,436,07/04/2021,"Chateau Margaux Premier Cru Classe, Margaux",Bordeaux,2013,04/05/2021,10127812013,1012781
530,03/05/2021,621,50,450,80,171,04/05/2021,"Chateau Batailley 5eme Cru Classe, Pauillac",Bordeaux,2005,05/05/2021,10063222005,1006322
420,03/05/2021,487,6,532,-112,-45,11/02/2021,"Chateau Batailley 5eme Cru Classe, Pauillac",Bordeaux,2006,04/05/2021,10063222006,1006322
980,03/05/2021,1097,45,830,150,267,18/04/2021,"Tignanello, Toscana",Tuscany,2014,04/05/2021,10953912014,1095391
420,03/05/2021,483,6,532,-112,-49,11/02/2021,"Chateau Batailley 5eme Cru Classe, Pauillac",Bordeaux,2006,05/05/2021,10063222006,1006322
3827,03/05/2021,4617,61,4116,-289,501,25/02/2021,"Chateau Margaux Premier Cru Classe, Margaux",Bordeaux,2004,04/05/2021,10127812004,1012781
1290,03/05/2021,1212,11,1172,118,40,07/04/2021,"Tignanello, Toscana",Tuscany,2010,04/05/2021,10953912010,1095391
1000,03/05/2021,1054,9,860,140,194,08/03/2021,"Tignanello, Toscana",Tuscany,2011,04/05/2021,10953912011,1095391
4943,07/07/2021,5355,13,4500,443,855,14/05/2021,"Chateau Angelus Premier Grand Cru Classe B, Saint-Emilion Grand Cru",Bordeaux,2000,08/07/2021,10060452000,1006045
6250,07/05/2021,7441,54,5922,328,1519,13/04/2021,"Chateau Margaux Premier Cru Classe, Margaux",Bordeaux,2010,08/05/2021,10127812010,1012781
3720,03/05/2021,4054,45,3480,240,574,10/04/2021,"Chateau Margaux Premier Cru Classe, Margaux",Bordeaux,2014,04/05/2021,10127812014,1012781
900,03/05/2021,1054,10,800,100,254,21/11/2019,"Chateau Calon Segur 3eme Cru Classe, Saint-Estephe",Bordeaux,2003,04/05/2021,10074752003,1007475
2260,03/05/2021,2311,4,2190,70,121,01/05/2021,"Gaja, Barbaresco",Piedmont,2004,04/05/2021,10996052004,1099605
1020,03/05/2021,1129,17,1000,20,129,12/04/2021,"Chateau Calon Segur 3eme Cru Classe, Saint-Estephe",Bordeaux,2010,04/05/2021,10074752010,1007475
4943,07/07/2021,5355,13,5096,-153,259,08/07/2021,"Chateau Angelus Premier Grand Cru Classe B, Saint-Emilion Grand Cru",Bordeaux,2000,09/07/2021,10060452000,1006045
420,03/05/2021,487,6,532,-112,-45,11/02/2021,"Chateau Batailley 5eme Cru Classe, Pauillac",Bordeaux,2006,04/05/2021,10063222006,1006322
6750,03/05/2021,7975,97,6412,338,1563,25/03/2021,"Chateau Margaux Premier Cru Classe, Margaux",Bordeaux,2009,04/05/2021,10127812009,1012781
420,03/05/2021,483,6,532,-112,-49,11/02/2021,"Chateau Batailley 5eme Cru Classe, Pauillac",Bordeaux,2006,05/05/2021,10063222006,1006322
4943,05/07/2021,5409,12,4500,443,909,14/05/2021,"Chateau Angelus Premier Grand Cru Classe B, Saint-Emilion Grand Cru",Bordeaux,2000,06/07/2021,10060452000,1006045
3900,03/05/2021,4447,32,3684,216,763,10/06/2020,"Chateau Margaux Premier Cru Classe, Margaux",Bordeaux,2002,04/05/2021,10127812002,1012781
750,07/05/2021,1007,36,790,-40,217,01/06/2020,"Chateau Calon Segur 3eme Cru Classe, Saint-Estephe",Bordeaux,2011,08/05/2021,10074752011,1007475
780,07/05/2021,837,6,682,98,155,15/09/2020,"Chateau Calon Segur 3eme Cru Classe, Saint-Estephe",Bordeaux,2013,08/05/2021,10074752013,1007475
3800,03/05/2021,4376,81,3560,240,816,20/11/2020,"Chateau Margaux Premier Cru Classe, Margaux",Bordeaux,2012,04/05/2021,10127812012,1012781
4400,03/05/2021,4883,26,4400,0,483,29/09/2020,"Chateau Margaux Premier Cru Classe, Margaux",Bordeaux,2001,04/05/2021,10127812001,1012781
1700,03/05/2021,1641,3,1378,322,263,29/07/2020,"Tignanello, Toscana",Tuscany,2001,04/05/2021,10953912001,1095391
3800,03/05/2021,4323,114,3690,110,633,13/04/2021,"Chateau Margaux Premier Cru Classe, Margaux",Bordeaux,2011,04/05/2021,10127812011,1012781
840,03/05/2021,1029,51,800,40,229,30/12/2020,"Chateau Calon Segur 3eme Cru Classe, Saint-Estephe",Bordeaux,2006,04/05/2021,10074752006,1007475
6400,02/07/2021,7179,27,6776,-376,403,10/06/2021,"Chateau Margaux Premier Cru Classe, Margaux",Bordeaux,2005,04/07/2021,10127812005,1012781
1000,02/07/2021,1159,88,988,12,171,28/05/2021,"Chateau Calon Segur 3eme Cru Classe, Saint-Estephe",Bordeaux,2005,04/07/2021,10074752005,1007475
900,02/07/2021,927,41,863,37,64,10/05/2021,"Chateau Calon Segur 3eme Cru Classe, Saint-Estephe",Bordeaux,2006,04/07/2021,10074752006,1007475
3560,03/05/2021,4162,29,3450,110,712,11/11/2020,"Chateau Margaux Premier Cru Classe, Margaux",Bordeaux,2007,04/05/2021,10127812007,1012781
804,03/05/2021,958,17,745,59,213,16/11/2020,"Chateau Calon Segur 3eme Cru Classe, Saint-Estephe",Bordeaux,2004,04/05/2021,10074752004,1007475
450,03/05/2021,450,1,340,110,110,31/08/2018,"Chateau Batailley 5eme Cru Classe, Pauillac",Bordeaux,2007,04/05/2021,10063222007,1006322
10500,03/05/2021,12011,54,9844,656,2167,29/03/2021,"Chateau Margaux Premier Cru Classe, Margaux",Bordeaux,2015,04/05/2021,10127812015,1012781
3920,07/05/2021,4486,75,3880,40,606,22/03/2021,"Chateau Margaux Premier Cru Classe, Margaux",Bordeaux,2008,08/05/2021,10127812008,1012781
3800,07/05/2021,4383,125,3690,110,693,13/04/2021,"Chateau Margaux Premier Cru Classe, Margaux",Bordeaux,2011,08/05/2021,10127812011,1012781
3800,07/05/2021,4155,37,3560,240,595,20/11/2020,"Chateau Margaux Premier Cru Classe, Margaux",Bordeaux,2012,08/05/2021,10127812012,1012781
907,07/05/2021,1101,28,805,102,296,20/11/2019,"Chateau Calon Segur 3eme Cru Classe, Saint-Estephe",Bordeaux,2001,08/05/2021,10074752001,1007475
840,07/05/2021,941,15,781,59,160,16/11/2020,"Chateau Calon Segur 3eme Cru Classe, Saint-Estephe",Bordeaux,2008,08/05/2021,10074752008,1007475
2260,07/05/2021,2305,4,2190,70,115,01/05/2021,"Gaja, Barbaresco",Piedmont,2004,08/05/2021,10996052004,1099605
3720,07/05/2021,4074,51,3480,240,594,10/04/2021,"Chateau Margaux Premier Cru Classe, Margaux",Bordeaux,2014,08/05/2021,10127812014,1012781
4400,07/05/2021,4898,27,4400,0,498,29/09/2020,"Chateau Margaux Premier Cru Classe, Margaux",Bordeaux,2001,08/05/2021,10127812001,1012781
860,03/05/2021,933,10,725,135,208,13/04/2021,"Chateau Calon Segur 3eme Cru Classe, Saint-Estephe",Bordeaux,2007,04/05/2021,10074752007,1007475
4943,05/07/2021,5409,12,4500,443,909,14/05/2021,"Chateau Angelus Premier Grand Cru Classe B, Saint-Emilion Grand Cru",Bordeaux,2000,06/07/2021,10060452000,1006045
6100,03/05/2021,7498,85,5922,178,1576,13/04/2021,"Chateau Margaux Premier Cru Classe, Margaux",Bordeaux,2010,04/05/2021,10127812010,1012781
1408,03/05/2021,1455,6,1238,170,217,02/11/2020,"Tignanello, Toscana",Tuscany,2006,04/05/2021,10953912006,1095391
4943,02/07/2021,5409,12,4500,443,909,14/05/2021,"Chateau Angelus Premier Grand Cru Classe B, Saint-Emilion Grand Cru",Bordeaux,2000,05/07/2021,10060452000,1006045
4943,02/07/2021,5391,12,4500,443,891,14/05/2021,"Chateau Angelus Premier Grand Cru Classe B, Saint-Emilion Grand Cru",Bordeaux,2000,03/07/2021,10060452000,1006045
1200,04/05/2021,1148,123,1082,118,66,27/04/2021,"Tignanello, Toscana",Tuscany,2016,05/05/2021,10953912016,1095391
8000,04/05/2021,8137,19,7950,50,187,12/03/2021,"Chateau Margaux Premier Cru Classe, Margaux",Bordeaux,2000,05/05/2021,10127812000,1012781
3827,07/05/2021,4597,57,4116,-289,481,25/02/2021,"Chateau Margaux Premier Cru Classe, Margaux",Bordeaux,2004,08/05/2021,10127812004,1012781
400,03/05/2021,487,5,332,68,155,06/10/2020,"Chateau Batailley 5eme Cru Classe, Pauillac",Bordeaux,2008,04/05/2021,10063222008,1006322
6250,07/05/2021,7037,46,6116,134,921,07/05/2021,"Chateau Margaux Premier Cru Classe, Margaux",Bordeaux,2005,08/05/2021,10127812005,1012781
900,07/05/2021,1062,21,800,100,262,21/11/2019,"Chateau Calon Segur 3eme Cru Classe, Saint-Estephe",Bordeaux,2003,08/05/2021,10074752003,1007475
490,03/05/2021,548,24,504,-14,44,06/04/2021,"Chateau Batailley 5eme Cru Classe, Pauillac",Bordeaux,2009,04/05/2021,10063222009,1006322
4943,02/07/2021,5391,12,4500,443,891,14/05/2021,"Chateau Angelus Premier Grand Cru Classe B, Saint-Emilion Grand Cru",Bordeaux,2000,03/07/2021,10060452000,1006045
768,07/05/2021,854,7,705,63,149,01/02/2021,"Chateau Calon Segur 3eme Cru Classe, Saint-Estephe",Bordeaux,2002,08/05/2021,10074752002,1007475
490,03/05/2021,548,24,504,-14,44,06/04/2021,"Chateau Batailley 5eme Cru Classe, Pauillac",Bordeaux,2009,04/05/2021,10063222009,1006322
4943,02/07/2021,5409,12,4500,443,909,14/05/2021,"Chateau Angelus Premier Grand Cru Classe B, Saint-Emilion Grand Cru",Bordeaux,2000,05/07/2021,10060452000,1006045
3900,07/05/2021,4435,31,3684,216,751,10/06/2020,"Chateau Margaux Premier Cru Classe, Margaux",Bordeaux,2002,08/05/2021,10127812002,1012781
4943,30/06/2021,5337,13,4500,443,837,14/05/2021,"Chateau Angelus Premier Grand Cru Classe B, Saint-Emilion Grand Cru",Bordeaux,2000,01/07/2021,10060452000,1006045
1024,07/05/2021,1125,10,1072,-48,53,20/01/2021,"Tignanello, Toscana",Tuscany,2009,08/05/2021,10953912009,1095391
1000,07/05/2021,1230,16,1047,-47,183,27/04/2021,"Chateau Calon Segur 3eme Cru Classe, Saint-Estephe",Bordeaux,2009,08/05/2021,10074752009,1007475
4943,30/06/2021,5337,13,4500,443,837,14/05/2021,"Chateau Angelus Premier Grand Cru Classe B, Saint-Emilion Grand Cru",Bordeaux,2000,01/07/2021,10060452000,1006045
4990,29/06/2021,5355,13,5096,-106,259,08/07/2021,"Chateau Angelus Premier Grand Cru Classe B, Saint-Emilion Grand Cru",Bordeaux,2000,10/07/2021,10060452000,1006045
4990,29/06/2021,5355,13,5096,-106,259,08/07/2021,"Chateau Angelus Premier Grand Cru Classe B, Saint-Emilion Grand Cru",Bordeaux,2000,10/07/2021,10060452000,1006045
4943,28/06/2021,5387,12,4500,443,887,14/05/2021,"Chateau Angelus Premier Grand Cru Classe B, Saint-Emilion Grand Cru",Bordeaux,2000,29/06/2021,10060452000,1006045
10500,07/05/2021,12398,67,9844,656,2554,29/03/2021,"Chateau Margaux Premier Cru Classe, Margaux",Bordeaux,2015,08/05/2021,10127812015,1012781
1700,07/05/2021,1656,3,1378,322,278,29/07/2020,"Tignanello, Toscana",Tuscany,2001,08/05/2021,10953912001,1095391
2199,02/07/2021,2225,2,1340,859,885,13/03/2020,"Gaja, Barbaresco",Piedmont,2009,03/07/2021,10996052009,1099605
960,30/06/2021,1038,10,880,80,158,22/06/2021,"Tignanello, Toscana",Tuscany,2011,03/07/2021,10953912011,1095391
1300,05/05/2021,1332,3,1200,100,132,06/03/2021,"Tignanello, Toscana",Tuscany,2007,09/05/2021,10953912007,1095391
1029,05/05/2021,1181,69,975,54,206,12/04/2021,"Chateau Calon Segur 3eme Cru Classe, Saint-Estephe",Bordeaux,2005,09/05/2021,10074752005,1007475
1060,05/05/2021,1109,201,1108,-48,1,08/05/2021,"Tignanello, Toscana",Tuscany,2016,09/05/2021,10953912016,1095391
3800,07/05/2021,4154,36,3560,240,594,20/11/2020,"Chateau Margaux Premier Cru Classe, Margaux",Bordeaux,2012,09/05/2021,10127812012,1012781
8000,07/05/2021,8230,20,7950,50,280,12/03/2021,"Chateau Margaux Premier Cru Classe, Margaux",Bordeaux,2000,09/05/2021,10127812000,1012781
1700,07/05/2021,1674,3,1378,322,296,29/07/2020,"Tignanello, Toscana",Tuscany,2001,09/05/2021,10953912001,1095391
3910,05/05/2021,4775,80,3800,110,975,07/04/2021,"Chateau Margaux Premier Cru Classe, Margaux",Bordeaux,2006,07/05/2021,10127812006,1012781
3827,06/05/2021,4605,56,4116,-289,489,25/02/2021,"Chateau Margaux Premier Cru Classe, Margaux",Bordeaux,2004,07/05/2021,10127812004,1012781
6600,06/05/2021,7945,99,6412,188,1533,25/03/2021,"Chateau Margaux Premier Cru Classe, Margaux",Bordeaux,2009,07/05/2021,10127812009,1012781
4943,28/06/2021,5387,12,4500,443,887,14/05/2021,"Chateau Angelus Premier Grand Cru Classe B, Saint-Emilion Grand Cru",Bordeaux,2000,29/06/2021,10060452000,1006045
6100,06/05/2021,7464,52,5922,178,1542,13/04/2021,"Chateau Margaux Premier Cru Classe, Margaux",Bordeaux,2010,07/05/2021,10127812010,1012781
3900,02/07/2021,4647,89,3822,78,825,20/06/2021,"Chateau Margaux Premier Cru Classe, Margaux",Bordeaux,2006,04/07/2021,10127812006,1012781
3560,02/07/2021,4185,37,3525,35,660,18/06/2021,"Chateau Margaux Premier Cru Classe, Margaux",Bordeaux,2007,04/07/2021,10127812007,1012781
4943,25/06/2021,5357,13,4500,443,857,14/05/2021,"Chateau Angelus Premier Grand Cru Classe B, Saint-Emilion Grand Cru",Bordeaux,2000,26/06/2021,10060452000,1006045
3900,02/07/2021,4288,82,3750,150,538,28/06/2021,"Chateau Margaux Premier Cru Classe, Margaux",Bordeaux,2008,04/07/2021,10127812008,1012781
895,02/07/2021,978,10,781,114,197,16/11/2020,"Chateau Calon Segur 3eme Cru Classe, Saint-Estephe",Bordeaux,2008,04/07/2021,10074752008,1007475
1299,05/05/2021,1460,9,1010,289,450,18/12/2020,"Tignanello, Toscana",Tuscany,2008,07/05/2021,10953912008,1095391
8000,06/05/2021,8147,18,7950,50,197,12/03/2021,"Chateau Margaux Premier Cru Classe, Margaux",Bordeaux,2000,07/05/2021,10127812000,1012781
9950,06/05/2021,9718,3,8000,1950,1718,30/01/2020,"Domaine Leflaive, Chevalier-Montrachet Grand Cru",Burgundy,2014,07/05/2021,10734012014,1073401
3875,06/05/2021,4486,75,3880,-5,606,22/03/2021,"Chateau Margaux Premier Cru Classe, Margaux",Bordeaux,2008,07/05/2021,10127812008,1012781
2500,05/07/2021,2632,3,2220,280,412,14/06/2021,"Gaja, Barbaresco",Piedmont,2001,06/07/2021,10996052001,1099605
2098,05/07/2021,2366,3,2190,-92,176,01/05/2021,"Gaja, Barbaresco",Piedmont,2004,06/07/2021,10996052004,1099605
1700,05/07/2021,1847,4,1378,322,469,29/07/2020,"Tignanello, Toscana",Tuscany,2001,06/07/2021,10953912001,1095391
1408,05/07/2021,1389,4,1238,170,151,02/11/2020,"Tignanello, Toscana",Tuscany,2006,06/07/2021,10953912006,1095391
1280,06/05/2021,1225,11,1172,108,53,07/04/2021,"Tignanello, Toscana",Tuscany,2010,07/05/2021,10953912010,1095391
4943,25/06/2021,5357,13,4500,443,857,14/05/2021,"Chateau Angelus Premier Grand Cru Classe B, Saint-Emilion Grand Cru",Bordeaux,2000,26/06/2021,10060452000,1006045
3800,06/05/2021,4383,125,3690,110,693,13/04/2021,"Chateau Margaux Premier Cru Classe, Margaux",Bordeaux,2011,07/05/2021,10127812011,1012781
4943,23/06/2021,5333,13,4500,443,833,14/05/2021,"Chateau Angelus Premier Grand Cru Classe B, Saint-Emilion Grand Cru",Bordeaux,2000,24/06/2021,10060452000,1006045
4943,23/06/2021,5333,13,4500,443,833,14/05/2021,"Chateau Angelus Premier Grand Cru Classe B, Saint-Emilion Grand Cru",Bordeaux,2000,24/06/2021,10060452000,1006045
3800,06/05/2021,4170,32,3560,240,610,20/11/2020,"Chateau Margaux Premier Cru Classe, Margaux",Bordeaux,2012,07/05/2021,10127812012,1012781
1000,05/05/2021,1230,16,1047,-47,183,27/04/2021,"Chateau Calon Segur 3eme Cru Classe, Saint-Estephe",Bordeaux,2009,07/05/2021,10074752009,1007475
4600,21/06/2021,5293,13,4500,100,793,14/05/2021,"Chateau Angelus Premier Grand Cru Classe B, Saint-Emilion Grand Cru",Bordeaux,2000,23/06/2021,10060452000,1006045
6250,06/05/2021,7051,45,6400,-150,651,15/04/2021,"Chateau Margaux Premier Cru Classe, Margaux",Bordeaux,2005,07/05/2021,10127812005,1012781
4400,06/05/2021,4898,27,4400,0,498,29/09/2020,"Chateau Margaux Premier Cru Classe, Margaux",Bordeaux,2001,07/05/2021,10127812001,1012781
2260,06/05/2021,2305,4,2190,70,115,01/05/2021,"Gaja, Barbaresco",Piedmont,2004,07/05/2021,10996052004,1099605
880,06/05/2021,948,10,725,155,223,13/04/2021,"Chateau Calon Segur 3eme Cru Classe, Saint-Estephe",Bordeaux,2007,07/05/2021,10074752007,1007475
3700,06/05/2021,3998,23,3520,180,478,07/04/2021,"Chateau Margaux Premier Cru Classe, Margaux",Bordeaux,2013,07/05/2021,10127812013,1012781
4600,21/06/2021,5128,10,4500,100,628,14/05/2021,"Chateau Angelus Premier Grand Cru Classe B, Saint-Emilion Grand Cru",Bordeaux,2000,22/06/2021,10060452000,1006045
840,06/05/2021,943,15,781,59,162,16/11/2020,"Chateau Calon Segur 3eme Cru Classe, Saint-Estephe",Bordeaux,2008,07/05/2021,10074752008,1007475
950,06/05/2021,1026,47,800,150,226,30/12/2020,"Chateau Calon Segur 3eme Cru Classe, Saint-Estephe",Bordeaux,2006,07/05/2021,10074752006,1007475
4600,21/06/2021,5293,13,4500,100,793,14/05/2021,"Chateau Angelus Premier Grand Cru Classe B, Saint-Emilion Grand Cru",Bordeaux,2000,23/06/2021,10060452000,1006045
490,03/05/2021,593,406,494,-4,99,20/04/2021,"Chateau Batailley 5eme Cru Classe, Pauillac",Bordeaux,2010,04/05/2021,10063222010,1006322
820,02/07/2021,937,6,735,85,202,09/09/2020,"Chateau Calon Segur 3eme Cru Classe, Saint-Estephe",Bordeaux,2012,03/07/2021,10074752012,1007475
3750,24/06/2021,4181,41,3560,190,621,20/11/2020,"Chateau Margaux Premier Cru Classe, Margaux",Bordeaux,2012,03/07/2021,10127812012,1012781
1800,02/07/2021,1691,2,1440,360,251,04/01/2018,"Gaja, Barbaresco",Piedmont,2010,03/07/2021,10996052010,1099605
490,03/05/2021,592,409,494,-4,98,20/04/2021,"Chateau Batailley 5eme Cru Classe, Pauillac",Bordeaux,2010,07/05/2021,10063222010,1006322
1300,05/05/2021,1335,3,1200,100,135,06/03/2021,"Tignanello, Toscana",Tuscany,2007,07/05/2021,10953912007,1095391
6830,02/07/2021,7777,46,7086,-256,691,11/06/2021,"Chateau Margaux Premier Cru Classe, Margaux",Bordeaux,2009,04/07/2021,10127812009,1012781
1000,02/07/2021,1259,44,1026,-26,233,24/06/2021,"Chateau Calon Segur 3eme Cru Classe, Saint-Estephe",Bordeaux,2009,04/07/2021,10074752009,1007475
490,03/05/2021,592,407,494,-4,98,20/04/2021,"Chateau Batailley 5eme Cru Classe, Pauillac",Bordeaux,2010,05/05/2021,10063222010,1006322
780,06/05/2021,837,6,682,98,155,15/09/2020,"Chateau Calon Segur 3eme Cru Classe, Saint-Estephe",Bordeaux,2013,07/05/2021,10074752013,1007475
1000,04/05/2021,1199,12,860,140,339,08/03/2021,"Tignanello, Toscana",Tuscany,2013,07/05/2021,10953912013,1095391
750,05/05/2021,1005,38,790,-40,215,01/06/2020,"Chateau Calon Segur 3eme Cru Classe, Saint-Estephe",Bordeaux,2011,07/05/2021,10074752011,1007475
490,03/05/2021,593,406,494,-4,99,20/04/2021,"Chateau Batailley 5eme Cru Classe, Pauillac",Bordeaux,2010,04/05/2021,10063222010,1006322
4600,21/06/2021,5128,10,4500,100,628,14/05/2021,"Chateau Angelus Premier Grand Cru Classe B, Saint-Emilion Grand Cru",Bordeaux,2000,22/06/2021,10060452000,1006045
3720,06/05/2021,4074,51,3480,240,594,10/04/2021,"Chateau Margaux Premier Cru Classe, Margaux",Bordeaux,2014,07/05/2021,10127812014,1012781
4920,15/06/2021,5231,11,4500,420,731,14/05/2021,"Chateau Angelus Premier Grand Cru Classe B, Saint-Emilion Grand Cru",Bordeaux,2000,18/06/2021,10060452000,1006045
490,03/05/2021,592,409,494,-4,98,20/04/2021,"Chateau Batailley 5eme Cru Classe, Pauillac",Bordeaux,2010,07/05/2021,10063222010,1006322
980,06/05/2021,1121,18,1000,-20,121,12/04/2021,"Chateau Calon Segur 3eme Cru Classe, Saint-Estephe",Bordeaux,2010,07/05/2021,10074752010,1007475
4920,15/06/2021,5179,10,4500,420,679,14/05/2021,"Chateau Angelus Premier Grand Cru Classe B, Saint-Emilion Grand Cru",Bordeaux,2000,19/06/2021,10060452000,1006045
4920,15/06/2021,5196,12,4500,420,696,14/05/2021,"Chateau Angelus Premier Grand Cru Classe B, Saint-Emilion Grand Cru",Bordeaux,2000,16/06/2021,10060452000,1006045
4920,15/06/2021,5196,12,4500,420,696,14/05/2021,"Chateau Angelus Premier Grand Cru Classe B, Saint-Emilion Grand Cru",Bordeaux,2000,16/06/2021,10060452000,1006045
3560,05/05/2021,4089,28,3592,-32,497,06/05/2021,"Chateau Margaux Premier Cru Classe, Margaux",Bordeaux,2007,07/05/2021,10127812007,1012781
1408,05/05/2021,1518,1,1150,258,368,21/04/2019,"Tignanello, Toscana",Tuscany,2005,07/05/2021,10953912005,1095391
4850,06/05/2021,5763,20,4800,50,963,11/03/2021,"Chateau Margaux Premier Cru Classe, Margaux",Bordeaux,2003,07/05/2021,10127812003,1012781
490,03/05/2021,592,407,494,-4,98,20/04/2021,"Chateau Batailley 5eme Cru Classe, Pauillac",Bordeaux,2010,05/05/2021,10063222010,1006322
850,06/05/2021,1100,95,860,-10,240,19/04/2021,"Chateau Calon Segur 3eme Cru Classe, Saint-Estephe",Bordeaux,2015,07/05/2021,10074752015,1007475
10500,06/05/2021,12462,70,9844,656,2618,29/03/2021,"Chateau Margaux Premier Cru Classe, Margaux",Bordeaux,2015,07/05/2021,10127812015,1012781
520,07/05/2021,575,4,460,60,115,05/05/2020,"Tua Rita, Giusto di Notri, Toscana",Tuscany,2008,08/05/2021,11058072008,1105807
4920,15/06/2021,5231,11,4500,420,731,14/05/2021,"Chateau Angelus Premier Grand Cru Classe B, Saint-Emilion Grand Cru",Bordeaux,2000,18/06/2021,10060452000,1006045
6400,02/07/2021,7532,50,5950,450,1582,23/06/2021,"Chateau Margaux Premier Cru Classe, Margaux",Bordeaux,2010,04/07/2021,10127812010,1012781
750,02/07/2021,989,35,790,-40,199,01/06/2020,"Chateau Calon Segur 3eme Cru Classe, Saint-Estephe",Bordeaux,2011,04/07/2021,10074752011,1007475
4920,15/06/2021,5179,10,4500,420,679,14/05/2021,"Chateau Angelus Premier Grand Cru Classe B, Saint-Emilion Grand Cru",Bordeaux,2000,19/06/2021,10060452000,1006045
400,03/05/2021,468,6,300,100,168,05/11/2020,"Chateau Batailley 5eme Cru Classe, Pauillac",Bordeaux,2011,04/05/2021,10063222011,1006322
990,08/06/2021,1110,21,1000,-10,110,12/04/2021,"Chateau Calon Segur 3eme Cru Classe, Saint-Estephe",Bordeaux,2010,09/06/2021,10074752010,1007475
1000,08/06/2021,1153,98,988,12,165,28/05/2021,"Chateau Calon Segur 3eme Cru Classe, Saint-Estephe",Bordeaux,2005,09/06/2021,10074752005,1007475
1350,08/06/2021,1445,7,1352,-2,93,23/09/2020,"Gaja, Barbaresco",Piedmont,2011,09/06/2021,10996052011,1099605
1000,07/06/2021,1169,44,1030,-30,139,25/05/2021,"Chateau Calon Segur 3eme Cru Classe, Saint-Estephe",Bordeaux,2009,09/06/2021,10074752009,1007475
5415,03/06/2021,5683,96,5238,177,445,17/05/2021,"Chateau Margaux Premier Cru Classe, Margaux",Bordeaux,2016,09/06/2021,10127812016,1012781
660,08/06/2021,724,4,390,270,334,18/08/2017,"Tua Rita, Giusto di Notri, Toscana",Tuscany,2006,09/06/2021,11058072006,1105807
1678,08/06/2021,1648,4,1180,498,468,25/06/2020,"Tignanello, Toscana",Tuscany,2004,09/06/2021,10953912004,1095391
2500,08/06/2021,3334,3,1200,1300,2134,16/05/2012,"Gaja, Barbaresco",Piedmont,2001,09/06/2021,10996052001,1099605
10500,07/06/2021,11988,53,9844,656,2144,29/03/2021,"Chateau Margaux Premier Cru Classe, Margaux",Bordeaux,2015,09/06/2021,10127812015,1012781
880,08/06/2021,986,13,725,155,261,13/04/2021,"Chateau Calon Segur 3eme Cru Classe, Saint-Estephe",Bordeaux,2007,09/06/2021,10074752007,1007475
1299,08/06/2021,1502,7,1010,289,492,18/12/2020,"Tignanello, Toscana",Tuscany,2008,09/06/2021,10953912008,1095391
400,03/05/2021,468,6,300,100,168,05/11/2020,"Chateau Batailley 5eme Cru Classe, Pauillac",Bordeaux,2011,04/05/2021,10063222011,1006322
400,03/05/2021,467,9,355,45,112,15/04/2021,"Chateau Batailley 5eme Cru Classe, Pauillac",Bordeaux,2012,04/05/2021,10063222012,1006322
3720,08/06/2021,4294,147,3480,240,814,10/04/2021,"Chateau Margaux Premier Cru Classe, Margaux",Bordeaux,2014,09/06/2021,10127812014,1012781
4920,11/06/2021,5196,12,4500,420,696,14/05/2021,"Chateau Angelus Premier Grand Cru Classe B, Saint-Emilion Grand Cru",Bordeaux,2000,12/06/2021,10060452000,1006045
14766,08/06/2021,16040,0,18750,-3984,-2710,29/08/2018,"Jacques-Frederic Mugnier, Chambolle-Musigny Premier Cru, Les Amoureuses",Burgundy,2015,09/06/2021,10496422015,1049642
6300,08/06/2021,7458,64,6190,110,1268,23/05/2021,"Chateau Margaux Premier Cru Classe, Margaux",Bordeaux,2010,09/06/2021,10127812010,1012781
400,03/05/2021,467,9,355,45,112,15/04/2021,"Chateau Batailley 5eme Cru Classe, Pauillac",Bordeaux,2012,04/05/2021,10063222012,1006322
857,08/06/2021,937,165,800,57,137,05/06/2021,"Tignanello, Toscana",Tuscany,2017,09/06/2021,10953912017,1095391
300,03/05/2021,301,108,304,-4,-3,10/01/2021,"Chateau Batailley 5eme Cru Classe, Pauillac",Bordeaux,2013,04/05/2021,10063222013,1006322
4920,11/06/2021,5196,12,4500,420,696,14/05/2021,"Chateau Angelus Premier Grand Cru Classe B, Saint-Emilion Grand Cru",Bordeaux,2000,12/06/2021,10060452000,1006045
1550,08/06/2021,1557,1,1300,250,257,27/04/2021,"Gaja, Barbaresco",Piedmont,2012,09/06/2021,10996052012,1099605
460,08/06/2021,492,182,420,40,72,28/05/2021,"Tua Rita, Giusto di Notri, Toscana",Tuscany,2016,09/06/2021,11058072016,1105807
4920,07/06/2021,5196,12,4500,420,696,14/05/2021,"Chateau Angelus Premier Grand Cru Classe B, Saint-Emilion Grand Cru",Bordeaux,2000,08/06/2021,10060452000,1006045
4920,07/06/2021,5196,12,4500,420,696,14/05/2021,"Chateau Angelus Premier Grand Cru Classe B, Saint-Emilion Grand Cru",Bordeaux,2000,08/06/2021,10060452000,1006045
1408,27/05/2021,1354,2,996,412,358,14/06/2019,"Tignanello, Toscana",Tuscany,2000,09/06/2021,10953912000,1095391
950,08/06/2021,1007,57,863,87,144,10/05/2021,"Chateau Calon Segur 3eme Cru Classe, Saint-Estephe",Bordeaux,2006,09/06/2021,10074752006,1007475
900,04/06/2021,1233,14,850,50,383,28/01/2021,"Tignanello, Toscana",Tuscany,2012,09/06/2021,10953912012,1095391
4920,01/06/2021,5186,13,4500,420,686,14/05/2021,"Chateau Angelus Premier Grand Cru Classe B, Saint-Emilion Grand Cru",Bordeaux,2000,04/06/2021,10060452000,1006045
7000,10/05/2021,6797,1,5360,1640,1437,18/09/2020,"Domaine Leflaive, Chevalier-Montrachet Grand Cru",Burgundy,2009,09/06/2021,10734012009,1073401
3826,08/06/2021,4526,58,4116,-290,410,25/02/2021,"Chateau Margaux Premier Cru Classe, Margaux",Bordeaux,2004,09/06/2021,10127812004,1012781
3700,18/05/2021,4137,131,3700,0,437,06/05/2021,"Chateau Margaux Premier Cru Classe, Margaux",Bordeaux,2017,19/05/2021,10127812017,1012781
10500,18/05/2021,12538,67,9844,656,2694,29/03/2021,"Chateau Margaux Premier Cru Classe, Margaux",Bordeaux,2015,19/05/2021,10127812015,1012781
420,18/05/2021,462,10,342,78,120,21/08/2020,"Tua Rita, Giusto di Notri, Toscana",Tuscany,2011,19/05/2021,11058072011,1105807
7800,08/06/2021,8230,8,7330,470,900,02/06/2021,"Domaine Leflaive, Chevalier-Montrachet Grand Cru",Burgundy,2018,09/06/2021,10734012018,1073401
760,03/06/2021,920,111,740,20,180,21/05/2021,"Chateau Calon Segur 3eme Cru Classe, Saint-Estephe",Bordeaux,2017,09/06/2021,10074752017,1007475
4920,01/06/2021,5185,13,4500,420,685,14/05/2021,"Chateau Angelus Premier Grand Cru Classe B, Saint-Emilion Grand Cru",Bordeaux,2000,02/06/2021,10060452000,1006045
1800,08/06/2021,1815,3,1300,500,515,30/05/2019,"Gaja, Barbaresco",Piedmont,2007,09/06/2021,10996052007,1099605
950,08/06/2021,1086,27,842,108,244,22/08/2020,"Chateau Calon Segur 3eme Cru Classe, Saint-Estephe",Bordeaux,2019,09/06/2021,10074752019,1007475
14520,08/06/2021,14270,1,12000,2520,2270,28/05/2020,"Jacques-Frederic Mugnier, Chambolle-Musigny Premier Cru, Les Amoureuses",Burgundy,2014,09/06/2021,10496422014,1049642
2232,08/06/2021,2369,5,2190,42,179,01/05/2021,"Gaja, Barbaresco",Piedmont,2004,09/06/2021,10996052004,1099605
3758,08/06/2021,4050,97,3690,68,360,13/04/2021,"Chateau Margaux Premier Cru Classe, Margaux",Bordeaux,2011,09/06/2021,10127812011,1012781
350,03/05/2021,371,98,324,26,47,20/04/2021,"Chateau Batailley 5eme Cru Classe, Pauillac",Bordeaux,2014,05/05/2021,10063222014,1006322
1408,08/06/2021,1394,5,1238,170,156,02/11/2020,"Tignanello, Toscana",Tuscany,2006,09/06/2021,10953912006,1095391
3740,08/06/2021,3976,53,3520,220,456,07/04/2021,"Chateau Margaux Premier Cru Classe, Margaux",Bordeaux,2013,09/06/2021,10127812013,1012781
350,03/05/2021,371,97,324,26,47,20/04/2021,"Chateau Batailley 5eme Cru Classe, Pauillac",Bordeaux,2014,04/05/2021,10063222014,1006322
8400,08/06/2021,8933,1,5960,2440,2973,01/08/2017,"Domaine Leflaive, Chevalier-Montrachet Grand Cru",Burgundy,2010,09/06/2021,10734012010,1073401
1080,08/06/2021,1161,58,1036,44,125,27/05/2021,"Chateau Calon Segur 3eme Cru Classe, Saint-Estephe",Bordeaux,2016,09/06/2021,10074752016,1007475
1010,03/06/2021,1213,63,950,60,263,03/05/2021,"Chateau Calon Segur 3eme Cru Classe, Saint-Estephe",Bordeaux,2018,09/06/2021,10074752018,1007475
3900,08/06/2021,4431,108,3700,200,731,07/06/2021,"Chateau Margaux Premier Cru Classe, Margaux",Bordeaux,2008,09/06/2021,10127812008,1012781
1408,08/06/2021,1368,1,1150,258,218,21/04/2019,"Tignanello, Toscana",Tuscany,2005,09/06/2021,10953912005,1095391
1350,08/06/2021,1473,61,1260,90,213,18/02/2021,"Gaja, Barbaresco",Piedmont,2015,09/06/2021,10996052015,1099605
4920,01/06/2021,5196,12,4500,420,696,14/05/2021,"Chateau Angelus Premier Grand Cru Classe B, Saint-Emilion Grand Cru",Bordeaux,2000,05/06/2021,10060452000,1006045
4920,01/06/2021,5186,13,4500,420,686,14/05/2021,"Chateau Angelus Premier Grand Cru Classe B, Saint-Emilion Grand Cru",Bordeaux,2000,04/06/2021,10060452000,1006045
17180,18/05/2021,17180,0,6538,10642,10642,05/07/2016,"Jacques-Frederic Mugnier, Chambolle-Musigny Premier Cru, Les Amoureuses",Burgundy,2012,19/05/2021,10496422012,1049642
686,08/06/2021,828,13,682,4,146,15/09/2020,"Chateau Calon Segur 3eme Cru Classe, Saint-Estephe",Bordeaux,2013,09/06/2021,10074752013,1007475
1028,08/06/2021,1055,8,860,168,195,08/03/2021,"Tignanello, Toscana",Tuscany,2011,09/06/2021,10953912011,1095391
1245,08/06/2021,1545,3,882,363,663,26/04/2019,"Tignanello, Toscana",Tuscany,2003,09/06/2021,10953912003,1095391
870,08/06/2021,948,10,705,165,243,01/02/2021,"Chateau Calon Segur 3eme Cru Classe, Saint-Estephe",Bordeaux,2002,09/06/2021,10074752002,1007475
3900,08/06/2021,4613,95,3861,39,752,28/05/2021,"Chateau Margaux Premier Cru Classe, Margaux",Bordeaux,2006,09/06/2021,10127812006,1012781
520,08/06/2021,557,4,460,60,97,05/05/2020,"Tua Rita, Giusto di Notri, Toscana",Tuscany,2008,09/06/2021,11058072008,1105807
7906,08/06/2021,7792,2,7124,782,668,15/02/2019,"Domaine Leflaive, Chevalier-Montrachet Grand Cru",Burgundy,2016,09/06/2021,10734012016,1073401
477,03/05/2021,529,45,360,117,169,19/11/2020,"Chateau Batailley 5eme Cru Classe, Pauillac",Bordeaux,2016,04/05/2021,10063222016,1006322
475,08/06/2021,547,22,388,87,159,29/09/2020,"Tua Rita, Giusto di Notri, Toscana",Tuscany,2015,09/06/2021,11058072015,1105807
8000,08/06/2021,8614,6,6974,1026,1640,14/03/2021,"Domaine Leflaive, Chevalier-Montrachet Grand Cru",Burgundy,2017,09/06/2021,10734012017,1073401
4920,01/06/2021,5185,13,4500,420,685,14/05/2021,"Chateau Angelus Premier Grand Cru Classe B, Saint-Emilion Grand Cru",Bordeaux,2000,02/06/2021,10060452000,1006045
880,03/06/2021,949,14,781,99,168,16/11/2020,"Chateau Calon Segur 3eme Cru Classe, Saint-Estephe",Bordeaux,2008,09/06/2021,10074752008,1007475
3700,08/06/2021,4220,119,3660,40,560,02/06/2021,"Chateau Margaux Premier Cru Classe, Margaux",Bordeaux,2017,09/06/2021,10127812017,1012781
1150,03/06/2021,1231,11,1202,-52,29,10/05/2021,"Tignanello, Toscana",Tuscany,2015,09/06/2021,10953912015,1095391
4920,01/06/2021,5196,12,4500,420,696,14/05/2021,"Chateau Angelus Premier Grand Cru Classe B, Saint-Emilion Grand Cru",Bordeaux,2000,05/06/2021,10060452000,1006045
2872,08/06/2021,2872,1,2554,318,318,22/05/2020,"Gaja, Barbaresco",Piedmont,2006,09/06/2021,10996052006,1099605
1024,17/05/2021,1126,10,1072,-48,54,20/01/2021,"Tignanello, Toscana",Tuscany,2009,19/05/2021,10953912009,1095391
4920,28/05/2021,5185,13,4500,420,685,14/05/2021,"Chateau Angelus Premier Grand Cru Classe B, Saint-Emilion Grand Cru",Bordeaux,2000,29/05/2021,10060452000,1006045
1200,18/05/2021,1153,127,1108,92,45,08/05/2021,"Tignanello, Toscana",Tuscany,2016,19/05/2021,10953912016,1095391
1050,18/05/2021,1206,70,1048,2,158,27/04/2021,"Chateau Calon Segur 3eme Cru Classe, Saint-Estephe",Bordeaux,2016,19/05/2021,10074752016,1007475
5415,10/05/2021,5657,140,5150,265,507,03/05/2021,"Chateau Margaux Premier Cru Classe, Margaux",Bordeaux,2018,12/05/2021,10127812018,1012781
1100,11/05/2021,1536,7,1010,90,526,18/12/2020,"Tignanello, Toscana",Tuscany,2008,12/05/2021,10953912008,1095391
4920,28/05/2021,5185,13,4500,420,685,14/05/2021,"Chateau Angelus Premier Grand Cru Classe B, Saint-Emilion Grand Cru",Bordeaux,2000,29/05/2021,10060452000,1006045
4920,24/05/2021,5185,13,4500,420,685,14/05/2021,"Chateau Angelus Premier Grand Cru Classe B, Saint-Emilion Grand Cru",Bordeaux,2000,28/05/2021,10060452000,1006045
3800,11/05/2021,4083,53,3480,320,603,10/04/2021,"Chateau Margaux Premier Cru Classe, Margaux",Bordeaux,2014,12/05/2021,10127812014,1012781
7800,11/05/2021,8143,6,7000,800,1143,26/04/2021,"Domaine Leflaive, Chevalier-Montrachet Grand Cru",Burgundy,2018,12/05/2021,10734012018,1073401
3900,10/05/2021,4520,33,3684,216,836,10/06/2020,"Chateau Margaux Premier Cru Classe, Margaux",Bordeaux,2002,12/05/2021,10127812002,1012781
4920,24/05/2021,5198,12,4500,420,698,14/05/2021,"Chateau Angelus Premier Grand Cru Classe B, Saint-Emilion Grand Cru",Bordeaux,2000,25/05/2021,10060452000,1006045
430,04/05/2021,557,10,400,30,157,11/05/2021,"Chateau Batailley 5eme Cru Classe, Pauillac",Bordeaux,2006,15/05/2021,10063222006,1006322
850,11/05/2021,1098,97,860,-10,238,19/04/2021,"Chateau Calon Segur 3eme Cru Classe, Saint-Estephe",Bordeaux,2015,12/05/2021,10074752015,1007475
4920,24/05/2021,5198,12,4500,420,698,14/05/2021,"Chateau Angelus Premier Grand Cru Classe B, Saint-Emilion Grand Cru",Bordeaux,2000,25/05/2021,10060452000,1006045
4820,10/05/2021,4881,7,4160,660,721,19/03/2021,"Chateau Margaux Premier Cru Classe, Margaux",Bordeaux,2019,12/05/2021,10127812019,1012781
3860,10/05/2021,4791,77,3800,60,991,07/04/2021,"Chateau Margaux Premier Cru Classe, Margaux",Bordeaux,2006,12/05/2021,10127812006,1012781
4800,10/05/2021,5717,28,4800,0,917,11/03/2021,"Chateau Margaux Premier Cru Classe, Margaux",Bordeaux,2003,12/05/2021,10127812003,1012781
4920,24/05/2021,5185,13,4500,420,685,14/05/2021,"Chateau Angelus Premier Grand Cru Classe B, Saint-Emilion Grand Cru",Bordeaux,2000,28/05/2021,10060452000,1006045
900,11/05/2021,1177,14,850,50,327,28/01/2021,"Tignanello, Toscana",Tuscany,2012,12/05/2021,10953912012,1095391
3702,04/05/2021,3662,2,1200,2502,2462,16/05/2012,"Gaja, Barbaresco",Piedmont,2001,12/05/2021,10996052001,1099605
1050,11/05/2021,1206,70,1048,2,158,27/04/2021,"Chateau Calon Segur 3eme Cru Classe, Saint-Estephe",Bordeaux,2016,12/05/2021,10074752016,1007475
4920,18/05/2021,5004,14,4500,420,504,14/05/2021,"Chateau Angelus Premier Grand Cru Classe B, Saint-Emilion Grand Cru",Bordeaux,2000,19/05/2021,10060452000,1006045
8400,11/05/2021,8400,0,7200,1200,1200,06/11/2019,"Domaine Denis Mortet, Chambertin Grand Cru",Burgundy,2014,12/05/2021,10490202014,1049020
12456,11/05/2021,14434,2,12000,456,2434,28/05/2020,"Jacques-Frederic Mugnier, Chambolle-Musigny Premier Cru, Les Amoureuses",Burgundy,2014,12/05/2021,10496422014,1049642
866,11/05/2021,918,29,842,24,76,22/08/2020,"Chateau Calon Segur 3eme Cru Classe, Saint-Estephe",Bordeaux,2019,12/05/2021,10074752019,1007475
4920,18/05/2021,5198,12,4500,420,698,14/05/2021,"Chateau Angelus Premier Grand Cru Classe B, Saint-Emilion Grand Cru",Bordeaux,2000,20/05/2021,10060452000,1006045
4920,18/05/2021,5004,14,4500,420,504,14/05/2021,"Chateau Angelus Premier Grand Cru Classe B, Saint-Emilion Grand Cru",Bordeaux,2000,19/05/2021,10060452000,1006045
4920,18/05/2021,5198,12,4500,420,698,14/05/2021,"Chateau Angelus Premier Grand Cru Classe B, Saint-Emilion Grand Cru",Bordeaux,2000,20/05/2021,10060452000,1006045
4800,17/05/2021,5004,14,4500,300,504,14/05/2021,"Chateau Angelus Premier Grand Cru Classe B, Saint-Emilion Grand Cru",Bordeaux,2000,18/05/2021,10060452000,1006045
768,07/05/2021,902,9,705,63,197,01/02/2021,"Chateau Calon Segur 3eme Cru Classe, Saint-Estephe",Bordeaux,2002,12/05/2021,10074752002,1007475
1280,11/05/2021,1227,12,1172,108,55,07/04/2021,"Tignanello, Toscana",Tuscany,2010,12/05/2021,10953912010,1095391
4800,17/05/2021,5004,14,4500,300,504,14/05/2021,"Chateau Angelus Premier Grand Cru Classe B, Saint-Emilion Grand Cru",Bordeaux,2000,18/05/2021,10060452000,1006045
1500,11/05/2021,1676,36,1408,92,268,09/04/2021,"Gaja, Barbaresco",Piedmont,2016,12/05/2021,10996052016,1099605
4400,11/05/2021,4857,32,4400,0,457,29/09/2020,"Chateau Margaux Premier Cru Classe, Margaux",Bordeaux,2001,12/05/2021,10127812001,1012781
430,04/05/2021,557,10,400,30,157,11/05/2021,"Chateau Batailley 5eme Cru Classe, Pauillac",Bordeaux,2006,15/05/2021,10063222006,1006322
3850,11/05/2021,4163,43,3560,290,603,20/11/2020,"Chateau Margaux Premier Cru Classe, Margaux",Bordeaux,2012,12/05/2021,10127812012,1012781
660,11/05/2021,724,4,390,270,334,18/08/2017,"Tua Rita, Giusto di Notri, Toscana",Tuscany,2006,12/05/2021,11058072006,1105807
3827,11/05/2021,4512,71,4116,-289,396,25/02/2021,"Chateau Margaux Premier Cru Classe, Margaux",Bordeaux,2004,12/05/2021,10127812004,1012781
450,04/05/2021,450,1,340,110,110,31/08/2018,"Chateau Batailley 5eme Cru Classe, Pauillac",Bordeaux,2007,05/05/2021,10063222007,1006322
400,04/05/2021,487,5,332,68,155,06/10/2020,"Chateau Batailley 5eme Cru Classe, Pauillac",Bordeaux,2008,05/05/2021,10063222008,1006322
950,11/05/2021,1014,61,863,87,151,10/05/2021,"Chateau Calon Segur 3eme Cru Classe, Saint-Estephe",Bordeaux,2006,12/05/2021,10074752006,1007475
6800,11/05/2021,6800,1,1730,5070,5070,31/10/2011,"Domaine Leflaive, Chevalier-Montrachet Grand Cru",Burgundy,2003,12/05/2021,10734012003,1073401
3740,11/05/2021,3962,48,3520,220,442,07/04/2021,"Chateau Margaux Premier Cru Classe, Margaux",Bordeaux,2013,12/05/2021,10127812013,1012781
830,04/05/2021,982,4,735,95,247,09/09/2020,"Chateau Calon Segur 3eme Cru Classe, Saint-Estephe",Bordeaux,2012,12/05/2021,10074752012,1007475
1400,11/05/2021,1433,10,1276,124,157,05/03/2021,"Gaja, Barbaresco",Piedmont,2013,12/05/2021,10996052013,1099605
490,04/05/2021,551,23,504,-14,47,06/04/2021,"Chateau Batailley 5eme Cru Classe, Pauillac",Bordeaux,2009,06/05/2021,10063222009,1006322
460,11/05/2021,487,154,420,40,67,23/03/2021,"Tua Rita, Giusto di Notri, Toscana",Tuscany,2016,12/05/2021,11058072016,1105807
6250,11/05/2021,7445,56,5922,328,1523,13/04/2021,"Chateau Margaux Premier Cru Classe, Margaux",Bordeaux,2010,12/05/2021,10127812010,1012781
4800,14/05/2021,5011,12,4500,300,511,14/05/2021,"Chateau Angelus Premier Grand Cru Classe B, Saint-Emilion Grand Cru",Bordeaux,2000,15/05/2021,10060452000,1006045
995,11/05/2021,1122,18,1000,-5,122,12/04/2021,"Chateau Calon Segur 3eme Cru Classe, Saint-Estephe",Bordeaux,2010,12/05/2021,10074752010,1007475
1050,11/05/2021,1348,40,940,110,408,18/03/2021,"Chateau Calon Segur 3eme Cru Classe, Saint-Estephe",Bordeaux,2000,12/05/2021,10074752000,1007475
4800,14/05/2021,5011,12,4500,300,511,14/05/2021,"Chateau Angelus Premier Grand Cru Classe B, Saint-Emilion Grand Cru",Bordeaux,2000,15/05/2021,10060452000,1006045
1596,11/05/2021,1596,0,1300,296,296,27/04/2021,"Gaja, Barbaresco",Piedmont,2012,12/05/2021,10996052012,1099605
6250,11/05/2021,7040,47,6116,134,924,07/05/2021,"Chateau Margaux Premier Cru Classe, Margaux",Bordeaux,2005,12/05/2021,10127812005,1012781
1000,11/05/2021,1057,9,860,140,197,08/03/2021,"Tignanello, Toscana",Tuscany,2011,12/05/2021,10953912011,1095391
1480,03/05/2021,1604,73,1356,124,248,20/04/2021,"Gaja, Barbaresco",Piedmont,2017,12/05/2021,10996052017,1099605
880,11/05/2021,943,10,725,155,218,13/04/2021,"Chateau Calon Segur 3eme Cru Classe, Saint-Estephe",Bordeaux,2007,12/05/2021,10074752007,1007475
4800,13/05/2021,5011,12,4480,320,531,12/11/2019,"Chateau Angelus Premier Grand Cru Classe B, Saint-Emilion Grand Cru",Bordeaux,2000,14/05/2021,10060452000,1006045
870,06/05/2021,1036,66,920,-50,116,10/05/2021,"Tignanello, Toscana",Tuscany,2018,12/05/2021,10953912018,1095391
1020,11/05/2021,1170,78,975,45,195,12/04/2021,"Chateau Calon Segur 3eme Cru Classe, Saint-Estephe",Bordeaux,2005,12/05/2021,10074752005,1007475
738,03/05/2021,891,127,760,-22,131,29/04/2021,"Chateau Calon Segur 3eme Cru Classe, Saint-Estephe",Bordeaux,2017,12/05/2021,10074752017,1007475
3700,11/05/2021,4148,151,3700,0,448,06/05/2021,"Chateau Margaux Premier Cru Classe, Margaux",Bordeaux,2017,12/05/2021,10127812017,1012781
1060,05/05/2021,1113,205,1108,-48,5,08/05/2021,"Tignanello, Toscana",Tuscany,2016,12/05/2021,10953912016,1095391
1380,11/05/2021,1454,7,1352,28,102,23/09/2020,"Gaja, Barbaresco",Piedmont,2011,12/05/2021,10996052011,1099605
8000,11/05/2021,8606,8,6974,1026,1632,14/03/2021,"Domaine Leflaive, Chevalier-Montrachet Grand Cru",Burgundy,2017,12/05/2021,10734012017,1073401
10500,11/05/2021,12398,74,9844,656,2554,29/03/2021,"Chateau Margaux Premier Cru Classe, Margaux",Bordeaux,2015,12/05/2021,10127812015,1012781
490,04/05/2021,551,23,504,-14,47,06/04/2021,"Chateau Batailley 5eme Cru Classe, Pauillac",Bordeaux,2009,06/05/2021,10063222009,1006322
2260,11/05/2021,2305,4,2190,70,115,01/05/2021,"Gaja, Barbaresco",Piedmont,2004,12/05/2021,10996052004,1099605
490,04/05/2021,551,24,504,-14,47,06/04/2021,"Chateau Batailley 5eme Cru Classe, Pauillac",Bordeaux,2009,05/05/2021,10063222009,1006322
3800,11/05/2021,4374,128,3690,110,684,13/04/2021,"Chateau Margaux Premier Cru Classe, Margaux",Bordeaux,2011,12/05/2021,10127812011,1012781
4800,13/05/2021,5011,12,4480,320,531,12/11/2019,"Chateau Angelus Premier Grand Cru Classe B, Saint-Emilion Grand Cru",Bordeaux,2000,14/05/2021,10060452000,1006045
490,04/05/2021,551,24,504,-14,47,06/04/2021,"Chateau Batailley 5eme Cru Classe, Pauillac",Bordeaux,2009,05/05/2021,10063222009,1006322
520,11/05/2021,575,4,460,60,115,05/05/2020,"Tua Rita, Giusto di Notri, Toscana",Tuscany,2008,12/05/2021,11058072008,1105807
7906,05/05/2021,7852,2,7124,782,728,15/02/2019,"Domaine Leflaive, Chevalier-Montrachet Grand Cru",Burgundy,2016,12/05/2021,10734012016,1073401
8040,11/05/2021,8232,20,7950,90,282,12/03/2021,"Chateau Margaux Premier Cru Classe, Margaux",Bordeaux,2000,12/05/2021,10127812000,1012781
780,11/05/2021,836,6,682,98,154,15/09/2020,"Chateau Calon Segur 3eme Cru Classe, Saint-Estephe",Bordeaux,2013,12/05/2021,10074752013,1007475
5580,10/05/2021,5698,90,5288,292,410,03/05/2021,"Chateau Margaux Premier Cru Classe, Margaux",Bordeaux,2016,12/05/2021,10127812016,1012781
400,04/05/2021,467,9,355,45,112,15/04/2021,"Chateau Batailley 5eme Cru Classe, Pauillac",Bordeaux,2012,05/05/2021,10063222012,1006322
6750,11/05/2021,7939,81,6412,338,1527,25/03/2021,"Chateau Margaux Premier Cru Classe, Margaux",Bordeaux,2009,12/05/2021,10127812009,1012781
12402,11/05/2021,12557,2,12850,-448,-293,30/11/2020,"Jacques-Frederic Mugnier, Chambolle-Musigny Premier Cru, Les Amoureuses",Burgundy,2011,12/05/2021,10496422011,1049642
3920,11/05/2021,4451,91,3880,40,571,22/03/2021,"Chateau Margaux Premier Cru Classe, Margaux",Bordeaux,2008,12/05/2021,10127812008,1012781
6250,18/05/2021,7088,42,6116,134,972,07/05/2021,"Chateau Margaux Premier Cru Classe, Margaux",Bordeaux,2005,19/05/2021,10127812005,1012781
17000,12/05/2021,15189,7,13000,4000,2189,29/04/2021,"Jacques-Frederic Mugnier, Chambolle-Musigny Premier Cru, Les Amoureuses",Burgundy,2017,19/05/2021,10496422017,1049642
4800,11/05/2021,5003,14,4480,320,523,12/11/2019,"Chateau Angelus Premier Grand Cru Classe B, Saint-Emilion Grand Cru",Bordeaux,2000,12/05/2021,10060452000,1006045
10650,18/05/2021,10047,1,4000,6650,6047,25/04/2016,"Domaine Denis Mortet, Chambertin Grand Cru",Burgundy,2013,19/05/2021,10490202013,1049020
8016,18/05/2021,9840,3,7290,726,2550,21/08/2020,"Domaine Denis Mortet, Chambertin Grand Cru",Burgundy,2017,19/05/2021,10490202017,1049020
4800,11/05/2021,5003,14,4480,320,523,12/11/2019,"Chateau Angelus Premier Grand Cru Classe B, Saint-Emilion Grand Cru",Bordeaux,2000,12/05/2021,10060452000,1006045
3750,24/06/2021,4182,41,3560,190,622,20/11/2020,"Chateau Margaux Premier Cru Classe, Margaux",Bordeaux,2012,04/07/2021,10127812012,1012781
3860,10/05/2021,4823,76,3800,60,1023,07/04/2021,"Chateau Margaux Premier Cru Classe, Margaux",Bordeaux,2006,19/05/2021,10127812006,1012781
4800,10/05/2021,5020,14,4480,320,540,12/11/2019,"Chateau Angelus Premier Grand Cru Classe B, Saint-Emilion Grand Cru",Bordeaux,2000,11/05/2021,10060452000,1006045
8100,02/07/2021,8994,13,8100,0,894,21/06/2021,"Chateau Margaux Premier Cru Classe, Margaux",Bordeaux,2000,05/07/2021,10127812000,1012781
900,02/07/2021,1146,23,800,100,346,21/11/2019,"Chateau Calon Segur 3eme Cru Classe, Saint-Estephe",Bordeaux,2003,05/07/2021,10074752003,1007475
3826,02/07/2021,4507,54,4116,-290,391,25/02/2021,"Chateau Margaux Premier Cru Classe, Margaux",Bordeaux,2004,05/07/2021,10127812004,1012781
4800,10/05/2021,5020,14,4480,320,540,12/11/2019,"Chateau Angelus Premier Grand Cru Classe B, Saint-Emilion Grand Cru",Bordeaux,2000,11/05/2021,10060452000,1006045
800,02/07/2021,922,18,745,55,177,16/11/2020,"Chateau Calon Segur 3eme Cru Classe, Saint-Estephe",Bordeaux,2004,05/07/2021,10074752004,1007475
6400,02/07/2021,7276,24,6776,-376,500,10/06/2021,"Chateau Margaux Premier Cru Classe, Margaux",Bordeaux,2005,05/07/2021,10127812005,1012781
6830,02/07/2021,7788,45,7086,-256,702,11/06/2021,"Chateau Margaux Premier Cru Classe, Margaux",Bordeaux,2009,05/07/2021,10127812009,1012781
400,04/05/2021,467,9,355,45,112,15/04/2021,"Chateau Batailley 5eme Cru Classe, Pauillac",Bordeaux,2012,05/05/2021,10063222012,1006322
3750,18/05/2021,4096,29,3592,158,504,06/05/2021,"Chateau Margaux Premier Cru Classe, Margaux",Bordeaux,2007,19/05/2021,10127812007,1012781
1398,18/05/2021,1432,11,1276,122,156,05/03/2021,"Gaja, Barbaresco",Piedmont,2013,19/05/2021,10996052013,1099605
1800,18/05/2021,1671,2,1440,360,231,04/01/2018,"Gaja, Barbaresco",Piedmont,2010,19/05/2021,10996052010,1099605
840,18/05/2021,1095,98,860,-20,235,19/04/2021,"Chateau Calon Segur 3eme Cru Classe, Saint-Estephe",Bordeaux,2015,19/05/2021,10074752015,1007475
1500,18/05/2021,1688,36,1408,92,280,09/04/2021,"Gaja, Barbaresco",Piedmont,2016,19/05/2021,10996052016,1099605
3850,18/05/2021,4180,41,3560,290,620,20/11/2020,"Chateau Margaux Premier Cru Classe, Margaux",Bordeaux,2012,19/05/2021,10127812012,1012781
950,18/05/2021,1015,62,863,87,152,10/05/2021,"Chateau Calon Segur 3eme Cru Classe, Saint-Estephe",Bordeaux,2006,19/05/2021,10074752006,1007475
6400,05/07/2021,7550,49,5950,450,1600,23/06/2021,"Chateau Margaux Premier Cru Classe, Margaux",Bordeaux,2010,06/07/2021,10127812010,1012781
300,04/05/2021,301,108,304,-4,-3,10/01/2021,"Chateau Batailley 5eme Cru Classe, Pauillac",Bordeaux,2013,05/05/2021,10063222013,1006322
990,05/07/2021,1134,16,990,0,144,16/06/2021,"Chateau Calon Segur 3eme Cru Classe, Saint-Estephe",Bordeaux,2010,06/07/2021,10074752010,1007475
4800,07/05/2021,5029,12,4480,320,549,12/11/2019,"Chateau Angelus Premier Grand Cru Classe B, Saint-Emilion Grand Cru",Bordeaux,2000,10/05/2021,10060452000,1006045
790,18/05/2021,974,17,745,45,229,16/11/2020,"Chateau Calon Segur 3eme Cru Classe, Saint-Estephe",Bordeaux,2004,19/05/2021,10074752004,1007475
750,18/05/2021,888,124,760,-10,128,17/05/2021,"Chateau Calon Segur 3eme Cru Classe, Saint-Estephe",Bordeaux,2017,19/05/2021,10074752017,1007475
1100,18/05/2021,1536,7,1010,90,526,18/12/2020,"Tignanello, Toscana",Tuscany,2008,19/05/2021,10953912008,1095391
1100,17/05/2021,1536,7,1010,90,526,18/12/2020,"Tignanello, Toscana",Tuscany,2008,18/05/2021,10953912008,1095391
4800,07/05/2021,5059,13,4480,320,579,12/11/2019,"Chateau Angelus Premier Grand Cru Classe B, Saint-Emilion Grand Cru",Bordeaux,2000,08/05/2021,10060452000,1006045
3827,17/05/2021,4520,69,4116,-289,404,25/02/2021,"Chateau Margaux Premier Cru Classe, Margaux",Bordeaux,2004,18/05/2021,10127812004,1012781
4800,07/05/2021,5029,12,4480,320,549,12/11/2019,"Chateau Angelus Premier Grand Cru Classe B, Saint-Emilion Grand Cru",Bordeaux,2000,10/05/2021,10060452000,1006045
496,04/05/2021,527,35,312,184,215,12/03/2021,"Chateau Batailley 5eme Cru Classe, Pauillac",Bordeaux,2015,05/05/2021,10063222015,1006322
4800,07/05/2021,5059,13,4480,320,579,12/11/2019,"Chateau Angelus Premier Grand Cru Classe B, Saint-Emilion Grand Cru",Bordeaux,2000,08/05/2021,10060452000,1006045
16200,17/05/2021,16056,0,18750,-2550,-2694,29/08/2018,"Jacques-Frederic Mugnier, Chambolle-Musigny Premier Cru, Les Amoureuses",Burgundy,2015,18/05/2021,10496422015,1049642
496,04/05/2021,518,9,312,184,206,12/03/2021,"Chateau Batailley 5eme Cru Classe, Pauillac",Bordeaux,2015,08/05/2021,10063222015,1006322
5415,10/05/2021,5669,140,5150,265,519,03/05/2021,"Chateau Margaux Premier Cru Classe, Margaux",Bordeaux,2018,18/05/2021,10127812018,1012781
5580,14/05/2021,5713,83,5238,342,475,17/05/2021,"Chateau Margaux Premier Cru Classe, Margaux",Bordeaux,2016,18/05/2021,10127812016,1012781
800,17/05/2021,891,139,814,-14,77,13/05/2021,"Tignanello, Toscana",Tuscany,2017,18/05/2021,10953912017,1095391
8040,17/05/2021,8232,20,7950,90,282,12/03/2021,"Chateau Margaux Premier Cru Classe, Margaux",Bordeaux,2000,18/05/2021,10127812000,1012781
900,17/05/2021,1043,62,940,-40,103,13/05/2021,"Tignanello, Toscana",Tuscany,2018,18/05/2021,10953912018,1095391
3800,17/05/2021,4076,44,3480,320,596,10/04/2021,"Chateau Margaux Premier Cru Classe, Margaux",Bordeaux,2014,18/05/2021,10127812014,1012781
750,04/05/2021,888,124,760,-10,128,17/05/2021,"Chateau Calon Segur 3eme Cru Classe, Saint-Estephe",Bordeaux,2017,18/05/2021,10074752017,1007475
3860,10/05/2021,4837,74,3800,60,1037,07/04/2021,"Chateau Margaux Premier Cru Classe, Margaux",Bordeaux,2006,18/05/2021,10127812006,1012781
4400,12/05/2021,4900,7,4160,240,740,19/03/2021,"Chateau Margaux Premier Cru Classe, Margaux",Bordeaux,2019,18/05/2021,10127812019,1012781
3750,17/05/2021,4084,28,3592,158,492,06/05/2021,"Chateau Margaux Premier Cru Classe, Margaux",Bordeaux,2007,18/05/2021,10127812007,1012781
3950,17/05/2021,4467,84,3800,150,667,12/05/2021,"Chateau Margaux Premier Cru Classe, Margaux",Bordeaux,2008,18/05/2021,10127812008,1012781
6300,17/05/2021,7623,45,5922,378,1701,13/04/2021,"Chateau Margaux Premier Cru Classe, Margaux",Bordeaux,2010,18/05/2021,10127812010,1012781
477,04/05/2021,538,45,360,117,178,19/11/2020,"Chateau Batailley 5eme Cru Classe, Pauillac",Bordeaux,2016,05/05/2021,10063222016,1006322
12456,17/05/2021,14434,2,12000,456,2434,28/05/2020,"Jacques-Frederic Mugnier, Chambolle-Musigny Premier Cru, Les Amoureuses",Burgundy,2014,18/05/2021,10496422014,1049642
4800,06/05/2021,5059,13,4480,320,579,12/11/2019,"Chateau Angelus Premier Grand Cru Classe B, Saint-Emilion Grand Cru",Bordeaux,2000,07/05/2021,10060452000,1006045
4800,06/05/2021,5059,13,4480,320,579,12/11/2019,"Chateau Angelus Premier Grand Cru Classe B, Saint-Emilion Grand Cru",Bordeaux,2000,07/05/2021,10060452000,1006045
4800,05/05/2021,5069,13,4480,320,589,12/11/2019,"Chateau Angelus Premier Grand Cru Classe B, Saint-Emilion Grand Cru",Bordeaux,2000,06/05/2021,10060452000,1006045
1000,17/05/2021,1170,78,975,25,195,12/04/2021,"Chateau Calon Segur 3eme Cru Classe, Saint-Estephe",Bordeaux,2005,18/05/2021,10074752005,1007475
660,17/05/2021,724,4,390,270,334,18/08/2017,"Tua Rita, Giusto di Notri, Toscana",Tuscany,2006,18/05/2021,11058072006,1105807
1400,17/05/2021,1433,10,1276,124,157,05/03/2021,"Gaja, Barbaresco",Piedmont,2013,18/05/2021,10996052013,1099605
995,17/05/2021,1116,19,1000,-5,116,12/04/2021,"Chateau Calon Segur 3eme Cru Classe, Saint-Estephe",Bordeaux,2010,18/05/2021,10074752010,1007475
1350,17/05/2021,1452,7,1352,-2,100,23/09/2020,"Gaja, Barbaresco",Piedmont,2011,18/05/2021,10996052011,1099605
7906,13/05/2021,8103,1,7124,782,979,15/02/2019,"Domaine Leflaive, Chevalier-Montrachet Grand Cru",Burgundy,2016,18/05/2021,10734012016,1073401
6800,17/05/2021,6800,1,1730,5070,5070,31/10/2011,"Domaine Leflaive, Chevalier-Montrachet Grand Cru",Burgundy,2003,18/05/2021,10734012003,1073401
3700,17/05/2021,4137,131,3700,0,437,06/05/2021,"Chateau Margaux Premier Cru Classe, Margaux",Bordeaux,2017,18/05/2021,10127812017,1012781
709,13/05/2021,815,9,682,27,133,15/09/2020,"Chateau Calon Segur 3eme Cru Classe, Saint-Estephe",Bordeaux,2013,18/05/2021,10074752013,1007475
6250,14/05/2021,6962,37,6116,134,846,07/05/2021,"Chateau Margaux Premier Cru Classe, Margaux",Bordeaux,2005,18/05/2021,10127812005,1012781
1000,17/05/2021,1237,17,1047,-47,190,27/04/2021,"Chateau Calon Segur 3eme Cru Classe, Saint-Estephe",Bordeaux,2009,18/05/2021,10074752009,1007475
4800,05/05/2021,5069,13,4480,320,589,12/11/2019,"Chateau Angelus Premier Grand Cru Classe B, Saint-Emilion Grand Cru",Bordeaux,2000,06/05/2021,10060452000,1006045
900,17/05/2021,1063,22,850,50,213,28/01/2021,"Tignanello, Toscana",Tuscany,2012,18/05/2021,10953912012,1095391
7800,11/05/2021,8133,7,7000,800,1133,26/04/2021,"Domaine Leflaive, Chevalier-Montrachet Grand Cru",Burgundy,2018,18/05/2021,10734012018,1073401
625,05/05/2021,676,9,470,155,206,29/03/2018,"Chateau Batailley 5eme Cru Classe, Pauillac",Bordeaux,2000,07/05/2021,10063222000,1006322
900,17/05/2021,1057,23,800,100,257,21/11/2019,"Chateau Calon Segur 3eme Cru Classe, Saint-Estephe",Bordeaux,2003,18/05/2021,10074752003,1007475
625,05/05/2021,687,10,470,155,217,29/03/2018,"Chateau Batailley 5eme Cru Classe, Pauillac",Bordeaux,2000,06/05/2021,10063222000,1006322
1800,17/05/2021,1840,2,1300,500,540,30/05/2019,"Gaja, Barbaresco",Piedmont,2007,18/05/2021,10996052007,1099605
2260,17/05/2021,2305,4,2190,70,115,01/05/2021,"Gaja, Barbaresco",Piedmont,2004,18/05/2021,10996052004,1099605
625,05/05/2021,687,10,470,155,217,29/03/2018,"Chateau Batailley 5eme Cru Classe, Pauillac",Bordeaux,2000,06/05/2021,10063222000,1006322
2872,17/05/2021,2872,2,2554,318,318,22/05/2020,"Gaja, Barbaresco",Piedmont,2006,18/05/2021,10996052006,1099605
4800,04/05/2021,5069,13,4480,320,589,12/11/2019,"Chateau Angelus Premier Grand Cru Classe B, Saint-Emilion Grand Cru",Bordeaux,2000,05/05/2021,10060452000,1006045
520,17/05/2021,575,4,460,60,115,05/05/2020,"Tua Rita, Giusto di Notri, Toscana",Tuscany,2008,18/05/2021,11058072008,1105807
4800,04/05/2021,5069,13,4480,320,589,12/11/2019,"Chateau Angelus Premier Grand Cru Classe B, Saint-Emilion Grand Cru",Bordeaux,2000,05/05/2021,10060452000,1006045
6650,14/05/2021,7991,69,6500,150,1491,12/05/2021,"Chateau Margaux Premier Cru Classe, Margaux",Bordeaux,2009,18/05/2021,10127812009,1012781
1200,14/05/2021,1152,126,1108,92,44,08/05/2021,"Tignanello, Toscana",Tuscany,2016,18/05/2021,10953912016,1095391
768,14/05/2021,901,11,705,63,196,01/02/2021,"Chateau Calon Segur 3eme Cru Classe, Saint-Estephe",Bordeaux,2002,18/05/2021,10074752002,1007475
1350,17/05/2021,1465,47,1260,90,205,18/02/2021,"Gaja, Barbaresco",Piedmont,2015,18/05/2021,10996052015,1099605
4400,17/05/2021,4883,27,4400,0,483,29/09/2020,"Chateau Margaux Premier Cru Classe, Margaux",Bordeaux,2001,18/05/2021,10127812001,1012781
4850,13/05/2021,5732,27,4800,50,932,11/03/2021,"Chateau Margaux Premier Cru Classe, Margaux",Bordeaux,2003,18/05/2021,10127812003,1012781
3850,17/05/2021,4165,41,3560,290,605,20/11/2020,"Chateau Margaux Premier Cru Classe, Margaux",Bordeaux,2012,18/05/2021,10127812012,1012781
6396,10/05/2021,6856,3,7900,-1504,-1044,29/04/2019,"Domaine Leflaive, Chevalier-Montrachet Grand Cru",Burgundy,2015,18/05/2021,10734012015,1073401
1050,17/05/2021,1206,70,1048,2,158,27/04/2021,"Chateau Calon Segur 3eme Cru Classe, Saint-Estephe",Bordeaux,2016,18/05/2021,10074752016,1007475
3740,17/05/2021,3968,47,3520,220,448,07/04/2021,"Chateau Margaux Premier Cru Classe, Margaux",Bordeaux,2013,18/05/2021,10127812013,1012781
4800,03/05/2021,5069,13,4480,320,589,12/11/2019,"Chateau Angelus Premier Grand Cru Classe B, Saint-Emilion Grand Cru",Bordeaux,2000,04/05/2021,10060452000,1006045
625,05/05/2021,676,9,470,155,206,29/03/2018,"Chateau Batailley 5eme Cru Classe, Pauillac",Bordeaux,2000,07/05/2021,10063222000,1006322
4800,03/05/2021,5069,13,4480,320,589,12/11/2019,"Chateau Angelus Premier Grand Cru Classe B, Saint-Emilion Grand Cru",Bordeaux,2000,04/05/2021,10060452000,1006045
530,05/05/2021,621,50,450,80,171,04/05/2021,"Chateau Batailley 5eme Cru Classe, Pauillac",Bordeaux,2005,06/05/2021,10063222005,1006322
850,17/05/2021,1098,97,860,-10,238,19/04/2021,"Chateau Calon Segur 3eme Cru Classe, Saint-Estephe",Bordeaux,2015,18/05/2021,10074752015,1007475
6900,17/05/2021,6900,0,6405,495,495,19/07/2019,"Domaine Leflaive, Chevalier-Montrachet Grand Cru",Burgundy,2005,18/05/2021,10734012005,1073401
3900,17/05/2021,4543,31,3684,216,859,10/06/2020,"Chateau Margaux Premier Cru Classe, Margaux",Bordeaux,2002,18/05/2021,10127812002,1012781
460,17/05/2021,486,149,420,40,66,23/03/2021,"Tua Rita, Giusto di Notri, Toscana",Tuscany,2016,18/05/2021,11058072016,1105807
6552,17/05/2021,6552,0,3920,2632,2632,26/04/2017,"Domaine Leflaive, Chevalier-Montrachet Grand Cru",Burgundy,2006,18/05/2021,10734012006,1073401
1024,17/05/2021,1125,10,1072,-48,53,20/01/2021,"Tignanello, Toscana",Tuscany,2009,18/05/2021,10953912009,1095391
3758,17/05/2021,4399,119,3690,68,709,13/04/2021,"Chateau Margaux Premier Cru Classe, Margaux",Bordeaux,2011,18/05/2021,10127812011,1012781
1040,04/05/2021,1198,61,950,90,248,03/05/2021,"Chateau Calon Segur 3eme Cru Classe, Saint-Estephe",Bordeaux,2018,18/05/2021,10074752018,1007475
530,05/05/2021,621,50,450,80,171,04/05/2021,"Chateau Batailley 5eme Cru Classe, Pauillac",Bordeaux,2005,06/05/2021,10063222005,1006322
12402,17/05/2021,12557,2,12850,-448,-293,30/11/2020,"Jacques-Frederic Mugnier, Chambolle-Musigny Premier Cru, Les Amoureuses",Burgundy,2011,18/05/2021,10496422011,1049642
1500,14/05/2021,1680,36,1408,92,272,09/04/2021,"Gaja, Barbaresco",Piedmont,2016,18/05/2021,10996052016,1099605
504,17/05/2021,522,1,300,204,222,03/11/2011,"Tua Rita, Giusto di Notri, Toscana",Tuscany,2007,18/05/2021,11058072007,1105807
420,05/05/2021,483,6,532,-112,-49,11/02/2021,"Chateau Batailley 5eme Cru Classe, Pauillac",Bordeaux,2006,06/05/2021,10063222006,1006322
908,17/05/2021,1072,33,805,103,267,20/11/2019,"Chateau Calon Segur 3eme Cru Classe, Saint-Estephe",Bordeaux,2001,18/05/2021,10074752001,1007475
750,17/05/2021,1013,35,790,-40,223,01/06/2020,"Chateau Calon Segur 3eme Cru Classe, Saint-Estephe",Bordeaux,2011,18/05/2021,10074752011,1007475
1010,14/05/2021,1040,13,860,150,180,08/03/2021,"Tignanello, Toscana",Tuscany,2011,18/05/2021,10953912011,1095391
10500,17/05/2021,12510,69,9844,656,2666,29/03/2021,"Chateau Margaux Premier Cru Classe, Margaux",Bordeaux,2015,18/05/2021,10127812015,1012781
8000,17/05/2021,8606,8,6974,1026,1632,14/03/2021,"Domaine Leflaive, Chevalier-Montrachet Grand Cru",Burgundy,2017,18/05/2021,10734012017,1073401
1000,17/05/2021,1237,17,1047,-47,190,27/04/2021,"Chateau Calon Segur 3eme Cru Classe, Saint-Estephe",Bordeaux,2009,18/05/2021,10074752009,1007475
3600,27/07/2021,3766,2,3101,499,665,26/11/2020,"Chateau Angelus Premier Grand Cru Classe B, Saint-Emilion Grand Cru",Bordeaux,2001,28/07/2021,10060452001,1006045
3600,27/07/2021,3766,2,3101,499,665,26/11/2020,"Chateau Angelus Premier Grand Cru Classe B, Saint-Emilion Grand Cru",Bordeaux,2001,28/07/2021,10060452001,1006045
4850,13/05/2021,5822,27,4800,50,1022,11/03/2021,"Chateau Margaux Premier Cru Classe, Margaux",Bordeaux,2003,19/05/2021,10127812003,1012781
1120,13/05/2021,1341,8,1172,-52,169,07/04/2021,"Tignanello, Toscana",Tuscany,2010,19/05/2021,10953912010,1095391
5580,18/05/2021,5716,84,5238,342,478,17/05/2021,"Chateau Margaux Premier Cru Classe, Margaux",Bordeaux,2016,19/05/2021,10127812016,1012781
6400,06/07/2021,7276,24,6776,-376,500,10/06/2021,"Chateau Margaux Premier Cru Classe, Margaux",Bordeaux,2005,07/07/2021,10127812005,1012781
3600,26/07/2021,3766,2,3101,499,665,26/11/2020,"Chateau Angelus Premier Grand Cru Classe B, Saint-Emilion Grand Cru",Bordeaux,2001,27/07/2021,10060452001,1006045
420,05/05/2021,483,6,532,-112,-49,11/02/2021,"Chateau Batailley 5eme Cru Classe, Pauillac",Bordeaux,2006,06/05/2021,10063222006,1006322
3827,18/05/2021,4519,71,4116,-289,403,25/02/2021,"Chateau Margaux Premier Cru Classe, Margaux",Bordeaux,2004,19/05/2021,10127812004,1012781
12402,18/05/2021,12557,2,12850,-448,-293,30/11/2020,"Jacques-Frederic Mugnier, Chambolle-Musigny Premier Cru, Les Amoureuses",Burgundy,2011,19/05/2021,10496422011,1049642
3740,18/05/2021,3972,48,3520,220,452,07/04/2021,"Chateau Margaux Premier Cru Classe, Margaux",Bordeaux,2013,19/05/2021,10127812013,1012781
5415,10/05/2021,5675,145,5150,265,525,03/05/2021,"Chateau Margaux Premier Cru Classe, Margaux",Bordeaux,2018,19/05/2021,10127812018,1012781
7800,18/05/2021,8079,7,7000,800,1079,26/04/2021,"Domaine Leflaive, Chevalier-Montrachet Grand Cru",Burgundy,2018,19/05/2021,10734012018,1073401
400,05/05/2021,487,5,332,68,155,06/10/2020,"Chateau Batailley 5eme Cru Classe, Pauillac",Bordeaux,2008,06/05/2021,10063222008,1006322
6650,18/05/2021,8031,69,6500,150,1531,12/05/2021,"Chateau Margaux Premier Cru Classe, Margaux",Bordeaux,2009,19/05/2021,10127812009,1012781
400,05/05/2021,467,9,355,45,112,15/04/2021,"Chateau Batailley 5eme Cru Classe, Pauillac",Bordeaux,2012,06/05/2021,10063222012,1006322
400,05/05/2021,467,9,355,45,112,15/04/2021,"Chateau Batailley 5eme Cru Classe, Pauillac",Bordeaux,2012,06/05/2021,10063222012,1006322
1480,13/05/2021,1620,74,1358,122,262,12/05/2021,"Gaja, Barbaresco",Piedmont,2017,19/05/2021,10996052017,1099605
1944,18/05/2021,1944,0,1300,644,644,27/04/2021,"Gaja, Barbaresco",Piedmont,2012,19/05/2021,10996052012,1099605
840,14/05/2021,927,16,781,59,146,16/11/2020,"Chateau Calon Segur 3eme Cru Classe, Saint-Estephe",Bordeaux,2008,19/05/2021,10074752008,1007475
300,05/05/2021,301,108,304,-4,-3,10/01/2021,"Chateau Batailley 5eme Cru Classe, Pauillac",Bordeaux,2013,06/05/2021,10063222013,1006322
1000,18/05/2021,1264,24,1047,-47,217,27/04/2021,"Chateau Calon Segur 3eme Cru Classe, Saint-Estephe",Bordeaux,2009,19/05/2021,10074752009,1007475
3600,26/07/2021,3766,2,3101,499,665,26/11/2020,"Chateau Angelus Premier Grand Cru Classe B, Saint-Emilion Grand Cru",Bordeaux,2001,27/07/2021,10060452001,1006045
1350,18/05/2021,1456,7,1352,-2,104,23/09/2020,"Gaja, Barbaresco",Piedmont,2011,19/05/2021,10996052011,1099605
3600,18/05/2021,4398,124,3690,-90,708,13/04/2021,"Chateau Margaux Premier Cru Classe, Margaux",Bordeaux,2011,19/05/2021,10127812011,1012781
1000,18/05/2021,1172,83,975,25,197,12/04/2021,"Chateau Calon Segur 3eme Cru Classe, Saint-Estephe",Bordeaux,2005,19/05/2021,10074752005,1007475
3600,23/07/2021,3766,2,3101,499,665,26/11/2020,"Chateau Angelus Premier Grand Cru Classe B, Saint-Emilion Grand Cru",Bordeaux,2001,24/07/2021,10060452001,1006045
3600,23/07/2021,3766,2,3101,499,665,26/11/2020,"Chateau Angelus Premier Grand Cru Classe B, Saint-Emilion Grand Cru",Bordeaux,2001,24/07/2021,10060452001,1006045
8000,18/05/2021,8606,8,6974,1026,1632,14/03/2021,"Domaine Leflaive, Chevalier-Montrachet Grand Cru",Burgundy,2017,19/05/2021,10734012017,1073401
1050,18/05/2021,1344,48,940,110,404,18/03/2021,"Chateau Calon Segur 3eme Cru Classe, Saint-Estephe",Bordeaux,2000,19/05/2021,10074752000,1007475
3600,22/07/2021,3766,2,3101,499,665,26/11/2020,"Chateau Angelus Premier Grand Cru Classe B, Saint-Emilion Grand Cru",Bordeaux,2001,23/07/2021,10060452001,1006045
3600,22/07/2021,3766,2,3101,499,665,26/11/2020,"Chateau Angelus Premier Grand Cru Classe B, Saint-Emilion Grand Cru",Bordeaux,2001,23/07/2021,10060452001,1006045
3800,14/05/2021,4076,44,3480,320,596,10/04/2021,"Chateau Margaux Premier Cru Classe, Margaux",Bordeaux,2014,17/05/2021,10127812014,1012781
10500,14/05/2021,12486,70,9844,656,2642,29/03/2021,"Chateau Margaux Premier Cru Classe, Margaux",Bordeaux,2015,17/05/2021,10127812015,1012781
3700,14/05/2021,4141,131,3700,0,441,06/05/2021,"Chateau Margaux Premier Cru Classe, Margaux",Bordeaux,2017,17/05/2021,10127812017,1012781
7000,10/05/2021,6895,1,5360,1640,1535,18/09/2020,"Domaine Leflaive, Chevalier-Montrachet Grand Cru",Burgundy,2009,17/05/2021,10734012009,1073401
1120,13/05/2021,1305,8,1172,-52,133,07/04/2021,"Tignanello, Toscana",Tuscany,2010,17/05/2021,10953912010,1095391
900,14/05/2021,1043,62,940,-40,103,13/05/2021,"Tignanello, Toscana",Tuscany,2018,17/05/2021,10953912018,1095391
3600,21/07/2021,3766,2,3101,499,665,26/11/2020,"Chateau Angelus Premier Grand Cru Classe B, Saint-Emilion Grand Cru",Bordeaux,2001,22/07/2021,10060452001,1006045
3600,21/07/2021,3766,2,3101,499,665,26/11/2020,"Chateau Angelus Premier Grand Cru Classe B, Saint-Emilion Grand Cru",Bordeaux,2001,22/07/2021,10060452001,1006045
6300,14/05/2021,7621,45,5922,378,1699,13/04/2021,"Chateau Margaux Premier Cru Classe, Margaux",Bordeaux,2010,17/05/2021,10127812010,1012781
3740,14/05/2021,3965,47,3520,220,445,07/04/2021,"Chateau Margaux Premier Cru Classe, Margaux",Bordeaux,2013,17/05/2021,10127812013,1012781
5580,14/05/2021,5711,85,5288,292,423,03/05/2021,"Chateau Margaux Premier Cru Classe, Margaux",Bordeaux,2016,17/05/2021,10127812016,1012781
3950,14/05/2021,4467,84,3800,150,667,12/05/2021,"Chateau Margaux Premier Cru Classe, Margaux",Bordeaux,2008,17/05/2021,10127812008,1012781
3600,20/07/2021,3766,2,3101,499,665,26/11/2020,"Chateau Angelus Premier Grand Cru Classe B, Saint-Emilion Grand Cru",Bordeaux,2001,21/07/2021,10060452001,1006045
3600,20/07/2021,3766,2,3101,499,665,26/11/2020,"Chateau Angelus Premier Grand Cru Classe B, Saint-Emilion Grand Cru",Bordeaux,2001,21/07/2021,10060452001,1006045
6250,14/05/2021,6952,38,6116,134,836,07/05/2021,"Chateau Margaux Premier Cru Classe, Margaux",Bordeaux,2005,17/05/2021,10127812005,1012781
6250,14/05/2021,6952,38,6116,134,836,07/05/2021,"Chateau Margaux Premier Cru Classe, Margaux",Bordeaux,2005,17/05/2021,10127812005,1012781
1120,13/05/2021,1305,8,1172,-52,133,07/04/2021,"Tignanello, Toscana",Tuscany,2010,17/05/2021,10953912010,1095391
895,06/07/2021,926,42,863,32,63,10/05/2021,"Chateau Calon Segur 3eme Cru Classe, Saint-Estephe",Bordeaux,2006,07/07/2021,10074752006,1007475
3900,06/07/2021,4655,88,3822,78,833,20/06/2021,"Chateau Margaux Premier Cru Classe, Margaux",Bordeaux,2006,07/07/2021,10127812006,1012781
850,29/06/2021,1078,85,822,28,256,28/06/2021,"Chateau Calon Segur 3eme Cru Classe, Saint-Estephe",Bordeaux,2015,30/06/2021,10074752015,1007475
3600,19/07/2021,3766,2,3101,499,665,26/11/2020,"Chateau Angelus Premier Grand Cru Classe B, Saint-Emilion Grand Cru",Bordeaux,2001,20/07/2021,10060452001,1006045
768,14/05/2021,926,13,705,63,221,01/02/2021,"Chateau Calon Segur 3eme Cru Classe, Saint-Estephe",Bordeaux,2002,19/05/2021,10074752002,1007475
800,17/05/2021,889,120,814,-14,75,13/05/2021,"Tignanello, Toscana",Tuscany,2017,19/05/2021,10953912017,1095391
3950,18/05/2021,4461,89,3800,150,661,12/05/2021,"Chateau Margaux Premier Cru Classe, Margaux",Bordeaux,2008,19/05/2021,10127812008,1012781
709,13/05/2021,818,9,682,27,136,15/09/2020,"Chateau Calon Segur 3eme Cru Classe, Saint-Estephe",Bordeaux,2013,19/05/2021,10074752013,1007475
1800,18/05/2021,1919,0,1768,32,151,22/05/2020,"Gaja, Barbaresco",Piedmont,2000,19/05/2021,10996052000,1099605
477,05/05/2021,538,45,360,117,178,19/11/2020,"Chateau Batailley 5eme Cru Classe, Pauillac",Bordeaux,2016,06/05/2021,10063222016,1006322
750,17/05/2021,1024,46,790,-40,234,01/06/2020,"Chateau Calon Segur 3eme Cru Classe, Saint-Estephe",Bordeaux,2011,19/05/2021,10074752011,1007475
790,13/05/2021,929,41,794,-4,135,20/04/2021,"Chateau Calon Segur 3eme Cru Classe, Saint-Estephe",Bordeaux,2014,19/05/2021,10074752014,1007475
3826,05/07/2021,4507,54,4116,-290,391,25/02/2021,"Chateau Margaux Premier Cru Classe, Margaux",Bordeaux,2004,06/07/2021,10127812004,1012781
4450,05/07/2021,4717,21,4400,50,317,29/09/2020,"Chateau Margaux Premier Cru Classe, Margaux",Bordeaux,2001,06/07/2021,10127812001,1012781
3900,05/07/2021,4469,26,3684,216,785,10/06/2020,"Chateau Margaux Premier Cru Classe, Margaux",Bordeaux,2002,06/07/2021,10127812002,1012781
3600,19/07/2021,3766,2,3101,499,665,26/11/2020,"Chateau Angelus Premier Grand Cru Classe B, Saint-Emilion Grand Cru",Bordeaux,2001,20/07/2021,10060452001,1006045
3600,16/07/2021,3766,2,3101,499,665,26/11/2020,"Chateau Angelus Premier Grand Cru Classe B, Saint-Emilion Grand Cru",Bordeaux,2001,19/07/2021,10060452001,1006045
800,05/07/2021,922,18,745,55,177,16/11/2020,"Chateau Calon Segur 3eme Cru Classe, Saint-Estephe",Bordeaux,2004,06/07/2021,10074752004,1007475
907,05/07/2021,924,18,805,102,119,20/11/2019,"Chateau Calon Segur 3eme Cru Classe, Saint-Estephe",Bordeaux,2001,06/07/2021,10074752001,1007475
412,06/05/2021,437,2,220,192,217,17/06/2015,"Chateau Batailley 5eme Cru Classe, Pauillac",Bordeaux,2002,07/05/2021,10063222002,1006322
450,06/05/2021,450,1,340,110,110,31/08/2018,"Chateau Batailley 5eme Cru Classe, Pauillac",Bordeaux,2007,07/05/2021,10063222007,1006322
400,06/05/2021,472,6,332,68,140,06/10/2020,"Chateau Batailley 5eme Cru Classe, Pauillac",Bordeaux,2008,07/05/2021,10063222008,1006322
3600,16/07/2021,3766,2,3101,499,665,26/11/2020,"Chateau Angelus Premier Grand Cru Classe B, Saint-Emilion Grand Cru",Bordeaux,2001,19/07/2021,10060452001,1006045
490,06/05/2021,551,23,504,-14,47,06/04/2021,"Chateau Batailley 5eme Cru Classe, Pauillac",Bordeaux,2009,07/05/2021,10063222009,1006322
811,13/05/2021,973,6,735,76,238,09/09/2020,"Chateau Calon Segur 3eme Cru Classe, Saint-Estephe",Bordeaux,2012,19/05/2021,10074752012,1007475
6300,18/05/2021,7632,52,5922,378,1710,13/04/2021,"Chateau Margaux Premier Cru Classe, Margaux",Bordeaux,2010,19/05/2021,10127812010,1012781
1700,18/05/2021,1674,3,1378,322,296,29/07/2020,"Tignanello, Toscana",Tuscany,2001,19/05/2021,10953912001,1095391
6400,02/07/2021,7550,49,5950,450,1600,23/06/2021,"Chateau Margaux Premier Cru Classe, Margaux",Bordeaux,2010,05/07/2021,10127812010,1012781
960,30/06/2021,1039,9,880,80,159,22/06/2021,"Tignanello, Toscana",Tuscany,2011,05/07/2021,10953912011,1095391
3740,02/07/2021,4000,49,3520,220,480,07/04/2021,"Chateau Margaux Premier Cru Classe, Margaux",Bordeaux,2013,05/07/2021,10127812013,1012781
504,18/05/2021,522,1,300,204,222,03/11/2011,"Tua Rita, Giusto di Notri, Toscana",Tuscany,2007,19/05/2021,11058072007,1105807
3790,15/07/2021,3727,2,3101,689,626,26/11/2020,"Chateau Angelus Premier Grand Cru Classe B, Saint-Emilion Grand Cru",Bordeaux,2001,29/07/2021,10060452001,1006045
3720,18/05/2021,4107,49,3480,240,627,10/04/2021,"Chateau Margaux Premier Cru Classe, Margaux",Bordeaux,2014,19/05/2021,10127812014,1012781
900,18/05/2021,1080,20,850,50,230,28/01/2021,"Tignanello, Toscana",Tuscany,2012,19/05/2021,10953912012,1095391
1200,18/05/2021,1202,10,1202,-2,0,10/05/2021,"Tignanello, Toscana",Tuscany,2015,19/05/2021,10953912015,1095391
3790,15/07/2021,3743,2,3101,689,642,26/11/2020,"Chateau Angelus Premier Grand Cru Classe B, Saint-Emilion Grand Cru",Bordeaux,2001,03/08/2021,10060452001,1006045
16200,18/05/2021,16056,0,18750,-2550,-2694,29/08/2018,"Jacques-Frederic Mugnier, Chambolle-Musigny Premier Cru, Les Amoureuses",Burgundy,2015,19/05/2021,10496422015,1049642
3790,15/07/2021,3727,2,3101,689,626,26/11/2020,"Chateau Angelus Premier Grand Cru Classe B, Saint-Emilion Grand Cru",Bordeaux,2001,29/07/2021,10060452001,1006045
3790,15/07/2021,3766,2,3101,689,665,26/11/2020,"Chateau Angelus Premier Grand Cru Classe B, Saint-Emilion Grand Cru",Bordeaux,2001,16/07/2021,10060452001,1006045
3720,02/07/2021,4324,127,3480,240,844,17/06/2021,"Chateau Margaux Premier Cru Classe, Margaux",Bordeaux,2014,05/07/2021,10127812014,1012781
3790,15/07/2021,3766,2,3101,689,665,26/11/2020,"Chateau Angelus Premier Grand Cru Classe B, Saint-Emilion Grand Cru",Bordeaux,2001,16/07/2021,10060452001,1006045
850,02/07/2021,1084,81,822,28,262,28/06/2021,"Chateau Calon Segur 3eme Cru Classe, Saint-Estephe",Bordeaux,2015,05/07/2021,10074752015,1007475
10400,02/07/2021,11861,49,9800,600,2061,11/06/2021,"Chateau Margaux Premier Cru Classe, Margaux",Bordeaux,2015,05/07/2021,10127812015,1012781
490,06/05/2021,551,23,504,-14,47,06/04/2021,"Chateau Batailley 5eme Cru Classe, Pauillac",Bordeaux,2009,07/05/2021,10063222009,1006322
2260,18/05/2021,2305,4,2190,70,115,01/05/2021,"Gaja, Barbaresco",Piedmont,2004,19/05/2021,10996052004,1099605
1050,18/05/2021,1213,12,860,190,353,08/03/2021,"Tignanello, Toscana",Tuscany,2013,19/05/2021,10953912013,1095391
5415,02/07/2021,5830,130,5238,177,592,17/05/2021,"Chateau Margaux Premier Cru Classe, Margaux",Bordeaux,2016,05/07/2021,10127812016,1012781
1100,02/07/2021,1222,68,1036,64,186,27/05/2021,"Chateau Calon Segur 3eme Cru Classe, Saint-Estephe",Bordeaux,2016,05/07/2021,10074752016,1007475
400,06/05/2021,467,9,355,45,112,15/04/2021,"Chateau Batailley 5eme Cru Classe, Pauillac",Bordeaux,2012,07/05/2021,10063222012,1006322
880,18/05/2021,986,13,725,155,261,13/04/2021,"Chateau Calon Segur 3eme Cru Classe, Saint-Estephe",Bordeaux,2007,19/05/2021,10074752007,1007475
8040,18/05/2021,8315,20,7950,90,365,12/03/2021,"Chateau Margaux Premier Cru Classe, Margaux",Bordeaux,2000,19/05/2021,10127812000,1012781
995,18/05/2021,1129,19,1000,-5,129,12/04/2021,"Chateau Calon Segur 3eme Cru Classe, Saint-Estephe",Bordeaux,2010,19/05/2021,10074752010,1007475
3790,15/07/2021,3743,2,3101,689,642,26/11/2020,"Chateau Angelus Premier Grand Cru Classe B, Saint-Emilion Grand Cru",Bordeaux,2001,03/08/2021,10060452001,1006045
3790,22/06/2021,3513,2,3101,689,412,26/11/2020,"Chateau Angelus Premier Grand Cru Classe B, Saint-Emilion Grand Cru",Bordeaux,2001,26/06/2021,10060452001,1006045
520,18/05/2021,575,4,460,60,115,05/05/2020,"Tua Rita, Giusto di Notri, Toscana",Tuscany,2008,19/05/2021,11058072008,1105807
460,18/05/2021,486,149,420,40,66,23/03/2021,"Tua Rita, Giusto di Notri, Toscana",Tuscany,2016,19/05/2021,11058072016,1105807
1020,18/05/2021,1197,61,950,70,247,03/05/2021,"Chateau Calon Segur 3eme Cru Classe, Saint-Estephe",Bordeaux,2018,19/05/2021,10074752018,1007475
1280,18/05/2021,1318,5,1200,80,118,06/03/2021,"Tignanello, Toscana",Tuscany,2007,19/05/2021,10953912007,1095391
3790,22/06/2021,3566,3,3101,689,465,26/11/2020,"Chateau Angelus Premier Grand Cru Classe B, Saint-Emilion Grand Cru",Bordeaux,2001,23/06/2021,10060452001,1006045
4400,18/05/2021,4883,27,4400,0,483,29/09/2020,"Chateau Margaux Premier Cru Classe, Margaux",Bordeaux,2001,19/05/2021,10127812001,1012781
1500,02/07/2021,1677,42,1408,92,269,09/04/2021,"Gaja, Barbaresco",Piedmont,2016,05/07/2021,10996052016,1099605
3790,22/06/2021,3566,3,3101,689,465,26/11/2020,"Chateau Angelus Premier Grand Cru Classe B, Saint-Emilion Grand Cru",Bordeaux,2001,23/06/2021,10060452001,1006045
3790,02/07/2021,4272,99,3950,-160,322,30/06/2021,"Chateau Margaux Premier Cru Classe, Margaux",Bordeaux,2017,05/07/2021,10127812017,1012781
1700,18/05/2021,1817,2,1300,400,517,30/05/2019,"Gaja, Barbaresco",Piedmont,2007,19/05/2021,10996052007,1099605
3790,22/06/2021,3513,2,3101,689,412,26/11/2020,"Chateau Angelus Premier Grand Cru Classe B, Saint-Emilion Grand Cru",Bordeaux,2001,26/06/2021,10060452001,1006045
400,06/05/2021,467,9,355,45,112,15/04/2021,"Chateau Batailley 5eme Cru Classe, Pauillac",Bordeaux,2012,07/05/2021,10063222012,1006322
300,06/05/2021,301,108,304,-4,-3,10/01/2021,"Chateau Batailley 5eme Cru Classe, Pauillac",Bordeaux,2013,07/05/2021,10063222013,1006322
660,18/05/2021,724,4,390,270,334,18/08/2017,"Tua Rita, Giusto di Notri, Toscana",Tuscany,2006,19/05/2021,11058072006,1105807
3790,22/06/2021,3560,2,3101,689,459,26/11/2020,"Chateau Angelus Premier Grand Cru Classe B, Saint-Emilion Grand Cru",Bordeaux,2001,09/07/2021,10060452001,1006045
3790,22/06/2021,3560,2,3101,689,459,26/11/2020,"Chateau Angelus Premier Grand Cru Classe B, Saint-Emilion Grand Cru",Bordeaux,2001,09/07/2021,10060452001,1006045
950,18/05/2021,1098,45,830,120,268,18/04/2021,"Tignanello, Toscana",Tuscany,2014,19/05/2021,10953912014,1095391
1010,18/05/2021,1048,11,860,150,188,08/03/2021,"Tignanello, Toscana",Tuscany,2011,19/05/2021,10953912011,1095391
2872,18/05/2021,2872,2,2554,318,318,22/05/2020,"Gaja, Barbaresco",Piedmont,2006,19/05/2021,10996052006,1099605
477,06/05/2021,538,45,440,37,98,06/05/2021,"Chateau Batailley 5eme Cru Classe, Pauillac",Bordeaux,2016,07/05/2021,10063222016,1006322
1350,02/07/2021,1480,56,1260,90,220,18/02/2021,"Gaja, Barbaresco",Piedmont,2015,05/07/2021,10996052015,1099605
15600,30/06/2021,15271,5,13000,2600,2271,29/04/2021,"Jacques-Frederic Mugnier, Chambolle-Musigny Premier Cru, Les Amoureuses",Burgundy,2017,05/07/2021,10496422017,1049642
3790,22/06/2021,3766,2,3101,689,665,26/11/2020,"Chateau Angelus Premier Grand Cru Classe B, Saint-Emilion Grand Cru",Bordeaux,2001,13/07/2021,10060452001,1006045
5600,02/07/2021,5852,100,5254,346,598,26/05/2021,"Chateau Margaux Premier Cru Classe, Margaux",Bordeaux,2018,05/07/2021,10127812018,1012781
857,30/06/2021,995,129,848,9,147,02/07/2021,"Tignanello, Toscana",Tuscany,2017,05/07/2021,10953912017,1095391
1516,29/06/2021,1630,65,1398,118,232,01/07/2021,"Gaja, Barbaresco",Piedmont,2017,05/07/2021,10996052017,1099605
3790,22/06/2021,3766,2,3101,689,665,26/11/2020,"Chateau Angelus Premier Grand Cru Classe B, Saint-Emilion Grand Cru",Bordeaux,2001,13/07/2021,10060452001,1006045
6400,05/07/2021,7276,24,6776,-376,500,10/06/2021,"Chateau Margaux Premier Cru Classe, Margaux",Bordeaux,2005,06/07/2021,10127812005,1012781
3790,07/06/2021,3558,2,3101,689,457,26/11/2020,"Chateau Angelus Premier Grand Cru Classe B, Saint-Emilion Grand Cru",Bordeaux,2001,12/06/2021,10060452001,1006045
1000,05/07/2021,1160,87,988,12,172,28/05/2021,"Chateau Calon Segur 3eme Cru Classe, Saint-Estephe",Bordeaux,2005,06/07/2021,10074752005,1007475
625,07/05/2021,676,9,470,155,206,29/03/2018,"Chateau Batailley 5eme Cru Classe, Pauillac",Bordeaux,2000,08/05/2021,10063222000,1006322
10400,29/06/2021,11947,51,9800,600,2147,11/06/2021,"Chateau Margaux Premier Cru Classe, Margaux",Bordeaux,2015,30/06/2021,10127812015,1012781
625,07/05/2021,679,8,470,155,209,29/03/2018,"Chateau Batailley 5eme Cru Classe, Pauillac",Bordeaux,2000,09/05/2021,10063222000,1006322
14520,29/06/2021,14520,1,12000,2520,2520,28/05/2020,"Jacques-Frederic Mugnier, Chambolle-Musigny Premier Cru, Les Amoureuses",Burgundy,2014,30/06/2021,10496422014,1049642
487,29/06/2021,535,24,388,99,147,29/09/2020,"Tua Rita, Giusto di Notri, Toscana",Tuscany,2015,30/06/2021,11058072015,1105807
2199,17/06/2021,2225,2,1340,859,885,13/03/2020,"Gaja, Barbaresco",Piedmont,2009,21/06/2021,10996052009,1099605
7800,18/06/2021,8255,5,7330,470,925,02/06/2021,"Domaine Leflaive, Chevalier-Montrachet Grand Cru",Burgundy,2018,21/06/2021,10734012018,1073401
4850,18/06/2021,5672,27,4842,8,830,19/05/2021,"Chateau Margaux Premier Cru Classe, Margaux",Bordeaux,2003,21/06/2021,10127812003,1012781
625,07/05/2021,676,9,470,155,206,29/03/2018,"Chateau Batailley 5eme Cru Classe, Pauillac",Bordeaux,2000,08/05/2021,10063222000,1006322
920,08/06/2021,1246,14,850,70,396,28/01/2021,"Tignanello, Toscana",Tuscany,2012,21/06/2021,10953912012,1095391
1300,18/06/2021,1443,7,1352,-52,91,23/09/2020,"Gaja, Barbaresco",Piedmont,2011,21/06/2021,10996052011,1099605
10500,18/06/2021,11907,53,9800,700,2107,11/06/2021,"Chateau Margaux Premier Cru Classe, Margaux",Bordeaux,2015,21/06/2021,10127812015,1012781
5578,17/06/2021,5825,105,5238,340,587,17/05/2021,"Chateau Margaux Premier Cru Classe, Margaux",Bordeaux,2016,21/06/2021,10127812016,1012781
1080,18/06/2021,1223,46,950,130,273,03/05/2021,"Chateau Calon Segur 3eme Cru Classe, Saint-Estephe",Bordeaux,2018,21/06/2021,10074752018,1007475
3790,07/06/2021,3566,3,3101,689,465,26/11/2020,"Chateau Angelus Premier Grand Cru Classe B, Saint-Emilion Grand Cru",Bordeaux,2001,15/06/2021,10060452001,1006045
3740,18/06/2021,3975,52,3520,220,455,07/04/2021,"Chateau Margaux Premier Cru Classe, Margaux",Bordeaux,2013,21/06/2021,10127812013,1012781
3700,18/06/2021,4223,115,3646,54,577,16/06/2021,"Chateau Margaux Premier Cru Classe, Margaux",Bordeaux,2017,21/06/2021,10127812017,1012781
3790,07/06/2021,3787,2,3101,689,686,26/11/2020,"Chateau Angelus Premier Grand Cru Classe B, Saint-Emilion Grand Cru",Bordeaux,2001,08/06/2021,10060452001,1006045
625,07/05/2021,679,8,470,155,209,29/03/2018,"Chateau Batailley 5eme Cru Classe, Pauillac",Bordeaux,2000,09/05/2021,10063222000,1006322
3900,18/06/2021,4618,86,3822,78,796,20/06/2021,"Chateau Margaux Premier Cru Classe, Margaux",Bordeaux,2006,21/06/2021,10127812006,1012781
2098,18/06/2021,2300,4,2190,-92,110,01/05/2021,"Gaja, Barbaresco",Piedmont,2004,21/06/2021,10996052004,1099605
3790,07/06/2021,3558,2,3101,689,457,26/11/2020,"Chateau Angelus Premier Grand Cru Classe B, Saint-Emilion Grand Cru",Bordeaux,2001,12/06/2021,10060452001,1006045
1024,17/06/2021,1222,5,1072,-48,150,20/01/2021,"Tignanello, Toscana",Tuscany,2009,21/06/2021,10953912009,1095391
907,18/06/2021,953,23,805,102,148,20/11/2019,"Chateau Calon Segur 3eme Cru Classe, Saint-Estephe",Bordeaux,2001,21/06/2021,10074752001,1007475
3900,18/06/2021,4221,71,3700,200,521,07/06/2021,"Chateau Margaux Premier Cru Classe, Margaux",Bordeaux,2008,21/06/2021,10127812008,1012781
3826,18/06/2021,4516,51,4116,-290,400,25/02/2021,"Chateau Margaux Premier Cru Classe, Margaux",Bordeaux,2004,21/06/2021,10127812004,1012781
3790,07/06/2021,3566,3,3101,689,465,26/11/2020,"Chateau Angelus Premier Grand Cru Classe B, Saint-Emilion Grand Cru",Bordeaux,2001,15/06/2021,10060452001,1006045
3790,07/06/2021,3787,2,3101,689,686,26/11/2020,"Chateau Angelus Premier Grand Cru Classe B, Saint-Emilion Grand Cru",Bordeaux,2001,08/06/2021,10060452001,1006045
1100,14/06/2021,1216,68,1036,64,180,27/05/2021,"Chateau Calon Segur 3eme Cru Classe, Saint-Estephe",Bordeaux,2016,21/06/2021,10074752016,1007475
540,17/06/2021,532,3,300,240,232,03/11/2011,"Tua Rita, Giusto di Notri, Toscana",Tuscany,2007,21/06/2021,11058072007,1105807
840,17/06/2021,1091,76,860,-20,231,19/04/2021,"Chateau Calon Segur 3eme Cru Classe, Saint-Estephe",Bordeaux,2015,21/06/2021,10074752015,1007475
1000,18/06/2021,1144,76,988,12,156,28/05/2021,"Chateau Calon Segur 3eme Cru Classe, Saint-Estephe",Bordeaux,2005,21/06/2021,10074752005,1007475
1408,17/06/2021,1376,4,1238,170,138,02/11/2020,"Tignanello, Toscana",Tuscany,2006,21/06/2021,10953912006,1095391
3750,17/06/2021,4029,83,3690,60,339,13/04/2021,"Chateau Margaux Premier Cru Classe, Margaux",Bordeaux,2011,21/06/2021,10127812011,1012781
3720,18/06/2021,4290,138,3480,240,810,17/06/2021,"Chateau Margaux Premier Cru Classe, Margaux",Bordeaux,2014,21/06/2021,10127812014,1012781
1596,18/06/2021,1596,1,1145,451,451,22/10/2015,"Gaja, Barbaresco",Piedmont,2003,21/06/2021,10996052003,1099605
3791,26/05/2021,3787,2,3101,690,686,26/11/2020,"Chateau Angelus Premier Grand Cru Classe B, Saint-Emilion Grand Cru",Bordeaux,2001,27/05/2021,10060452001,1006045
686,18/06/2021,838,8,682,4,156,15/09/2020,"Chateau Calon Segur 3eme Cru Classe, Saint-Estephe",Bordeaux,2013,21/06/2021,10074752013,1007475
1700,17/06/2021,1636,3,1378,322,258,29/07/2020,"Tignanello, Toscana",Tuscany,2001,21/06/2021,10953912001,1095391
1310,17/06/2021,1398,5,1172,138,226,07/04/2021,"Tignanello, Toscana",Tuscany,2010,21/06/2021,10953912010,1095391
3791,26/05/2021,3787,2,3101,690,686,26/11/2020,"Chateau Angelus Premier Grand Cru Classe B, Saint-Emilion Grand Cru",Bordeaux,2001,27/05/2021,10060452001,1006045
6830,17/06/2021,7675,46,7086,-256,589,11/06/2021,"Chateau Margaux Premier Cru Classe, Margaux",Bordeaux,2009,21/06/2021,10127812009,1012781
16200,29/06/2021,16040,0,18750,-2550,-2710,29/08/2018,"Jacques-Frederic Mugnier, Chambolle-Musigny Premier Cru, Les Amoureuses",Burgundy,2015,30/06/2021,10496422015,1049642
5307,28/06/2021,5790,117,5238,69,552,17/05/2021,"Chateau Margaux Premier Cru Classe, Margaux",Bordeaux,2016,30/06/2021,10127812016,1012781
3791,10/05/2021,3670,3,3101,690,569,26/11/2020,"Chateau Angelus Premier Grand Cru Classe B, Saint-Emilion Grand Cru",Bordeaux,2001,12/05/2021,10060452001,1006045
1100,29/06/2021,1220,68,1036,64,184,27/05/2021,"Chateau Calon Segur 3eme Cru Classe, Saint-Estephe",Bordeaux,2016,30/06/2021,10074752016,1007475
412,07/05/2021,437,2,220,192,217,17/06/2015,"Chateau Batailley 5eme Cru Classe, Pauillac",Bordeaux,2002,08/05/2021,10063222002,1006322
1238,28/06/2021,1268,37,1100,138,168,28/06/2021,"Tignanello, Toscana",Tuscany,2016,30/06/2021,10953912016,1095391
7906,29/06/2021,7792,2,7124,782,668,15/02/2019,"Domaine Leflaive, Chevalier-Montrachet Grand Cru",Burgundy,2016,30/06/2021,10734012016,1073401
3791,10/05/2021,3712,3,3101,690,611,26/11/2020,"Chateau Angelus Premier Grand Cru Classe B, Saint-Emilion Grand Cru",Bordeaux,2001,16/05/2021,10060452001,1006045
750,17/06/2021,929,102,740,10,189,21/05/2021,"Chateau Calon Segur 3eme Cru Classe, Saint-Estephe",Bordeaux,2017,30/06/2021,10074752017,1007475
3790,28/06/2021,4221,105,3646,144,575,16/06/2021,"Chateau Margaux Premier Cru Classe, Margaux",Bordeaux,2017,30/06/2021,10127812017,1012781
10500,02/06/2021,12169,50,9844,656,2325,29/03/2021,"Chateau Margaux Premier Cru Classe, Margaux",Bordeaux,2015,07/06/2021,10127812015,1012781
1299,27/05/2021,1502,7,1010,289,492,18/12/2020,"Tignanello, Toscana",Tuscany,2008,07/06/2021,10953912008,1095391
3900,04/06/2021,4447,99,3800,100,647,12/05/2021,"Chateau Margaux Premier Cru Classe, Margaux",Bordeaux,2008,07/06/2021,10127812008,1012781
3720,04/06/2021,4295,145,3480,240,815,10/04/2021,"Chateau Margaux Premier Cru Classe, Margaux",Bordeaux,2014,07/06/2021,10127812014,1012781
589,07/05/2021,621,50,450,139,171,04/05/2021,"Chateau Batailley 5eme Cru Classe, Pauillac",Bordeaux,2005,08/05/2021,10063222005,1006322
3791,10/05/2021,3787,2,3101,690,686,26/11/2020,"Chateau Angelus Premier Grand Cru Classe B, Saint-Emilion Grand Cru",Bordeaux,2001,21/05/2021,10060452001,1006045
1408,07/06/2021,1394,5,1238,170,156,02/11/2020,"Tignanello, Toscana",Tuscany,2006,08/06/2021,10953912006,1095391
17000,12/05/2021,15268,7,13000,4000,2268,29/04/2021,"Jacques-Frederic Mugnier, Chambolle-Musigny Premier Cru, Les Amoureuses",Burgundy,2017,13/05/2021,10496422017,1049642
780,12/05/2021,891,139,907,-127,-16,03/05/2021,"Tignanello, Toscana",Tuscany,2017,13/05/2021,10953912017,1095391
6250,12/05/2021,7040,47,6116,134,924,07/05/2021,"Chateau Margaux Premier Cru Classe, Margaux",Bordeaux,2005,13/05/2021,10127812005,1012781
540,12/05/2021,540,1,300,240,240,03/11/2011,"Tua Rita, Giusto di Notri, Toscana",Tuscany,2007,13/05/2021,11058072007,1105807
589,07/05/2021,621,50,450,139,171,04/05/2021,"Chateau Batailley 5eme Cru Classe, Pauillac",Bordeaux,2005,08/05/2021,10063222005,1006322
1700,12/05/2021,1674,3,1378,322,296,29/07/2020,"Tignanello, Toscana",Tuscany,2001,13/05/2021,10953912001,1095391
3800,12/05/2021,4374,128,3690,110,684,13/04/2021,"Chateau Margaux Premier Cru Classe, Margaux",Bordeaux,2011,13/05/2021,10127812011,1012781
3791,10/05/2021,3787,2,3101,690,686,26/11/2020,"Chateau Angelus Premier Grand Cru Classe B, Saint-Emilion Grand Cru",Bordeaux,2001,21/05/2021,10060452001,1006045
1480,03/05/2021,1604,73,1358,122,246,12/05/2021,"Gaja, Barbaresco",Piedmont,2017,13/05/2021,10996052017,1099605
8240,12/05/2021,8720,1,5960,2280,2760,01/08/2017,"Domaine Leflaive, Chevalier-Montrachet Grand Cru",Burgundy,2010,13/05/2021,10734012010,1073401
3791,10/05/2021,3648,3,3101,690,547,26/11/2020,"Chateau Angelus Premier Grand Cru Classe B, Saint-Emilion Grand Cru",Bordeaux,2001,11/05/2021,10060452001,1006045
3791,10/05/2021,3712,3,3101,690,611,26/11/2020,"Chateau Angelus Premier Grand Cru Classe B, Saint-Emilion Grand Cru",Bordeaux,2001,16/05/2021,10060452001,1006045
3791,10/05/2021,3670,3,3101,690,569,26/11/2020,"Chateau Angelus Premier Grand Cru Classe B, Saint-Emilion Grand Cru",Bordeaux,2001,12/05/2021,10060452001,1006045
1000,12/05/2021,1167,79,975,25,192,12/04/2021,"Chateau Calon Segur 3eme Cru Classe, Saint-Estephe",Bordeaux,2005,13/05/2021,10074752005,1007475
3740,12/05/2021,3962,48,3520,220,442,07/04/2021,"Chateau Margaux Premier Cru Classe, Margaux",Bordeaux,2013,13/05/2021,10127812013,1012781
1380,12/05/2021,1454,7,1352,28,102,23/09/2020,"Gaja, Barbaresco",Piedmont,2011,13/05/2021,10996052011,1099605
400,07/05/2021,482,5,532,-132,-50,11/02/2021,"Chateau Batailley 5eme Cru Classe, Pauillac",Bordeaux,2006,08/05/2021,10063222006,1006322
5580,12/05/2021,5698,90,5288,292,410,03/05/2021,"Chateau Margaux Premier Cru Classe, Margaux",Bordeaux,2016,13/05/2021,10127812016,1012781
3791,10/05/2021,3648,3,3101,690,547,26/11/2020,"Chateau Angelus Premier Grand Cru Classe B, Saint-Emilion Grand Cru",Bordeaux,2001,11/05/2021,10060452001,1006045
850,12/05/2021,1098,97,860,-10,238,19/04/2021,"Chateau Calon Segur 3eme Cru Classe, Saint-Estephe",Bordeaux,2015,13/05/2021,10074752015,1007475
2973,10/08/2021,3137,9,2610,363,527,10/01/2017,"Chateau Angelus Premier Grand Cru Classe B, Saint-Emilion Grand Cru",Bordeaux,2002,11/08/2021,10060452002,1006045
400,07/05/2021,482,5,532,-132,-50,11/02/2021,"Chateau Batailley 5eme Cru Classe, Pauillac",Bordeaux,2006,08/05/2021,10063222006,1006322
450,07/05/2021,450,1,340,110,110,31/08/2018,"Chateau Batailley 5eme Cru Classe, Pauillac",Bordeaux,2007,08/05/2021,10063222007,1006322
1000,12/05/2021,1229,16,1047,-47,182,27/04/2021,"Chateau Calon Segur 3eme Cru Classe, Saint-Estephe",Bordeaux,2009,13/05/2021,10074752009,1007475
1050,12/05/2021,1206,70,1048,2,158,27/04/2021,"Chateau Calon Segur 3eme Cru Classe, Saint-Estephe",Bordeaux,2016,13/05/2021,10074752016,1007475
995,12/05/2021,1122,18,1000,-5,122,12/04/2021,"Chateau Calon Segur 3eme Cru Classe, Saint-Estephe",Bordeaux,2010,13/05/2021,10074752010,1007475
1280,12/05/2021,1227,12,1172,108,55,07/04/2021,"Tignanello, Toscana",Tuscany,2010,13/05/2021,10953912010,1095391
1110,04/05/2021,1197,11,1202,-92,-5,10/05/2021,"Tignanello, Toscana",Tuscany,2015,13/05/2021,10953912015,1095391
900,12/05/2021,1177,14,850,50,327,28/01/2021,"Tignanello, Toscana",Tuscany,2012,13/05/2021,10953912012,1095391
6800,12/05/2021,6800,1,1730,5070,5070,31/10/2011,"Domaine Leflaive, Chevalier-Montrachet Grand Cru",Burgundy,2003,13/05/2021,10734012003,1073401
4400,12/05/2021,4881,7,4160,240,721,19/03/2021,"Chateau Margaux Premier Cru Classe, Margaux",Bordeaux,2019,13/05/2021,10127812019,1012781
3850,12/05/2021,4163,43,3560,290,603,20/11/2020,"Chateau Margaux Premier Cru Classe, Margaux",Bordeaux,2012,13/05/2021,10127812012,1012781
460,12/05/2021,487,154,420,40,67,23/03/2021,"Tua Rita, Giusto di Notri, Toscana",Tuscany,2016,13/05/2021,11058072016,1105807
2973,10/08/2021,3137,9,2610,363,527,10/01/2017,"Chateau Angelus Premier Grand Cru Classe B, Saint-Emilion Grand Cru",Bordeaux,2002,11/08/2021,10060452002,1006045
1400,12/05/2021,1433,10,1276,124,157,05/03/2021,"Gaja, Barbaresco",Piedmont,2013,13/05/2021,10996052013,1099605
8040,12/05/2021,8232,20,7950,90,282,12/03/2021,"Chateau Margaux Premier Cru Classe, Margaux",Bordeaux,2000,13/05/2021,10127812000,1012781
400,07/05/2021,472,6,332,68,140,06/10/2020,"Chateau Batailley 5eme Cru Classe, Pauillac",Bordeaux,2008,08/05/2021,10063222008,1006322
2973,09/08/2021,3137,9,2610,363,527,10/01/2017,"Chateau Angelus Premier Grand Cru Classe B, Saint-Emilion Grand Cru",Bordeaux,2002,10/08/2021,10060452002,1006045
2973,09/08/2021,3137,9,2610,363,527,10/01/2017,"Chateau Angelus Premier Grand Cru Classe B, Saint-Emilion Grand Cru",Bordeaux,2002,10/08/2021,10060452002,1006045
2973,06/08/2021,3137,9,2610,363,527,10/01/2017,"Chateau Angelus Premier Grand Cru Classe B, Saint-Emilion Grand Cru",Bordeaux,2002,07/08/2021,10060452002,1006045
8400,12/05/2021,8400,0,7200,1200,1200,06/11/2019,"Domaine Denis Mortet, Chambertin Grand Cru",Burgundy,2014,13/05/2021,10490202014,1049020
1500,12/05/2021,1676,36,1408,92,268,09/04/2021,"Gaja, Barbaresco",Piedmont,2016,13/05/2021,10996052016,1099605
3860,10/05/2021,4789,78,3800,60,989,07/04/2021,"Chateau Margaux Premier Cru Classe, Margaux",Bordeaux,2006,13/05/2021,10127812006,1012781
1300,05/05/2021,1324,3,1200,100,124,06/03/2021,"Tignanello, Toscana",Tuscany,2007,13/05/2021,10953912007,1095391
490,07/05/2021,553,21,504,-14,49,06/04/2021,"Chateau Batailley 5eme Cru Classe, Pauillac",Bordeaux,2009,08/05/2021,10063222009,1006322
2973,06/08/2021,3137,9,2610,363,527,10/01/2017,"Chateau Angelus Premier Grand Cru Classe B, Saint-Emilion Grand Cru",Bordeaux,2002,07/08/2021,10060452002,1006045
3700,12/05/2021,4148,151,3700,0,448,06/05/2021,"Chateau Margaux Premier Cru Classe, Margaux",Bordeaux,2017,13/05/2021,10127812017,1012781
10500,12/05/2021,12395,75,9844,656,2551,29/03/2021,"Chateau Margaux Premier Cru Classe, Margaux",Bordeaux,2015,13/05/2021,10127812015,1012781
6360,12/05/2021,6400,1,4500,1860,1900,08/04/2015,"Domaine Leflaive, Chevalier-Montrachet Grand Cru",Burgundy,2012,13/05/2021,10734012012,1073401
900,12/05/2021,1036,66,920,-20,116,10/05/2021,"Tignanello, Toscana",Tuscany,2018,13/05/2021,10953912018,1095391
2973,05/08/2021,3138,9,2610,363,528,10/01/2017,"Chateau Angelus Premier Grand Cru Classe B, Saint-Emilion Grand Cru",Bordeaux,2002,06/08/2021,10060452002,1006045
4800,12/05/2021,5717,28,4800,0,917,11/03/2021,"Chateau Margaux Premier Cru Classe, Margaux",Bordeaux,2003,13/05/2021,10127812003,1012781
6300,12/05/2021,7459,56,5922,378,1537,13/04/2021,"Chateau Margaux Premier Cru Classe, Margaux",Bordeaux,2010,13/05/2021,10127812010,1012781
1010,12/05/2021,1057,9,860,150,197,08/03/2021,"Tignanello, Toscana",Tuscany,2011,13/05/2021,10953912011,1095391
830,12/05/2021,928,17,781,49,147,16/11/2020,"Chateau Calon Segur 3eme Cru Classe, Saint-Estephe",Bordeaux,2008,13/05/2021,10074752008,1007475
3800,12/05/2021,4078,54,3480,320,598,10/04/2021,"Chateau Margaux Premier Cru Classe, Margaux",Bordeaux,2014,13/05/2021,10127812014,1012781
490,07/05/2021,553,21,504,-14,49,06/04/2021,"Chateau Batailley 5eme Cru Classe, Pauillac",Bordeaux,2009,08/05/2021,10063222009,1006322
1350,10/05/2021,1465,47,1260,90,205,18/02/2021,"Gaja, Barbaresco",Piedmont,2015,13/05/2021,10996052015,1099605
4400,12/05/2021,4922,27,4400,0,522,29/09/2020,"Chateau Margaux Premier Cru Classe, Margaux",Bordeaux,2001,13/05/2021,10127812001,1012781
780,12/05/2021,836,6,682,98,154,15/09/2020,"Chateau Calon Segur 3eme Cru Classe, Saint-Estephe",Bordeaux,2013,13/05/2021,10074752013,1007475
7600,12/05/2021,8122,7,7000,600,1122,26/04/2021,"Domaine Leflaive, Chevalier-Montrachet Grand Cru",Burgundy,2018,13/05/2021,10734012018,1073401
3920,12/05/2021,4457,90,3800,120,657,12/05/2021,"Chateau Margaux Premier Cru Classe, Margaux",Bordeaux,2008,13/05/2021,10127812008,1012781
840,12/05/2021,918,29,842,-2,76,22/08/2020,"Chateau Calon Segur 3eme Cru Classe, Saint-Estephe",Bordeaux,2019,13/05/2021,10074752019,1007475
400,07/05/2021,461,10,355,45,106,15/04/2021,"Chateau Batailley 5eme Cru Classe, Pauillac",Bordeaux,2012,08/05/2021,10063222012,1006322
6750,12/05/2021,7938,81,6500,250,1438,12/05/2021,"Chateau Margaux Premier Cru Classe, Margaux",Bordeaux,2009,13/05/2021,10127812009,1012781
1100,12/05/2021,1536,7,1010,90,526,18/12/2020,"Tignanello, Toscana",Tuscany,2008,13/05/2021,10953912008,1095391
3827,12/05/2021,4512,71,4116,-289,396,25/02/2021,"Chateau Margaux Premier Cru Classe, Margaux",Bordeaux,2004,13/05/2021,10127812004,1012781
16200,25/06/2021,16040,0,18750,-2550,-2710,29/08/2018,"Jacques-Frederic Mugnier, Chambolle-Musigny Premier Cru, Les Amoureuses",Burgundy,2015,26/06/2021,10496422015,1049642
686,25/06/2021,838,8,682,4,156,15/09/2020,"Chateau Calon Segur 3eme Cru Classe, Saint-Estephe",Bordeaux,2013,26/06/2021,10074752013,1007475
2098,25/06/2021,2300,4,2190,-92,110,01/05/2021,"Gaja, Barbaresco",Piedmont,2004,26/06/2021,10996052004,1099605
2973,05/08/2021,3138,9,2610,363,528,10/01/2017,"Chateau Angelus Premier Grand Cru Classe B, Saint-Emilion Grand Cru",Bordeaux,2002,06/08/2021,10060452002,1006045
7800,25/06/2021,8255,5,7330,470,925,02/06/2021,"Domaine Leflaive, Chevalier-Montrachet Grand Cru",Burgundy,2018,26/06/2021,10734012018,1073401
2973,04/08/2021,3137,9,2610,363,527,10/01/2017,"Chateau Angelus Premier Grand Cru Classe B, Saint-Emilion Grand Cru",Bordeaux,2002,05/08/2021,10060452002,1006045
460,25/06/2021,493,188,420,40,73,28/05/2021,"Tua Rita, Giusto di Notri, Toscana",Tuscany,2016,26/06/2021,11058072016,1105807
480,24/06/2021,467,101,380,100,87,25/03/2021,"Tua Rita, Giusto di Notri, Toscana",Tuscany,2018,26/06/2021,11058072018,1105807
14520,25/06/2021,14520,1,12000,2520,2520,28/05/2020,"Jacques-Frederic Mugnier, Chambolle-Musigny Premier Cru, Les Amoureuses",Burgundy,2014,26/06/2021,10496422014,1049642
2973,04/08/2021,3137,9,2610,363,527,10/01/2017,"Chateau Angelus Premier Grand Cru Classe B, Saint-Emilion Grand Cru",Bordeaux,2002,05/08/2021,10060452002,1006045
3770,23/06/2021,4219,109,3646,124,573,16/06/2021,"Chateau Margaux Premier Cru Classe, Margaux",Bordeaux,2017,26/06/2021,10127812017,1012781
2973,03/08/2021,3137,9,2610,363,527,10/01/2017,"Chateau Angelus Premier Grand Cru Classe B, Saint-Emilion Grand Cru",Bordeaux,2002,03/08/2021,10060452002,1006045
2973,03/08/2021,3137,9,2610,363,527,10/01/2017,"Chateau Angelus Premier Grand Cru Classe B, Saint-Emilion Grand Cru",Bordeaux,2002,04/08/2021,10060452002,1006045
2500,25/06/2021,2636,2,2220,280,416,14/06/2021,"Gaja, Barbaresco",Piedmont,2001,26/06/2021,10996052001,1099605
520,25/06/2021,556,4,460,60,96,05/05/2020,"Tua Rita, Giusto di Notri, Toscana",Tuscany,2008,26/06/2021,11058072008,1105807
870,25/06/2021,954,4,705,165,249,01/02/2021,"Chateau Calon Segur 3eme Cru Classe, Saint-Estephe",Bordeaux,2002,26/06/2021,10074752002,1007475
400,07/05/2021,463,9,355,45,108,15/04/2021,"Chateau Batailley 5eme Cru Classe, Pauillac",Bordeaux,2012,10/05/2021,10063222012,1006322
10500,25/06/2021,11863,51,9800,700,2063,11/06/2021,"Chateau Margaux Premier Cru Classe, Margaux",Bordeaux,2015,26/06/2021,10127812015,1012781
3900,25/06/2021,4260,78,3700,200,560,07/06/2021,"Chateau Margaux Premier Cru Classe, Margaux",Bordeaux,2008,26/06/2021,10127812008,1012781
790,25/06/2021,904,22,801,-11,103,31/05/2021,"Chateau Calon Segur 3eme Cru Classe, Saint-Estephe",Bordeaux,2014,26/06/2021,10074752014,1007475
8000,25/06/2021,8692,5,6974,1026,1718,14/03/2021,"Domaine Leflaive, Chevalier-Montrachet Grand Cru",Burgundy,2017,26/06/2021,10734012017,1073401
950,25/06/2021,1019,52,863,87,156,10/05/2021,"Chateau Calon Segur 3eme Cru Classe, Saint-Estephe",Bordeaux,2006,26/06/2021,10074752006,1007475
1850,25/06/2021,1831,1,1180,670,651,10/03/2017,"Gaja, Barbaresco",Piedmont,2005,26/06/2021,10996052005,1099605
3720,25/06/2021,4312,146,3480,240,832,17/06/2021,"Chateau Margaux Premier Cru Classe, Margaux",Bordeaux,2014,26/06/2021,10127812014,1012781
2973,02/08/2021,3137,9,2610,363,527,10/01/2017,"Chateau Angelus Premier Grand Cru Classe B, Saint-Emilion Grand Cru",Bordeaux,2002,03/08/2021,10060452002,1006045
2973,02/08/2021,3137,9,2610,363,527,10/01/2017,"Chateau Angelus Premier Grand Cru Classe B, Saint-Emilion Grand Cru",Bordeaux,2002,03/08/2021,10060452002,1006045
487,21/06/2021,526,46,320,167,206,24/03/2021,"Tua Rita, Giusto di Notri, Toscana",Tuscany,2017,26/06/2021,11058072017,1105807
6830,23/06/2021,7717,50,7086,-256,631,11/06/2021,"Chateau Margaux Premier Cru Classe, Margaux",Bordeaux,2009,26/06/2021,10127812009,1012781
400,07/05/2021,461,10,355,45,106,15/04/2021,"Chateau Batailley 5eme Cru Classe, Pauillac",Bordeaux,2012,08/05/2021,10063222012,1006322
990,25/06/2021,1116,15,990,0,126,16/06/2021,"Chateau Calon Segur 3eme Cru Classe, Saint-Estephe",Bordeaux,2010,26/06/2021,10074752010,1007475
2973,30/07/2021,3137,8,2610,363,527,10/01/2017,"Chateau Angelus Premier Grand Cru Classe B, Saint-Emilion Grand Cru",Bordeaux,2002,31/07/2021,10060452002,1006045
1050,17/06/2021,1143,6,860,190,283,08/03/2021,"Tignanello, Toscana",Tuscany,2013,26/06/2021,10953912013,1095391
3560,25/06/2021,4171,44,3525,35,646,18/06/2021,"Chateau Margaux Premier Cru Classe, Margaux",Bordeaux,2007,26/06/2021,10127812007,1012781
400,07/05/2021,463,9,355,45,108,15/04/2021,"Chateau Batailley 5eme Cru Classe, Pauillac",Bordeaux,2012,10/05/2021,10063222012,1006322
5578,21/06/2021,5833,100,5238,340,595,17/05/2021,"Chateau Margaux Premier Cru Classe, Margaux",Bordeaux,2016,24/06/2021,10127812016,1012781
300,07/05/2021,301,109,304,-4,-3,10/01/2021,"Chateau Batailley 5eme Cru Classe, Pauillac",Bordeaux,2013,08/05/2021,10063222013,1006322
15600,23/06/2021,15193,6,13000,2600,2193,29/04/2021,"Jacques-Frederic Mugnier, Chambolle-Musigny Premier Cru, Les Amoureuses",Burgundy,2017,24/06/2021,10496422017,1049642
6830,23/06/2021,7698,51,7086,-256,612,11/06/2021,"Chateau Margaux Premier Cru Classe, Margaux",Bordeaux,2009,24/06/2021,10127812009,1012781
3900,23/06/2021,4269,76,3700,200,569,07/06/2021,"Chateau Margaux Premier Cru Classe, Margaux",Bordeaux,2008,24/06/2021,10127812008,1012781
3900,23/06/2021,4494,25,3684,216,810,10/06/2020,"Chateau Margaux Premier Cru Classe, Margaux",Bordeaux,2002,24/06/2021,10127812002,1012781
415,07/05/2021,535,46,440,-25,95,06/05/2021,"Chateau Batailley 5eme Cru Classe, Pauillac",Bordeaux,2016,08/05/2021,10063222016,1006322
2973,30/07/2021,3137,8,2610,363,527,10/01/2017,"Chateau Angelus Premier Grand Cru Classe B, Saint-Emilion Grand Cru",Bordeaux,2002,31/07/2021,10060452002,1006045
3720,23/06/2021,4311,146,3480,240,831,17/06/2021,"Chateau Margaux Premier Cru Classe, Margaux",Bordeaux,2014,24/06/2021,10127812014,1012781
950,23/06/2021,1246,14,850,100,396,28/01/2021,"Tignanello, Toscana",Tuscany,2012,24/06/2021,10953912012,1095391
686,23/06/2021,838,8,682,4,156,15/09/2020,"Chateau Calon Segur 3eme Cru Classe, Saint-Estephe",Bordeaux,2013,24/06/2021,10074752013,1007475
16200,23/06/2021,16040,0,18750,-2550,-2710,29/08/2018,"Jacques-Frederic Mugnier, Chambolle-Musigny Premier Cru, Les Amoureuses",Burgundy,2015,24/06/2021,10496422015,1049642
2973,29/07/2021,3137,8,2610,363,527,10/01/2017,"Chateau Angelus Premier Grand Cru Classe B, Saint-Emilion Grand Cru",Bordeaux,2002,30/07/2021,10060452002,1006045
3900,23/06/2021,4629,95,3822,78,807,20/06/2021,"Chateau Margaux Premier Cru Classe, Margaux",Bordeaux,2006,24/06/2021,10127812006,1012781
540,23/06/2021,532,3,300,240,232,03/11/2011,"Tua Rita, Giusto di Notri, Toscana",Tuscany,2007,24/06/2021,11058072007,1105807
1028,22/06/2021,1129,22,842,186,287,22/08/2020,"Chateau Calon Segur 3eme Cru Classe, Saint-Estephe",Bordeaux,2019,24/06/2021,10074752019,1007475
2973,29/07/2021,3137,8,2610,363,527,10/01/2017,"Chateau Angelus Premier Grand Cru Classe B, Saint-Emilion Grand Cru",Bordeaux,2002,30/07/2021,10060452002,1006045
3750,14/06/2021,4219,40,3560,190,659,20/11/2020,"Chateau Margaux Premier Cru Classe, Margaux",Bordeaux,2012,24/06/2021,10127812012,1012781
4850,18/06/2021,5654,29,4650,200,1004,21/06/2021,"Chateau Margaux Premier Cru Classe, Margaux",Bordeaux,2003,24/06/2021,10127812003,1012781
870,23/06/2021,955,4,705,165,250,01/02/2021,"Chateau Calon Segur 3eme Cru Classe, Saint-Estephe",Bordeaux,2002,24/06/2021,10074752002,1007475
860,23/06/2021,1033,70,910,-50,123,23/06/2021,"Tignanello, Toscana",Tuscany,2018,24/06/2021,10953912018,1095391
1130,23/06/2021,1227,9,1202,-72,25,10/05/2021,"Tignanello, Toscana",Tuscany,2015,24/06/2021,10953912015,1095391
990,23/06/2021,1108,16,990,0,118,16/06/2021,"Chateau Calon Segur 3eme Cru Classe, Saint-Estephe",Bordeaux,2010,24/06/2021,10074752010,1007475
6400,23/06/2021,7483,53,5950,450,1533,23/06/2021,"Chateau Margaux Premier Cru Classe, Margaux",Bordeaux,2010,24/06/2021,10127812010,1012781
907,23/06/2021,953,23,805,102,148,20/11/2019,"Chateau Calon Segur 3eme Cru Classe, Saint-Estephe",Bordeaux,2001,24/06/2021,10074752001,1007475
2924,15/07/2021,3126,7,2610,314,516,10/01/2017,"Chateau Angelus Premier Grand Cru Classe B, Saint-Emilion Grand Cru",Bordeaux,2002,16/07/2021,10060452002,1006045
8400,23/06/2021,8400,1,5960,2440,2440,01/08/2017,"Domaine Leflaive, Chevalier-Montrachet Grand Cru",Burgundy,2010,24/06/2021,10734012010,1073401
2199,23/06/2021,2225,2,1340,859,885,13/03/2020,"Gaja, Barbaresco",Piedmont,2009,24/06/2021,10996052009,1099605
625,10/05/2021,677,8,470,155,207,29/03/2018,"Chateau Batailley 5eme Cru Classe, Pauillac",Bordeaux,2000,12/05/2021,10063222000,1006322
2924,15/07/2021,3124,7,2610,314,514,10/01/2017,"Chateau Angelus Premier Grand Cru Classe B, Saint-Emilion Grand Cru",Bordeaux,2002,20/07/2021,10060452002,1006045
5000,15/06/2021,5052,7,4160,840,892,19/03/2021,"Chateau Margaux Premier Cru Classe, Margaux",Bordeaux,2019,24/06/2021,10127812019,1012781
487,21/06/2021,536,26,388,99,148,29/09/2020,"Tua Rita, Giusto di Notri, Toscana",Tuscany,2015,24/06/2021,11058072015,1105807
1000,23/06/2021,1245,49,1030,-30,215,25/05/2021,"Chateau Calon Segur 3eme Cru Classe, Saint-Estephe",Bordeaux,2009,24/06/2021,10074752009,1007475
1050,17/06/2021,1145,6,860,190,285,08/03/2021,"Tignanello, Toscana",Tuscany,2013,24/06/2021,10953912013,1095391
14520,23/06/2021,14520,1,12000,2520,2520,28/05/2020,"Jacques-Frederic Mugnier, Chambolle-Musigny Premier Cru, Les Amoureuses",Burgundy,2014,24/06/2021,10496422014,1049642
1000,17/06/2021,1051,8,880,120,171,22/06/2021,"Tignanello, Toscana",Tuscany,2011,24/06/2021,10953912011,1095391
2924,15/07/2021,3137,8,2610,314,527,10/01/2017,"Chateau Angelus Premier Grand Cru Classe B, Saint-Emilion Grand Cru",Bordeaux,2002,27/07/2021,10060452002,1006045
950,23/06/2021,1019,52,863,87,156,10/05/2021,"Chateau Calon Segur 3eme Cru Classe, Saint-Estephe",Bordeaux,2006,24/06/2021,10074752006,1007475
3740,23/06/2021,4028,62,3520,220,508,07/04/2021,"Chateau Margaux Premier Cru Classe, Margaux",Bordeaux,2013,24/06/2021,10127812013,1012781
1408,23/06/2021,1389,4,1238,170,151,02/11/2020,"Tignanello, Toscana",Tuscany,2006,24/06/2021,10953912006,1095391
2924,15/07/2021,3126,7,2610,314,516,10/01/2017,"Chateau Angelus Premier Grand Cru Classe B, Saint-Emilion Grand Cru",Bordeaux,2002,16/07/2021,10060452002,1006045
625,10/05/2021,679,8,470,155,209,29/03/2018,"Chateau Batailley 5eme Cru Classe, Pauillac",Bordeaux,2000,11/05/2021,10063222000,1006322
1398,17/06/2021,1531,15,1276,122,255,05/03/2021,"Gaja, Barbaresco",Piedmont,2013,24/06/2021,10996052013,1099605
1070,23/06/2021,1223,51,950,120,273,03/05/2021,"Chateau Calon Segur 3eme Cru Classe, Saint-Estephe",Bordeaux,2018,24/06/2021,10074752018,1007475
10500,23/06/2021,11956,52,9800,700,2156,11/06/2021,"Chateau Margaux Premier Cru Classe, Margaux",Bordeaux,2015,24/06/2021,10127812015,1012781
2924,15/07/2021,3124,7,2610,314,514,10/01/2017,"Chateau Angelus Premier Grand Cru Classe B, Saint-Emilion Grand Cru",Bordeaux,2002,20/07/2021,10060452002,1006045
1304,23/06/2021,1402,4,1172,132,230,07/04/2021,"Tignanello, Toscana",Tuscany,2010,24/06/2021,10953912010,1095391
3560,23/06/2021,4173,44,3525,35,648,18/06/2021,"Chateau Margaux Premier Cru Classe, Margaux",Bordeaux,2007,24/06/2021,10127812007,1012781
900,23/06/2021,1054,22,800,100,254,21/11/2019,"Chateau Calon Segur 3eme Cru Classe, Saint-Estephe",Bordeaux,2003,24/06/2021,10074752003,1007475
7800,23/06/2021,8255,5,7330,470,925,02/06/2021,"Domaine Leflaive, Chevalier-Montrachet Grand Cru",Burgundy,2018,24/06/2021,10734012018,1073401
1238,23/06/2021,1266,38,1050,188,216,10/06/2021,"Tignanello, Toscana",Tuscany,2016,24/06/2021,10953912016,1095391
2924,15/07/2021,3137,8,2610,314,527,10/01/2017,"Chateau Angelus Premier Grand Cru Classe B, Saint-Emilion Grand Cru",Bordeaux,2002,27/07/2021,10060452002,1006045
1024,23/06/2021,1232,5,1072,-48,160,20/01/2021,"Tignanello, Toscana",Tuscany,2009,24/06/2021,10953912009,1095391
2973,14/07/2021,3126,7,2610,363,516,10/01/2017,"Chateau Angelus Premier Grand Cru Classe B, Saint-Emilion Grand Cru",Bordeaux,2002,15/07/2021,10060452002,1006045
625,10/05/2021,677,8,470,155,207,29/03/2018,"Chateau Batailley 5eme Cru Classe, Pauillac",Bordeaux,2000,12/05/2021,10063222000,1006322
2973,14/07/2021,3126,7,2610,363,516,10/01/2017,"Chateau Angelus Premier Grand Cru Classe B, Saint-Emilion Grand Cru",Bordeaux,2002,15/07/2021,10060452002,1006045
625,10/05/2021,679,8,470,155,209,29/03/2018,"Chateau Batailley 5eme Cru Classe, Pauillac",Bordeaux,2000,11/05/2021,10063222000,1006322
3750,24/06/2021,4213,40,3560,190,653,20/11/2020,"Chateau Margaux Premier Cru Classe, Margaux",Bordeaux,2012,26/06/2021,10127812012,1012781
2437,25/06/2021,2231,2,1768,669,463,22/05/2020,"Gaja, Barbaresco",Piedmont,2000,26/06/2021,10996052000,1099605
840,17/06/2021,1092,76,860,-20,232,19/04/2021,"Chateau Calon Segur 3eme Cru Classe, Saint-Estephe",Bordeaux,2015,26/06/2021,10074752015,1007475
3900,25/06/2021,4496,25,3684,216,812,10/06/2020,"Chateau Margaux Premier Cru Classe, Margaux",Bordeaux,2002,26/06/2021,10127812002,1012781
412,10/05/2021,437,2,220,192,217,17/06/2015,"Chateau Batailley 5eme Cru Classe, Pauillac",Bordeaux,2002,11/05/2021,10063222002,1006322
3826,25/06/2021,4499,55,4116,-290,383,25/02/2021,"Chateau Margaux Premier Cru Classe, Margaux",Bordeaux,2004,26/06/2021,10127812004,1012781
995,21/05/2021,1126,22,1000,-5,126,12/04/2021,"Chateau Calon Segur 3eme Cru Classe, Saint-Estephe",Bordeaux,2010,23/05/2021,10074752010,1007475
6250,20/05/2021,7017,41,6300,-50,717,21/05/2021,"Chateau Margaux Premier Cru Classe, Margaux",Bordeaux,2005,23/05/2021,10127812005,1012781
8040,21/05/2021,8398,21,7950,90,448,12/03/2021,"Chateau Margaux Premier Cru Classe, Margaux",Bordeaux,2000,23/05/2021,10127812000,1012781
3758,21/05/2021,4045,80,3690,68,355,13/04/2021,"Chateau Margaux Premier Cru Classe, Margaux",Bordeaux,2011,23/05/2021,10127812011,1012781
3850,21/05/2021,4186,43,3560,290,626,20/11/2020,"Chateau Margaux Premier Cru Classe, Margaux",Bordeaux,2012,23/05/2021,10127812012,1012781
589,10/05/2021,621,50,450,139,171,04/05/2021,"Chateau Batailley 5eme Cru Classe, Pauillac",Bordeaux,2005,11/05/2021,10063222005,1006322
1100,25/06/2021,1216,67,1036,64,180,27/05/2021,"Chateau Calon Segur 3eme Cru Classe, Saint-Estephe",Bordeaux,2016,26/06/2021,10074752016,1007475
1500,25/06/2021,1681,49,1408,92,273,09/04/2021,"Gaja, Barbaresco",Piedmont,2016,26/06/2021,10996052016,1099605
589,10/05/2021,621,50,450,139,171,04/05/2021,"Chateau Batailley 5eme Cru Classe, Pauillac",Bordeaux,2005,11/05/2021,10063222005,1006322
840,12/05/2021,1075,28,842,-2,233,22/08/2020,"Chateau Calon Segur 3eme Cru Classe, Saint-Estephe",Bordeaux,2019,24/05/2021,10074752019,1007475
5415,10/05/2021,5591,141,5150,265,441,03/05/2021,"Chateau Margaux Premier Cru Classe, Margaux",Bordeaux,2018,24/05/2021,10127812018,1012781
400,10/05/2021,482,5,400,0,82,11/05/2021,"Chateau Batailley 5eme Cru Classe, Pauillac",Bordeaux,2006,12/05/2021,10063222006,1006322
2973,13/07/2021,3126,7,2610,363,516,10/01/2017,"Chateau Angelus Premier Grand Cru Classe B, Saint-Emilion Grand Cru",Bordeaux,2002,14/07/2021,10060452002,1006045
5600,23/06/2021,5856,99,5254,346,602,26/05/2021,"Chateau Margaux Premier Cru Classe, Margaux",Bordeaux,2018,24/06/2021,10127812018,1012781
7600,12/05/2021,8133,7,7000,600,1133,26/04/2021,"Domaine Leflaive, Chevalier-Montrachet Grand Cru",Burgundy,2018,14/05/2021,10734012018,1073401
1678,13/05/2021,1702,4,1180,498,522,25/06/2020,"Tignanello, Toscana",Tuscany,2004,14/05/2021,10953912004,1095391
2973,13/07/2021,3126,7,2610,363,516,10/01/2017,"Chateau Angelus Premier Grand Cru Classe B, Saint-Emilion Grand Cru",Bordeaux,2002,14/07/2021,10060452002,1006045
1040,04/05/2021,1196,62,950,90,246,03/05/2021,"Chateau Calon Segur 3eme Cru Classe, Saint-Estephe",Bordeaux,2018,14/05/2021,10074752018,1007475
880,23/06/2021,967,9,725,155,242,13/04/2021,"Chateau Calon Segur 3eme Cru Classe, Saint-Estephe",Bordeaux,2007,24/06/2021,10074752007,1007475
1000,23/06/2021,1155,93,988,12,167,28/05/2021,"Chateau Calon Segur 3eme Cru Classe, Saint-Estephe",Bordeaux,2005,24/06/2021,10074752005,1007475
6557,23/06/2021,6557,0,3920,2637,2637,26/04/2017,"Domaine Leflaive, Chevalier-Montrachet Grand Cru",Burgundy,2006,24/06/2021,10734012006,1073401
2500,23/06/2021,2636,2,2220,280,416,14/06/2021,"Gaja, Barbaresco",Piedmont,2001,24/06/2021,10996052001,1099605
3826,23/06/2021,4526,54,4116,-290,410,25/02/2021,"Chateau Margaux Premier Cru Classe, Margaux",Bordeaux,2004,24/06/2021,10127812004,1012781
2973,12/07/2021,3126,7,2610,363,516,10/01/2017,"Chateau Angelus Premier Grand Cru Classe B, Saint-Emilion Grand Cru",Bordeaux,2002,13/07/2021,10060452002,1006045
460,23/06/2021,493,188,420,40,73,28/05/2021,"Tua Rita, Giusto di Notri, Toscana",Tuscany,2016,24/06/2021,11058072016,1105807
400,10/05/2021,557,10,400,0,157,11/05/2021,"Chateau Batailley 5eme Cru Classe, Pauillac",Bordeaux,2006,14/05/2021,10063222006,1006322
8100,23/06/2021,8544,18,8100,0,444,21/06/2021,"Chateau Margaux Premier Cru Classe, Margaux",Bordeaux,2000,24/06/2021,10127812000,1012781
1550,23/06/2021,1557,1,1300,250,257,27/04/2021,"Gaja, Barbaresco",Piedmont,2012,24/06/2021,10996052012,1099605
1040,23/06/2021,1204,22,940,100,264,18/03/2021,"Chateau Calon Segur 3eme Cru Classe, Saint-Estephe",Bordeaux,2000,24/06/2021,10074752000,1007475
2973,12/07/2021,3126,7,2610,363,516,10/01/2017,"Chateau Angelus Premier Grand Cru Classe B, Saint-Emilion Grand Cru",Bordeaux,2002,13/07/2021,10060452002,1006045
660,13/05/2021,724,4,390,270,334,18/08/2017,"Tua Rita, Giusto di Notri, Toscana",Tuscany,2006,14/05/2021,11058072006,1105807
6750,13/05/2021,7939,80,6500,250,1439,12/05/2021,"Chateau Margaux Premier Cru Classe, Margaux",Bordeaux,2009,14/05/2021,10127812009,1012781
3770,23/06/2021,4232,110,3646,124,586,16/06/2021,"Chateau Margaux Premier Cru Classe, Margaux",Bordeaux,2017,24/06/2021,10127812017,1012781
1100,23/06/2021,1218,67,1036,64,182,27/05/2021,"Chateau Calon Segur 3eme Cru Classe, Saint-Estephe",Bordeaux,2016,24/06/2021,10074752016,1007475
1500,11/06/2021,1681,50,1408,92,273,09/04/2021,"Gaja, Barbaresco",Piedmont,2016,12/06/2021,10996052016,1099605
4850,11/06/2021,5601,32,4842,8,759,19/05/2021,"Chateau Margaux Premier Cru Classe, Margaux",Bordeaux,2003,12/06/2021,10127812003,1012781
6800,13/05/2021,6800,1,1730,5070,5070,31/10/2011,"Domaine Leflaive, Chevalier-Montrachet Grand Cru",Burgundy,2003,14/05/2021,10734012003,1073401
1000,13/05/2021,1237,17,1047,-47,190,27/04/2021,"Chateau Calon Segur 3eme Cru Classe, Saint-Estephe",Bordeaux,2009,14/05/2021,10074752009,1007475
1408,13/05/2021,1518,1,1150,258,368,21/04/2019,"Tignanello, Toscana",Tuscany,2005,14/05/2021,10953912005,1095391
709,13/05/2021,819,7,682,27,137,15/09/2020,"Chateau Calon Segur 3eme Cru Classe, Saint-Estephe",Bordeaux,2013,14/05/2021,10074752013,1007475
1244,13/05/2021,1578,3,882,362,696,26/04/2019,"Tignanello, Toscana",Tuscany,2003,14/05/2021,10953912003,1095391
1300,13/05/2021,1342,3,1200,100,142,06/03/2021,"Tignanello, Toscana",Tuscany,2007,14/05/2021,10953912007,1095391
3850,13/05/2021,4163,43,3560,290,603,20/11/2020,"Chateau Margaux Premier Cru Classe, Margaux",Bordeaux,2012,14/05/2021,10127812012,1012781
907,13/05/2021,1072,33,805,102,267,20/11/2019,"Chateau Calon Segur 3eme Cru Classe, Saint-Estephe",Bordeaux,2001,14/05/2021,10074752001,1007475
1500,13/05/2021,1676,36,1408,92,268,09/04/2021,"Gaja, Barbaresco",Piedmont,2016,14/05/2021,10996052016,1099605
1800,13/05/2021,1840,2,1300,500,540,30/05/2019,"Gaja, Barbaresco",Piedmont,2007,14/05/2021,10996052007,1099605
6830,11/06/2021,7684,49,7086,-256,598,11/06/2021,"Chateau Margaux Premier Cru Classe, Margaux",Bordeaux,2009,12/06/2021,10127812009,1012781
686,11/06/2021,828,13,682,4,146,15/09/2020,"Chateau Calon Segur 3eme Cru Classe, Saint-Estephe",Bordeaux,2013,12/06/2021,10074752013,1007475
400,10/05/2021,557,10,400,0,157,11/05/2021,"Chateau Batailley 5eme Cru Classe, Pauillac",Bordeaux,2006,14/05/2021,10063222006,1006322
400,10/05/2021,482,5,532,-132,-50,11/02/2021,"Chateau Batailley 5eme Cru Classe, Pauillac",Bordeaux,2006,11/05/2021,10063222006,1006322
7800,11/06/2021,8230,8,7330,470,900,02/06/2021,"Domaine Leflaive, Chevalier-Montrachet Grand Cru",Burgundy,2018,12/06/2021,10734012018,1073401
900,12/05/2021,1036,66,940,-40,96,13/05/2021,"Tignanello, Toscana",Tuscany,2018,14/05/2021,10953912018,1095391
3700,13/05/2021,4142,136,3700,0,442,06/05/2021,"Chateau Margaux Premier Cru Classe, Margaux",Bordeaux,2017,14/05/2021,10127812017,1012781
400,10/05/2021,482,5,400,0,82,11/05/2021,"Chateau Batailley 5eme Cru Classe, Pauillac",Bordeaux,2006,12/05/2021,10063222006,1006322
1010,12/05/2021,1048,9,860,150,188,08/03/2021,"Tignanello, Toscana",Tuscany,2011,14/05/2021,10953912011,1095391
850,13/05/2021,1098,97,860,-10,238,19/04/2021,"Chateau Calon Segur 3eme Cru Classe, Saint-Estephe",Bordeaux,2015,14/05/2021,10074752015,1007475
2973,09/07/2021,3126,7,2610,363,516,10/01/2017,"Chateau Angelus Premier Grand Cru Classe B, Saint-Emilion Grand Cru",Bordeaux,2002,10/07/2021,10060452002,1006045
2973,09/07/2021,3126,7,2610,363,516,10/01/2017,"Chateau Angelus Premier Grand Cru Classe B, Saint-Emilion Grand Cru",Bordeaux,2002,10/07/2021,10060452002,1006045
1299,11/06/2021,1523,12,1300,-1,223,28/09/2020,"Gaja, Barbaresco",Piedmont,2014,12/06/2021,10996052014,1099605
3900,11/06/2021,4422,110,3700,200,722,07/06/2021,"Chateau Margaux Premier Cru Classe, Margaux",Bordeaux,2008,12/06/2021,10127812008,1012781
2500,11/06/2021,3334,3,1200,1300,2134,16/05/2012,"Gaja, Barbaresco",Piedmont,2001,12/06/2021,10996052001,1099605
990,11/06/2021,1110,21,1000,-10,110,12/04/2021,"Chateau Calon Segur 3eme Cru Classe, Saint-Estephe",Bordeaux,2010,12/06/2021,10074752010,1007475
6557,11/06/2021,6557,0,3920,2637,2637,26/04/2017,"Domaine Leflaive, Chevalier-Montrachet Grand Cru",Burgundy,2006,12/06/2021,10734012006,1073401
2973,08/07/2021,3126,7,2610,363,516,10/01/2017,"Chateau Angelus Premier Grand Cru Classe B, Saint-Emilion Grand Cru",Bordeaux,2002,09/07/2021,10060452002,1006045
870,11/06/2021,948,10,705,165,243,01/02/2021,"Chateau Calon Segur 3eme Cru Classe, Saint-Estephe",Bordeaux,2002,12/06/2021,10074752002,1007475
400,10/05/2021,482,5,532,-132,-50,11/02/2021,"Chateau Batailley 5eme Cru Classe, Pauillac",Bordeaux,2006,11/05/2021,10063222006,1006322
8000,11/06/2021,8639,6,6974,1026,1665,14/03/2021,"Domaine Leflaive, Chevalier-Montrachet Grand Cru",Burgundy,2017,12/06/2021,10734012017,1073401
1550,11/06/2021,1557,1,1300,250,257,27/04/2021,"Gaja, Barbaresco",Piedmont,2012,12/06/2021,10996052012,1099605
430,11/06/2021,463,83,380,50,83,25/03/2021,"Tua Rita, Giusto di Notri, Toscana",Tuscany,2018,12/06/2021,11058072018,1105807
2973,08/07/2021,3126,7,2610,363,516,10/01/2017,"Chateau Angelus Premier Grand Cru Classe B, Saint-Emilion Grand Cru",Bordeaux,2002,09/07/2021,10060452002,1006045
10100,11/06/2021,11971,53,9800,300,2171,11/06/2021,"Chateau Margaux Premier Cru Classe, Margaux",Bordeaux,2015,12/06/2021,10127812015,1012781
1800,11/06/2021,1815,3,1300,500,515,30/05/2019,"Gaja, Barbaresco",Piedmont,2007,12/06/2021,10996052007,1099605
540,11/06/2021,533,3,300,240,233,03/11/2011,"Tua Rita, Giusto di Notri, Toscana",Tuscany,2007,12/06/2021,11058072007,1105807
450,10/05/2021,450,1,340,110,110,31/08/2018,"Chateau Batailley 5eme Cru Classe, Pauillac",Bordeaux,2007,11/05/2021,10063222007,1006322
3758,11/06/2021,4050,97,3690,68,360,13/04/2021,"Chateau Margaux Premier Cru Classe, Margaux",Bordeaux,2011,12/06/2021,10127812011,1012781
8000,23/06/2021,8683,5,6974,1026,1709,14/03/2021,"Domaine Leflaive, Chevalier-Montrachet Grand Cru",Burgundy,2017,24/06/2021,10734012017,1073401
460,29/06/2021,489,188,420,40,69,28/05/2021,"Tua Rita, Giusto di Notri, Toscana",Tuscany,2016,30/06/2021,11058072016,1105807
8000,29/06/2021,8692,5,6974,1026,1718,14/03/2021,"Domaine Leflaive, Chevalier-Montrachet Grand Cru",Burgundy,2017,30/06/2021,10734012017,1073401
2973,07/07/2021,3126,7,2610,363,516,10/01/2017,"Chateau Angelus Premier Grand Cru Classe B, Saint-Emilion Grand Cru",Bordeaux,2002,08/07/2021,10060452002,1006045
900,05/07/2021,927,41,863,37,64,10/05/2021,"Chateau Calon Segur 3eme Cru Classe, Saint-Estephe",Bordeaux,2006,06/07/2021,10074752006,1007475
3900,05/07/2021,4647,89,3822,78,825,20/06/2021,"Chateau Margaux Premier Cru Classe, Margaux",Bordeaux,2006,06/07/2021,10127812006,1012781
400,10/05/2021,459,5,332,68,127,06/10/2020,"Chateau Batailley 5eme Cru Classe, Pauillac",Bordeaux,2008,11/05/2021,10063222008,1006322
1700,23/06/2021,1652,3,1378,322,274,29/07/2020,"Tignanello, Toscana",Tuscany,2001,24/06/2021,10953912001,1095391
1850,23/06/2021,1831,1,1180,670,651,10/03/2017,"Gaja, Barbaresco",Piedmont,2005,24/06/2021,10996052005,1099605
2098,23/06/2021,2300,4,2190,-92,110,01/05/2021,"Gaja, Barbaresco",Piedmont,2004,24/06/2021,10996052004,1099605
2973,07/07/2021,3126,7,2610,363,516,10/01/2017,"Chateau Angelus Premier Grand Cru Classe B, Saint-Emilion Grand Cru",Bordeaux,2002,08/07/2021,10060452002,1006045
490,10/05/2021,553,21,504,-14,49,06/04/2021,"Chateau Batailley 5eme Cru Classe, Pauillac",Bordeaux,2009,11/05/2021,10063222009,1006322
490,10/05/2021,553,21,504,-14,49,06/04/2021,"Chateau Batailley 5eme Cru Classe, Pauillac",Bordeaux,2009,11/05/2021,10063222009,1006322
400,10/05/2021,463,9,355,45,108,15/04/2021,"Chateau Batailley 5eme Cru Classe, Pauillac",Bordeaux,2012,11/05/2021,10063222012,1006322
1480,13/05/2021,1604,73,1358,122,246,12/05/2021,"Gaja, Barbaresco",Piedmont,2017,14/05/2021,10996052017,1099605
400,10/05/2021,463,9,355,45,108,15/04/2021,"Chateau Batailley 5eme Cru Classe, Pauillac",Bordeaux,2012,11/05/2021,10063222012,1006322
1300,27/05/2021,1333,5,1200,100,133,06/03/2021,"Tignanello, Toscana",Tuscany,2007,30/05/2021,10953912007,1095391
8040,28/05/2021,8483,23,7950,90,533,12/03/2021,"Chateau Margaux Premier Cru Classe, Margaux",Bordeaux,2000,30/05/2021,10127812000,1012781
3560,05/07/2021,4185,37,3525,35,660,18/06/2021,"Chateau Margaux Premier Cru Classe, Margaux",Bordeaux,2007,06/07/2021,10127812007,1012781
2973,06/07/2021,3126,7,2610,363,516,10/01/2017,"Chateau Angelus Premier Grand Cru Classe B, Saint-Emilion Grand Cru",Bordeaux,2002,07/07/2021,10060452002,1006045
2973,06/07/2021,3126,7,2610,363,516,10/01/2017,"Chateau Angelus Premier Grand Cru Classe B, Saint-Emilion Grand Cru",Bordeaux,2002,07/07/2021,10060452002,1006045
1404,13/05/2021,1407,1,996,408,411,14/06/2019,"Tignanello, Toscana",Tuscany,2000,14/05/2021,10953912000,1095391
2924,22/06/2021,3126,7,2610,314,516,10/01/2017,"Chateau Angelus Premier Grand Cru Classe B, Saint-Emilion Grand Cru",Bordeaux,2002,04/07/2021,10060452002,1006045
1350,13/05/2021,1465,47,1260,90,205,18/02/2021,"Gaja, Barbaresco",Piedmont,2015,14/05/2021,10996052015,1099605
3920,13/05/2021,4455,88,3800,120,655,12/05/2021,"Chateau Margaux Premier Cru Classe, Margaux",Bordeaux,2008,14/05/2021,10127812008,1012781
811,13/05/2021,944,5,735,76,209,09/09/2020,"Chateau Calon Segur 3eme Cru Classe, Saint-Estephe",Bordeaux,2012,14/05/2021,10074752012,1007475
300,10/05/2021,301,109,304,-4,-3,10/01/2021,"Chateau Batailley 5eme Cru Classe, Pauillac",Bordeaux,2013,11/05/2021,10063222013,1006322
880,03/06/2021,975,11,781,99,194,16/11/2020,"Chateau Calon Segur 3eme Cru Classe, Saint-Estephe",Bordeaux,2008,14/06/2021,10074752008,1007475
415,10/05/2021,535,46,364,51,171,12/05/2021,"Chateau Batailley 5eme Cru Classe, Pauillac",Bordeaux,2016,13/05/2021,10063222016,1006322
1000,11/06/2021,1165,43,1030,-30,135,25/05/2021,"Chateau Calon Segur 3eme Cru Classe, Saint-Estephe",Bordeaux,2009,14/06/2021,10074752009,1007475
6300,11/06/2021,7464,63,6190,110,1274,23/05/2021,"Chateau Margaux Premier Cru Classe, Margaux",Bordeaux,2010,14/06/2021,10127812010,1012781
3700,11/06/2021,4217,118,3660,40,557,02/06/2021,"Chateau Margaux Premier Cru Classe, Margaux",Bordeaux,2017,14/06/2021,10127812017,1012781
415,10/05/2021,535,46,440,-25,95,06/05/2021,"Chateau Batailley 5eme Cru Classe, Pauillac",Bordeaux,2016,11/05/2021,10063222016,1006322
1000,28/05/2021,1160,41,1030,-30,130,25/05/2021,"Chateau Calon Segur 3eme Cru Classe, Saint-Estephe",Bordeaux,2009,30/05/2021,10074752009,1007475
648,11/05/2021,680,8,470,178,210,29/03/2018,"Chateau Batailley 5eme Cru Classe, Pauillac",Bordeaux,2000,18/05/2021,10063222000,1006322
648,11/05/2021,680,8,470,178,210,29/03/2018,"Chateau Batailley 5eme Cru Classe, Pauillac",Bordeaux,2000,18/05/2021,10063222000,1006322
4386,02/06/2021,4709,27,4400,-14,309,29/09/2020,"Chateau Margaux Premier Cru Classe, Margaux",Bordeaux,2001,14/06/2021,10127812001,1012781
990,11/06/2021,1109,20,1000,-10,109,12/04/2021,"Chateau Calon Segur 3eme Cru Classe, Saint-Estephe",Bordeaux,2010,14/06/2021,10074752010,1007475
3900,11/06/2021,4616,93,3861,39,755,28/05/2021,"Chateau Margaux Premier Cru Classe, Margaux",Bordeaux,2006,14/06/2021,10127812006,1012781
2924,22/06/2021,3139,8,2610,314,529,10/01/2017,"Chateau Angelus Premier Grand Cru Classe B, Saint-Emilion Grand Cru",Bordeaux,2002,23/06/2021,10060452002,1006045
830,12/05/2021,927,16,781,49,146,16/11/2020,"Chateau Calon Segur 3eme Cru Classe, Saint-Estephe",Bordeaux,2008,14/05/2021,10074752008,1007475
760,03/06/2021,922,110,740,20,182,21/05/2021,"Chateau Calon Segur 3eme Cru Classe, Saint-Estephe",Bordeaux,2017,14/06/2021,10074752017,1007475
1310,11/06/2021,1398,6,1172,138,226,07/04/2021,"Tignanello, Toscana",Tuscany,2010,14/06/2021,10953912010,1095391
830,03/06/2021,987,5,735,95,252,09/09/2020,"Chateau Calon Segur 3eme Cru Classe, Saint-Estephe",Bordeaux,2012,14/06/2021,10074752012,1007475
10100,11/06/2021,11970,52,9800,300,2170,11/06/2021,"Chateau Margaux Premier Cru Classe, Margaux",Bordeaux,2015,14/06/2021,10127812015,1012781
6300,11/06/2021,7464,63,6190,110,1274,23/05/2021,"Chateau Margaux Premier Cru Classe, Margaux",Bordeaux,2010,14/06/2021,10127812010,1012781
2924,22/06/2021,3139,8,2610,314,529,10/01/2017,"Chateau Angelus Premier Grand Cru Classe B, Saint-Emilion Grand Cru",Bordeaux,2002,23/06/2021,10060452002,1006045
4400,13/05/2021,4902,27,4400,0,502,29/09/2020,"Chateau Margaux Premier Cru Classe, Margaux",Bordeaux,2001,14/05/2021,10127812001,1012781
880,13/05/2021,967,9,725,155,242,13/04/2021,"Chateau Calon Segur 3eme Cru Classe, Saint-Estephe",Bordeaux,2007,14/05/2021,10074752007,1007475
3750,13/05/2021,4070,27,3592,158,478,06/05/2021,"Chateau Margaux Premier Cru Classe, Margaux",Bordeaux,2007,14/05/2021,10127812007,1012781
1050,13/05/2021,1206,70,1048,2,158,27/04/2021,"Chateau Calon Segur 3eme Cru Classe, Saint-Estephe",Bordeaux,2016,14/05/2021,10074752016,1007475
950,13/05/2021,1014,61,863,87,151,10/05/2021,"Chateau Calon Segur 3eme Cru Classe, Saint-Estephe",Bordeaux,2006,14/05/2021,10074752006,1007475
490,10/05/2021,553,21,388,102,165,29/09/2020,"Tua Rita, Giusto di Notri, Toscana",Tuscany,2015,14/05/2021,11058072015,1105807
2924,22/06/2021,3131,8,2610,314,521,10/01/2017,"Chateau Angelus Premier Grand Cru Classe B, Saint-Emilion Grand Cru",Bordeaux,2002,26/06/2021,10060452002,1006045
2924,22/06/2021,3131,8,2610,314,521,10/01/2017,"Chateau Angelus Premier Grand Cru Classe B, Saint-Emilion Grand Cru",Bordeaux,2002,26/06/2021,10060452002,1006045
6300,26/05/2021,7541,56,6190,110,1351,23/05/2021,"Chateau Margaux Premier Cru Classe, Margaux",Bordeaux,2010,27/05/2021,10127812010,1012781
12456,13/05/2021,14434,2,12000,456,2434,28/05/2020,"Jacques-Frederic Mugnier, Chambolle-Musigny Premier Cru, Les Amoureuses",Burgundy,2014,14/05/2021,10496422014,1049642
412,11/05/2021,437,2,220,192,217,17/06/2015,"Chateau Batailley 5eme Cru Classe, Pauillac",Bordeaux,2002,12/05/2021,10063222002,1006322
2260,13/05/2021,2305,4,2190,70,115,01/05/2021,"Gaja, Barbaresco",Piedmont,2004,14/05/2021,10996052004,1099605
460,13/05/2021,486,149,420,40,66,23/03/2021,"Tua Rita, Giusto di Notri, Toscana",Tuscany,2016,14/05/2021,11058072016,1105807
1400,13/05/2021,1433,10,1276,124,157,05/03/2021,"Gaja, Barbaresco",Piedmont,2013,14/05/2021,10996052013,1099605
520,13/05/2021,575,4,460,60,115,05/05/2020,"Tua Rita, Giusto di Notri, Toscana",Tuscany,2008,14/05/2021,11058072008,1105807
1000,13/05/2021,1167,79,975,25,192,12/04/2021,"Chateau Calon Segur 3eme Cru Classe, Saint-Estephe",Bordeaux,2005,14/05/2021,10074752005,1007475
1350,13/05/2021,1452,7,1352,-2,100,23/09/2020,"Gaja, Barbaresco",Piedmont,2011,14/05/2021,10996052011,1099605
16200,13/05/2021,16056,0,18750,-2550,-2694,29/08/2018,"Jacques-Frederic Mugnier, Chambolle-Musigny Premier Cru, Les Amoureuses",Burgundy,2015,14/05/2021,10496422015,1049642
8040,13/05/2021,8232,20,7950,90,282,12/03/2021,"Chateau Margaux Premier Cru Classe, Margaux",Bordeaux,2000,14/05/2021,10127812000,1012781
2924,22/06/2021,3126,7,2610,314,516,10/01/2017,"Chateau Angelus Premier Grand Cru Classe B, Saint-Emilion Grand Cru",Bordeaux,2002,04/07/2021,10060452002,1006045
6100,03/05/2021,7488,51,5922,178,1566,13/04/2021,"Chateau Margaux Premier Cru Classe, Margaux",Bordeaux,2010,06/05/2021,10127812010,1012781
1700,26/05/2021,1666,4,1378,322,288,29/07/2020,"Tignanello, Toscana",Tuscany,2001,27/05/2021,10953912001,1095391
4850,20/05/2021,5700,32,4842,8,858,19/05/2021,"Chateau Margaux Premier Cru Classe, Margaux",Bordeaux,2003,27/05/2021,10127812003,1012781
589,11/05/2021,623,53,450,139,173,04/05/2021,"Chateau Batailley 5eme Cru Classe, Pauillac",Bordeaux,2005,12/05/2021,10063222005,1006322
908,26/05/2021,927,19,805,103,122,20/11/2019,"Chateau Calon Segur 3eme Cru Classe, Saint-Estephe",Bordeaux,2001,27/05/2021,10074752001,1007475
589,11/05/2021,623,53,450,139,173,04/05/2021,"Chateau Batailley 5eme Cru Classe, Pauillac",Bordeaux,2005,12/05/2021,10063222005,1006322
1000,26/05/2021,1158,42,1030,-30,128,25/05/2021,"Chateau Calon Segur 3eme Cru Classe, Saint-Estephe",Bordeaux,2009,27/05/2021,10074752009,1007475
450,11/05/2021,450,1,340,110,110,31/08/2018,"Chateau Batailley 5eme Cru Classe, Pauillac",Bordeaux,2007,12/05/2021,10063222007,1006322
790,26/05/2021,943,136,814,-24,129,13/05/2021,"Tignanello, Toscana",Tuscany,2017,27/05/2021,10953912017,1095391
1244,05/05/2021,1578,3,882,362,696,26/04/2019,"Tignanello, Toscana",Tuscany,2003,06/05/2021,10953912003,1095391
3720,05/05/2021,4074,51,3480,240,594,10/04/2021,"Chateau Margaux Premier Cru Classe, Margaux",Bordeaux,2014,06/05/2021,10127812014,1012781
1678,05/05/2021,1702,4,1180,498,522,25/06/2020,"Tignanello, Toscana",Tuscany,2004,06/05/2021,10953912004,1095391
1404,05/05/2021,1407,1,996,408,411,14/06/2019,"Tignanello, Toscana",Tuscany,2000,06/05/2021,10953912000,1095391
6750,05/05/2021,7944,99,6412,338,1532,25/03/2021,"Chateau Margaux Premier Cru Classe, Margaux",Bordeaux,2009,06/05/2021,10127812009,1012781
3827,04/05/2021,4605,56,4116,-289,489,25/02/2021,"Chateau Margaux Premier Cru Classe, Margaux",Bordeaux,2004,06/05/2021,10127812004,1012781
958,05/05/2021,1057,9,860,98,197,08/03/2021,"Tignanello, Toscana",Tuscany,2011,06/05/2021,10953912011,1095391
400,11/05/2021,443,9,332,68,111,06/10/2020,"Chateau Batailley 5eme Cru Classe, Pauillac",Bordeaux,2008,12/05/2021,10063222008,1006322
490,11/05/2021,553,21,504,-14,49,06/04/2021,"Chateau Batailley 5eme Cru Classe, Pauillac",Bordeaux,2009,12/05/2021,10063222009,1006322
490,11/05/2021,553,21,504,-14,49,06/04/2021,"Chateau Batailley 5eme Cru Classe, Pauillac",Bordeaux,2009,12/05/2021,10063222009,1006322
3900,05/07/2021,4288,82,3750,150,538,28/06/2021,"Chateau Margaux Premier Cru Classe, Margaux",Bordeaux,2008,06/07/2021,10127812008,1012781
400,11/05/2021,463,9,355,45,108,15/04/2021,"Chateau Batailley 5eme Cru Classe, Pauillac",Bordeaux,2012,12/05/2021,10063222012,1006322
6830,05/07/2021,7757,50,7086,-256,671,11/06/2021,"Chateau Margaux Premier Cru Classe, Margaux",Bordeaux,2009,06/07/2021,10127812009,1012781
400,11/05/2021,463,9,355,45,108,15/04/2021,"Chateau Batailley 5eme Cru Classe, Pauillac",Bordeaux,2012,12/05/2021,10063222012,1006322
3758,26/05/2021,4045,78,3690,68,355,13/04/2021,"Chateau Margaux Premier Cru Classe, Margaux",Bordeaux,2011,27/05/2021,10127812011,1012781
1050,26/05/2021,1137,7,860,190,277,08/03/2021,"Tignanello, Toscana",Tuscany,2013,27/05/2021,10953912013,1095391
1050,26/05/2021,1158,59,1034,16,124,25/05/2021,"Chateau Calon Segur 3eme Cru Classe, Saint-Estephe",Bordeaux,2016,27/05/2021,10074752016,1007475
3700,26/05/2021,4061,131,3700,0,361,06/05/2021,"Chateau Margaux Premier Cru Classe, Margaux",Bordeaux,2017,27/05/2021,10127812017,1012781
860,21/06/2021,1033,70,896,-36,137,17/06/2021,"Tignanello, Toscana",Tuscany,2018,23/06/2021,10953912018,1095391
900,05/05/2021,1062,21,800,100,262,21/11/2019,"Chateau Calon Segur 3eme Cru Classe, Saint-Estephe",Bordeaux,2003,06/05/2021,10074752003,1007475
2973,21/06/2021,3139,8,2610,363,529,10/01/2017,"Chateau Angelus Premier Grand Cru Classe B, Saint-Emilion Grand Cru",Bordeaux,2002,22/06/2021,10060452002,1006045
1020,05/05/2021,1129,17,1000,20,129,12/04/2021,"Chateau Calon Segur 3eme Cru Classe, Saint-Estephe",Bordeaux,2010,06/05/2021,10074752010,1007475
2973,21/06/2021,3139,8,2610,363,529,10/01/2017,"Chateau Angelus Premier Grand Cru Classe B, Saint-Emilion Grand Cru",Bordeaux,2002,22/06/2021,10060452002,1006045
1000,22/06/2021,1245,49,1030,-30,215,25/05/2021,"Chateau Calon Segur 3eme Cru Classe, Saint-Estephe",Bordeaux,2009,23/06/2021,10074752009,1007475
10328,21/06/2021,11941,52,9800,528,2141,11/06/2021,"Chateau Margaux Premier Cru Classe, Margaux",Bordeaux,2015,23/06/2021,10127812015,1012781
686,22/06/2021,838,8,682,4,156,15/09/2020,"Chateau Calon Segur 3eme Cru Classe, Saint-Estephe",Bordeaux,2013,23/06/2021,10074752013,1007475
2924,07/06/2021,3249,12,2610,314,639,10/01/2017,"Chateau Angelus Premier Grand Cru Classe B, Saint-Emilion Grand Cru",Bordeaux,2002,17/06/2021,10060452002,1006045
1678,22/06/2021,1683,4,1180,498,503,25/06/2020,"Tignanello, Toscana",Tuscany,2004,23/06/2021,10953912004,1095391
1080,22/06/2021,1229,51,950,130,279,03/05/2021,"Chateau Calon Segur 3eme Cru Classe, Saint-Estephe",Bordeaux,2018,23/06/2021,10074752018,1007475
780,05/05/2021,837,6,682,98,155,15/09/2020,"Chateau Calon Segur 3eme Cru Classe, Saint-Estephe",Bordeaux,2013,06/05/2021,10074752013,1007475
3800,05/05/2021,4362,134,3690,110,672,13/04/2021,"Chateau Margaux Premier Cru Classe, Margaux",Bordeaux,2011,06/05/2021,10127812011,1012781
2924,07/06/2021,3250,12,2610,314,640,10/01/2017,"Chateau Angelus Premier Grand Cru Classe B, Saint-Emilion Grand Cru",Bordeaux,2002,19/06/2021,10060452002,1006045
1050,24/05/2021,1219,19,940,110,279,18/03/2021,"Chateau Calon Segur 3eme Cru Classe, Saint-Estephe",Bordeaux,2000,27/05/2021,10074752000,1007475
2200,26/05/2021,2127,2,1340,860,787,13/03/2020,"Gaja, Barbaresco",Piedmont,2009,27/05/2021,10996052009,1099605
300,11/05/2021,301,109,304,-4,-3,10/01/2021,"Chateau Batailley 5eme Cru Classe, Pauillac",Bordeaux,2013,12/05/2021,10063222013,1006322
1050,11/05/2021,1344,48,940,110,404,18/03/2021,"Chateau Calon Segur 3eme Cru Classe, Saint-Estephe",Bordeaux,2000,14/05/2021,10074752000,1007475
2924,07/06/2021,3265,12,2610,314,655,10/01/2017,"Chateau Angelus Premier Grand Cru Classe B, Saint-Emilion Grand Cru",Bordeaux,2002,08/06/2021,10060452002,1006045
2924,07/06/2021,3139,8,2610,314,529,10/01/2017,"Chateau Angelus Premier Grand Cru Classe B, Saint-Emilion Grand Cru",Bordeaux,2002,20/06/2021,10060452002,1006045
960,21/06/2021,1246,14,850,110,396,28/01/2021,"Tignanello, Toscana",Tuscany,2012,23/06/2021,10953912012,1095391
2924,07/06/2021,3265,12,2610,314,655,10/01/2017,"Chateau Angelus Premier Grand Cru Classe B, Saint-Emilion Grand Cru",Bordeaux,2002,08/06/2021,10060452002,1006045
3900,21/06/2021,4494,25,3684,216,810,10/06/2020,"Chateau Margaux Premier Cru Classe, Margaux",Bordeaux,2002,23/06/2021,10127812002,1012781
4400,26/05/2021,4829,18,4400,0,429,29/09/2020,"Chateau Margaux Premier Cru Classe, Margaux",Bordeaux,2001,27/05/2021,10127812001,1012781
2924,07/06/2021,3249,12,2610,314,639,10/01/2017,"Chateau Angelus Premier Grand Cru Classe B, Saint-Emilion Grand Cru",Bordeaux,2002,17/06/2021,10060452002,1006045
3900,22/06/2021,4629,95,3822,78,807,20/06/2021,"Chateau Margaux Premier Cru Classe, Margaux",Bordeaux,2006,23/06/2021,10127812006,1012781
2924,07/06/2021,3250,12,2610,314,640,10/01/2017,"Chateau Angelus Premier Grand Cru Classe B, Saint-Emilion Grand Cru",Bordeaux,2002,19/06/2021,10060452002,1006045
5539,21/06/2021,5825,100,5238,301,587,17/05/2021,"Chateau Margaux Premier Cru Classe, Margaux",Bordeaux,2016,23/06/2021,10127812016,1012781
3900,22/06/2021,4269,76,3700,200,569,07/06/2021,"Chateau Margaux Premier Cru Classe, Margaux",Bordeaux,2008,23/06/2021,10127812008,1012781
950,22/06/2021,1019,52,863,87,156,10/05/2021,"Chateau Calon Segur 3eme Cru Classe, Saint-Estephe",Bordeaux,2006,23/06/2021,10074752006,1007475
1516,22/06/2021,1566,175,1358,158,208,12/05/2021,"Gaja, Barbaresco",Piedmont,2017,23/06/2021,10996052017,1099605
625,12/05/2021,677,8,470,155,207,29/03/2018,"Chateau Batailley 5eme Cru Classe, Pauillac",Bordeaux,2000,13/05/2021,10063222000,1006322
1000,05/05/2021,1181,69,975,25,206,12/04/2021,"Chateau Calon Segur 3eme Cru Classe, Saint-Estephe",Bordeaux,2005,06/05/2021,10074752005,1007475
2260,05/05/2021,2305,4,2190,70,115,01/05/2021,"Gaja, Barbaresco",Piedmont,2004,06/05/2021,10996052004,1099605
660,22/06/2021,727,5,390,270,337,18/08/2017,"Tua Rita, Giusto di Notri, Toscana",Tuscany,2006,23/06/2021,11058072006,1105807
2924,07/06/2021,3139,8,2610,314,529,10/01/2017,"Chateau Angelus Premier Grand Cru Classe B, Saint-Emilion Grand Cru",Bordeaux,2002,20/06/2021,10060452002,1006045
625,12/05/2021,678,8,470,155,208,29/03/2018,"Chateau Batailley 5eme Cru Classe, Pauillac",Bordeaux,2000,14/05/2021,10063222000,1006322
1000,05/05/2021,1219,17,1047,-47,172,27/04/2021,"Chateau Calon Segur 3eme Cru Classe, Saint-Estephe",Bordeaux,2009,06/05/2021,10074752009,1007475
625,12/05/2021,771,3,470,155,301,29/03/2018,"Chateau Batailley 5eme Cru Classe, Pauillac",Bordeaux,2000,13/06/2021,10063222000,1006322
430,26/05/2021,503,4,300,130,203,03/11/2011,"Tua Rita, Giusto di Notri, Toscana",Tuscany,2007,27/05/2021,11058072007,1105807
520,26/05/2021,563,5,460,60,103,05/05/2020,"Tua Rita, Giusto di Notri, Toscana",Tuscany,2008,27/05/2021,11058072008,1105807
5490,26/05/2021,5592,141,5254,236,338,26/05/2021,"Chateau Margaux Premier Cru Classe, Margaux",Bordeaux,2018,27/05/2021,10127812018,1012781
3827,26/05/2021,4507,62,4116,-289,391,25/02/2021,"Chateau Margaux Premier Cru Classe, Margaux",Bordeaux,2004,27/05/2021,10127812004,1012781
625,12/05/2021,771,3,470,155,301,29/03/2018,"Chateau Batailley 5eme Cru Classe, Pauillac",Bordeaux,2000,13/06/2021,10063222000,1006322
1408,05/05/2021,1434,5,1238,170,196,02/11/2020,"Tignanello, Toscana",Tuscany,2006,06/05/2021,10953912006,1095391
3560,05/05/2021,4093,28,3450,110,643,11/11/2020,"Chateau Margaux Premier Cru Classe, Margaux",Bordeaux,2007,06/05/2021,10127812007,1012781
2924,26/05/2021,3265,12,2610,314,655,10/01/2017,"Chateau Angelus Premier Grand Cru Classe B, Saint-Emilion Grand Cru",Bordeaux,2002,27/05/2021,10060452002,1006045
2924,26/05/2021,3265,12,2610,314,655,10/01/2017,"Chateau Angelus Premier Grand Cru Classe B, Saint-Emilion Grand Cru",Bordeaux,2002,27/05/2021,10060452002,1006045
3800,05/05/2021,4170,32,3560,240,610,20/11/2020,"Chateau Margaux Premier Cru Classe, Margaux",Bordeaux,2012,06/05/2021,10127812012,1012781
1100,05/05/2021,1460,9,1010,90,450,18/12/2020,"Tignanello, Toscana",Tuscany,2008,06/05/2021,10953912008,1095391
8400,13/05/2021,8400,0,7200,1200,1200,06/11/2019,"Domaine Denis Mortet, Chambertin Grand Cru",Burgundy,2014,14/05/2021,10490202014,1049020
540,10/05/2021,546,3,544,-4,2,18/09/2020,"Tua Rita, Giusto di Notri, Toscana",Tuscany,2013,14/05/2021,11058072013,1105807
750,05/05/2021,1008,37,790,-40,218,01/06/2020,"Chateau Calon Segur 3eme Cru Classe, Saint-Estephe",Bordeaux,2011,06/05/2021,10074752011,1007475
2974,25/05/2021,3265,12,2610,364,655,10/01/2017,"Chateau Angelus Premier Grand Cru Classe B, Saint-Emilion Grand Cru",Bordeaux,2002,26/05/2021,10060452002,1006045
1280,05/05/2021,1225,11,1172,108,53,07/04/2021,"Tignanello, Toscana",Tuscany,2010,06/05/2021,10953912010,1095391
3900,05/05/2021,4447,32,3684,216,763,10/06/2020,"Chateau Margaux Premier Cru Classe, Margaux",Bordeaux,2002,06/05/2021,10127812002,1012781
8000,05/05/2021,8137,19,7950,50,187,12/03/2021,"Chateau Margaux Premier Cru Classe, Margaux",Bordeaux,2000,06/05/2021,10127812000,1012781
1700,05/05/2021,1654,3,1378,322,276,29/07/2020,"Tignanello, Toscana",Tuscany,2001,06/05/2021,10953912001,1095391
625,12/05/2021,674,9,470,155,204,29/03/2018,"Chateau Batailley 5eme Cru Classe, Pauillac",Bordeaux,2000,12/06/2021,10063222000,1006322
487,21/06/2021,533,26,388,99,145,29/09/2020,"Tua Rita, Giusto di Notri, Toscana",Tuscany,2015,23/06/2021,11058072015,1105807
1570,22/06/2021,1344,3,1200,370,144,06/03/2021,"Tignanello, Toscana",Tuscany,2007,23/06/2021,10953912007,1095391
880,05/05/2021,948,10,725,155,223,13/04/2021,"Chateau Calon Segur 3eme Cru Classe, Saint-Estephe",Bordeaux,2007,06/05/2021,10074752007,1007475
3910,05/05/2021,4764,81,3800,110,964,07/04/2021,"Chateau Margaux Premier Cru Classe, Margaux",Bordeaux,2006,06/05/2021,10127812006,1012781
1408,05/05/2021,1487,2,1150,258,337,21/04/2019,"Tignanello, Toscana",Tuscany,2005,06/05/2021,10953912005,1095391
790,26/05/2021,971,22,745,45,226,16/11/2020,"Chateau Calon Segur 3eme Cru Classe, Saint-Estephe",Bordeaux,2004,27/05/2021,10074752004,1007475
2974,25/05/2021,3265,12,2610,364,655,10/01/2017,"Chateau Angelus Premier Grand Cru Classe B, Saint-Emilion Grand Cru",Bordeaux,2002,26/05/2021,10060452002,1006045
625,12/05/2021,628,7,470,155,158,29/03/2018,"Chateau Batailley 5eme Cru Classe, Pauillac",Bordeaux,2000,30/05/2021,10063222000,1006322
1079,21/06/2021,1217,67,1036,43,181,27/05/2021,"Chateau Calon Segur 3eme Cru Classe, Saint-Estephe",Bordeaux,2016,23/06/2021,10074752016,1007475
1350,26/05/2021,1432,7,1352,-2,80,23/09/2020,"Gaja, Barbaresco",Piedmont,2011,27/05/2021,10996052011,1099605
990,26/05/2021,1114,22,1000,-10,114,12/04/2021,"Chateau Calon Segur 3eme Cru Classe, Saint-Estephe",Bordeaux,2010,27/05/2021,10074752010,1007475
8040,26/05/2021,8366,18,7950,90,416,12/03/2021,"Chateau Margaux Premier Cru Classe, Margaux",Bordeaux,2000,27/05/2021,10127812000,1012781
2974,24/05/2021,3271,11,2610,364,661,10/01/2017,"Chateau Angelus Premier Grand Cru Classe B, Saint-Emilion Grand Cru",Bordeaux,2002,25/05/2021,10060452002,1006045
3740,26/05/2021,3967,45,3520,220,447,07/04/2021,"Chateau Margaux Premier Cru Classe, Margaux",Bordeaux,2013,27/05/2021,10127812013,1012781
1550,22/06/2021,1557,1,1300,250,257,27/04/2021,"Gaja, Barbaresco",Piedmont,2012,23/06/2021,10996052012,1099605
625,12/05/2021,677,8,470,155,207,29/03/2018,"Chateau Batailley 5eme Cru Classe, Pauillac",Bordeaux,2000,13/05/2021,10063222000,1006322
1000,17/06/2021,1053,8,880,120,173,22/06/2021,"Tignanello, Toscana",Tuscany,2011,23/06/2021,10953912011,1095391
2974,24/05/2021,3271,11,2610,364,661,10/01/2017,"Chateau Angelus Premier Grand Cru Classe B, Saint-Emilion Grand Cru",Bordeaux,2002,25/05/2021,10060452002,1006045
5000,26/05/2021,5010,8,4160,840,850,19/03/2021,"Chateau Margaux Premier Cru Classe, Margaux",Bordeaux,2019,27/05/2021,10127812019,1012781
3860,19/05/2021,4713,78,3800,60,913,07/04/2021,"Chateau Margaux Premier Cru Classe, Margaux",Bordeaux,2006,27/05/2021,10127812006,1012781
2924,10/05/2021,3158,7,2610,314,548,10/01/2017,"Chateau Angelus Premier Grand Cru Classe B, Saint-Emilion Grand Cru",Bordeaux,2002,11/05/2021,10060452002,1006045
920,04/05/2021,1096,46,830,90,266,18/04/2021,"Tignanello, Toscana",Tuscany,2014,14/05/2021,10953912014,1095391
995,13/05/2021,1116,19,1000,-5,116,12/04/2021,"Chateau Calon Segur 3eme Cru Classe, Saint-Estephe",Bordeaux,2010,14/05/2021,10074752010,1007475
625,12/05/2021,674,9,470,155,204,29/03/2018,"Chateau Batailley 5eme Cru Classe, Pauillac",Bordeaux,2000,12/06/2021,10063222000,1006322
1000,22/06/2021,1155,93,988,12,167,28/05/2021,"Chateau Calon Segur 3eme Cru Classe, Saint-Estephe",Bordeaux,2005,23/06/2021,10074752005,1007475
789,02/06/2021,976,21,745,44,231,16/11/2020,"Chateau Calon Segur 3eme Cru Classe, Saint-Estephe",Bordeaux,2004,03/06/2021,10074752004,1007475
625,12/05/2021,628,7,470,155,158,29/03/2018,"Chateau Batailley 5eme Cru Classe, Pauillac",Bordeaux,2000,30/05/2021,10063222000,1006322
625,12/05/2021,678,8,470,155,208,29/03/2018,"Chateau Batailley 5eme Cru Classe, Pauillac",Bordeaux,2000,14/05/2021,10063222000,1006322
3750,26/05/2021,4115,32,3592,158,523,06/05/2021,"Chateau Margaux Premier Cru Classe, Margaux",Bordeaux,2007,27/05/2021,10127812007,1012781
6400,19/05/2021,6400,1,4500,1900,1900,08/04/2015,"Domaine Leflaive, Chevalier-Montrachet Grand Cru",Burgundy,2012,27/05/2021,10734012012,1073401
2924,10/05/2021,3271,11,2610,314,661,10/01/2017,"Chateau Angelus Premier Grand Cru Classe B, Saint-Emilion Grand Cru",Bordeaux,2002,20/05/2021,10060452002,1006045
6750,26/05/2021,7647,42,6525,225,1122,23/05/2021,"Chateau Margaux Premier Cru Classe, Margaux",Bordeaux,2009,27/05/2021,10127812009,1012781
17000,26/05/2021,15189,7,13000,4000,2189,29/04/2021,"Jacques-Frederic Mugnier, Chambolle-Musigny Premier Cru, Les Amoureuses",Burgundy,2017,27/05/2021,10496422017,1049642
2924,10/05/2021,3158,7,2610,314,548,10/01/2017,"Chateau Angelus Premier Grand Cru Classe B, Saint-Emilion Grand Cru",Bordeaux,2002,11/05/2021,10060452002,1006045
2924,10/05/2021,3271,11,2610,314,661,10/01/2017,"Chateau Angelus Premier Grand Cru Classe B, Saint-Emilion Grand Cru",Bordeaux,2002,20/05/2021,10060452002,1006045
1350,26/05/2021,1473,61,1260,90,213,18/02/2021,"Gaja, Barbaresco",Piedmont,2015,27/05/2021,10996052015,1099605
7906,13/05/2021,7852,2,7124,782,728,15/02/2019,"Domaine Leflaive, Chevalier-Montrachet Grand Cru",Burgundy,2016,14/05/2021,10734012016,1073401
780,12/05/2021,892,137,814,-34,78,13/05/2021,"Tignanello, Toscana",Tuscany,2017,14/05/2021,10953912017,1095391
450,12/05/2021,450,1,340,110,110,31/08/2018,"Chateau Batailley 5eme Cru Classe, Pauillac",Bordeaux,2007,13/05/2021,10063222007,1006322
3800,13/05/2021,4070,50,3480,320,590,10/04/2021,"Chateau Margaux Premier Cru Classe, Margaux",Bordeaux,2014,14/05/2021,10127812014,1012781
16200,22/06/2021,16040,0,18750,-2550,-2710,29/08/2018,"Jacques-Frederic Mugnier, Chambolle-Musigny Premier Cru, Les Amoureuses",Burgundy,2015,23/06/2021,10496422015,1049642
3740,22/06/2021,4030,62,3520,220,510,07/04/2021,"Chateau Margaux Premier Cru Classe, Margaux",Bordeaux,2013,23/06/2021,10127812013,1012781
1300,22/06/2021,1443,7,1352,-52,91,23/09/2020,"Gaja, Barbaresco",Piedmont,2011,23/06/2021,10996052011,1099605
3826,02/06/2021,4532,59,4116,-290,416,25/02/2021,"Chateau Margaux Premier Cru Classe, Margaux",Bordeaux,2004,03/06/2021,10127812004,1012781
10500,05/05/2021,12468,69,9844,656,2624,29/03/2021,"Chateau Margaux Premier Cru Classe, Margaux",Bordeaux,2015,06/05/2021,10127812015,1012781
1300,05/05/2021,1342,3,1200,100,142,06/03/2021,"Tignanello, Toscana",Tuscany,2007,06/05/2021,10953912007,1095391
2974,07/05/2021,3194,6,2610,364,584,10/01/2017,"Chateau Angelus Premier Grand Cru Classe B, Saint-Emilion Grand Cru",Bordeaux,2002,10/05/2021,10060452002,1006045
3720,26/05/2021,4110,42,3480,240,630,10/04/2021,"Chateau Margaux Premier Cru Classe, Margaux",Bordeaux,2014,27/05/2021,10127812014,1012781
2974,07/05/2021,3156,7,2610,364,546,10/01/2017,"Chateau Angelus Premier Grand Cru Classe B, Saint-Emilion Grand Cru",Bordeaux,2002,08/05/2021,10060452002,1006045
2974,07/05/2021,3194,6,2610,364,584,10/01/2017,"Chateau Angelus Premier Grand Cru Classe B, Saint-Emilion Grand Cru",Bordeaux,2002,10/05/2021,10060452002,1006045
2098,22/06/2021,2300,4,2190,-92,110,01/05/2021,"Gaja, Barbaresco",Piedmont,2004,23/06/2021,10996052004,1099605
1850,22/06/2021,1831,1,1180,670,651,10/03/2017,"Gaja, Barbaresco",Piedmont,2005,23/06/2021,10996052005,1099605
8100,21/06/2021,8544,18,8100,0,444,21/06/2021,"Chateau Margaux Premier Cru Classe, Margaux",Bordeaux,2000,23/06/2021,10127812000,1012781
750,17/06/2021,925,109,740,10,185,21/05/2021,"Chateau Calon Segur 3eme Cru Classe, Saint-Estephe",Bordeaux,2017,23/06/2021,10074752017,1007475
3826,22/06/2021,4518,54,4116,-290,402,25/02/2021,"Chateau Margaux Premier Cru Classe, Margaux",Bordeaux,2004,23/06/2021,10127812004,1012781
1390,09/06/2021,1531,15,1276,114,255,05/03/2021,"Gaja, Barbaresco",Piedmont,2013,23/06/2021,10996052013,1099605
8000,22/06/2021,8657,5,6974,1026,1683,14/03/2021,"Domaine Leflaive, Chevalier-Montrachet Grand Cru",Burgundy,2017,23/06/2021,10734012017,1073401
400,12/05/2021,443,9,332,68,111,06/10/2020,"Chateau Batailley 5eme Cru Classe, Pauillac",Bordeaux,2008,13/05/2021,10063222008,1006322
9950,05/05/2021,9718,3,8000,1950,1718,30/01/2020,"Domaine Leflaive, Chevalier-Montrachet Grand Cru",Burgundy,2014,06/05/2021,10734012014,1073401
4400,05/05/2021,4898,27,4400,0,498,29/09/2020,"Chateau Margaux Premier Cru Classe, Margaux",Bordeaux,2001,06/05/2021,10127812001,1012781
840,12/05/2021,921,26,842,-2,79,22/08/2020,"Chateau Calon Segur 3eme Cru Classe, Saint-Estephe",Bordeaux,2019,14/05/2021,10074752019,1007475
2872,13/05/2021,2872,2,2554,318,318,22/05/2020,"Gaja, Barbaresco",Piedmont,2006,14/05/2021,10996052006,1099605
490,12/05/2021,552,21,504,-14,48,06/04/2021,"Chateau Batailley 5eme Cru Classe, Pauillac",Bordeaux,2009,13/05/2021,10063222009,1006322
2974,07/05/2021,3156,7,2610,364,546,10/01/2017,"Chateau Angelus Premier Grand Cru Classe B, Saint-Emilion Grand Cru",Bordeaux,2002,08/05/2021,10060452002,1006045
8400,24/05/2021,8933,1,5960,2440,2973,01/08/2017,"Domaine Leflaive, Chevalier-Montrachet Grand Cru",Burgundy,2010,27/05/2021,10734012010,1073401
750,18/05/2021,885,120,740,10,145,21/05/2021,"Chateau Calon Segur 3eme Cru Classe, Saint-Estephe",Bordeaux,2017,27/05/2021,10074752017,1007475
5580,26/05/2021,5654,67,5238,342,416,17/05/2021,"Chateau Margaux Premier Cru Classe, Margaux",Bordeaux,2016,27/05/2021,10127812016,1012781
2974,06/05/2021,3172,8,2610,364,562,10/01/2017,"Chateau Angelus Premier Grand Cru Classe B, Saint-Emilion Grand Cru",Bordeaux,2002,07/05/2021,10060452002,1006045
1000,26/05/2021,1156,96,1000,0,156,25/05/2021,"Chateau Calon Segur 3eme Cru Classe, Saint-Estephe",Bordeaux,2005,27/05/2021,10074752005,1007475
750,02/06/2021,1015,52,790,-40,225,01/06/2020,"Chateau Calon Segur 3eme Cru Classe, Saint-Estephe",Bordeaux,2011,03/06/2021,10074752011,1007475
880,02/06/2021,986,13,725,155,261,13/04/2021,"Chateau Calon Segur 3eme Cru Classe, Saint-Estephe",Bordeaux,2007,03/06/2021,10074752007,1007475
1029,31/05/2021,1152,7,860,169,292,08/03/2021,"Tignanello, Toscana",Tuscany,2013,03/06/2021,10953912013,1095391
5600,10/05/2021,5853,1,4400,1200,1453,06/11/2017,"Domaine Leflaive, Chevalier-Montrachet Grand Cru",Burgundy,2013,14/05/2021,10734012013,1073401
3860,10/05/2021,4792,77,3800,60,992,07/04/2021,"Chateau Margaux Premier Cru Classe, Margaux",Bordeaux,2006,14/05/2021,10127812006,1012781
2974,06/05/2021,3172,8,2610,364,562,10/01/2017,"Chateau Angelus Premier Grand Cru Classe B, Saint-Emilion Grand Cru",Bordeaux,2002,07/05/2021,10060452002,1006045
490,12/05/2021,552,21,504,-14,48,06/04/2021,"Chateau Batailley 5eme Cru Classe, Pauillac",Bordeaux,2009,13/05/2021,10063222009,1006322
2974,05/05/2021,3172,8,2610,364,562,10/01/2017,"Chateau Angelus Premier Grand Cru Classe B, Saint-Emilion Grand Cru",Bordeaux,2002,06/05/2021,10060452002,1006045
7600,22/06/2021,7792,2,7124,476,668,15/02/2019,"Domaine Leflaive, Chevalier-Montrachet Grand Cru",Burgundy,2016,23/06/2021,10734012016,1073401
2974,05/05/2021,3172,8,2610,364,562,10/01/2017,"Chateau Angelus Premier Grand Cru Classe B, Saint-Emilion Grand Cru",Bordeaux,2002,06/05/2021,10060452002,1006045
400,12/05/2021,463,9,355,45,108,15/04/2021,"Chateau Batailley 5eme Cru Classe, Pauillac",Bordeaux,2012,13/05/2021,10063222012,1006322
460,22/06/2021,493,188,420,40,73,28/05/2021,"Tua Rita, Giusto di Notri, Toscana",Tuscany,2016,23/06/2021,11058072016,1105807
400,12/05/2021,463,9,355,45,108,15/04/2021,"Chateau Batailley 5eme Cru Classe, Pauillac",Bordeaux,2012,13/05/2021,10063222012,1006322
14520,22/06/2021,14520,1,12000,2520,2520,28/05/2020,"Jacques-Frederic Mugnier, Chambolle-Musigny Premier Cru, Les Amoureuses",Burgundy,2014,23/06/2021,10496422014,1049642
2974,04/05/2021,3172,8,2610,364,562,10/01/2017,"Chateau Angelus Premier Grand Cru Classe B, Saint-Emilion Grand Cru",Bordeaux,2002,05/05/2021,10060452002,1006045
3900,26/05/2021,4437,92,3800,100,637,12/05/2021,"Chateau Margaux Premier Cru Classe, Margaux",Bordeaux,2008,27/05/2021,10127812008,1012781
6552,26/05/2021,6552,0,3920,2632,2632,26/04/2017,"Domaine Leflaive, Chevalier-Montrachet Grand Cru",Burgundy,2006,27/05/2021,10734012006,1073401
2974,04/05/2021,3172,8,2610,364,562,10/01/2017,"Chateau Angelus Premier Grand Cru Classe B, Saint-Emilion Grand Cru",Bordeaux,2002,05/05/2021,10060452002,1006045
1280,26/05/2021,1328,6,1200,80,128,06/03/2021,"Tignanello, Toscana",Tuscany,2007,27/05/2021,10953912007,1095391
2974,03/05/2021,3171,8,2610,364,561,10/01/2017,"Chateau Angelus Premier Grand Cru Classe B, Saint-Emilion Grand Cru",Bordeaux,2002,04/05/2021,10060452002,1006045
7800,22/06/2021,8255,5,7330,470,925,02/06/2021,"Domaine Leflaive, Chevalier-Montrachet Grand Cru",Burgundy,2018,23/06/2021,10734012018,1073401
907,05/05/2021,1099,29,805,102,294,20/11/2019,"Chateau Calon Segur 3eme Cru Classe, Saint-Estephe",Bordeaux,2001,06/05/2021,10074752001,1007475
3700,05/05/2021,4010,24,3520,180,490,07/04/2021,"Chateau Margaux Premier Cru Classe, Margaux",Bordeaux,2013,06/05/2021,10127812013,1012781
790,05/05/2021,914,40,794,-4,120,20/04/2021,"Chateau Calon Segur 3eme Cru Classe, Saint-Estephe",Bordeaux,2014,06/05/2021,10074752014,1007475
6250,04/05/2021,7051,45,6400,-150,651,15/04/2021,"Chateau Margaux Premier Cru Classe, Margaux",Bordeaux,2005,06/05/2021,10127812005,1012781
1100,26/05/2021,1513,7,1010,90,503,18/12/2020,"Tignanello, Toscana",Tuscany,2008,27/05/2021,10953912008,1095391
2974,03/05/2021,3171,8,2610,364,561,10/01/2017,"Chateau Angelus Premier Grand Cru Classe B, Saint-Emilion Grand Cru",Bordeaux,2002,04/05/2021,10060452002,1006045
3300,10/08/2021,3480,10,3155,145,325,08/07/2021,"Chateau Angelus Premier Grand Cru Classe B, Saint-Emilion Grand Cru",Bordeaux,2003,11/08/2021,10060452003,1006045
460,26/05/2021,486,149,420,40,66,23/03/2021,"Tua Rita, Giusto di Notri, Toscana",Tuscany,2016,27/05/2021,11058072016,1105807
3300,10/08/2021,3480,10,3155,145,325,08/07/2021,"Chateau Angelus Premier Grand Cru Classe B, Saint-Emilion Grand Cru",Bordeaux,2003,11/08/2021,10060452003,1006045
3300,09/08/2021,3480,10,3155,145,325,08/07/2021,"Chateau Angelus Premier Grand Cru Classe B, Saint-Emilion Grand Cru",Bordeaux,2003,10/08/2021,10060452003,1006045
300,12/05/2021,301,109,304,-4,-3,10/01/2021,"Chateau Batailley 5eme Cru Classe, Pauillac",Bordeaux,2013,13/05/2021,10063222013,1006322
1299,05/05/2021,1460,9,1010,289,450,18/12/2020,"Tignanello, Toscana",Tuscany,2008,07/05/2021,10953912008,1095391
3300,09/08/2021,3480,10,3155,145,325,08/07/2021,"Chateau Angelus Premier Grand Cru Classe B, Saint-Emilion Grand Cru",Bordeaux,2003,10/08/2021,10060452003,1006045
940,17/06/2021,1106,42,830,110,276,22/06/2021,"Tignanello, Toscana",Tuscany,2014,23/06/2021,10953912014,1095391
880,22/06/2021,967,9,725,155,242,13/04/2021,"Chateau Calon Segur 3eme Cru Classe, Saint-Estephe",Bordeaux,2007,23/06/2021,10074752007,1007475
1100,13/05/2021,1536,7,1010,90,526,18/12/2020,"Tignanello, Toscana",Tuscany,2008,14/05/2021,10953912008,1095391
4800,12/05/2021,5738,26,4800,0,938,11/03/2021,"Chateau Margaux Premier Cru Classe, Margaux",Bordeaux,2003,14/05/2021,10127812003,1012781
3631,06/08/2021,3500,9,3155,476,345,08/07/2021,"Chateau Angelus Premier Grand Cru Classe B, Saint-Emilion Grand Cru",Bordeaux,2003,07/08/2021,10060452003,1006045
866,17/05/2021,1075,28,842,24,233,22/08/2020,"Chateau Calon Segur 3eme Cru Classe, Saint-Estephe",Bordeaux,2019,27/05/2021,10074752019,1007475
3720,22/06/2021,4311,146,3480,240,831,17/06/2021,"Chateau Margaux Premier Cru Classe, Margaux",Bordeaux,2014,23/06/2021,10127812014,1012781
950,02/06/2021,1006,62,863,87,143,10/05/2021,"Chateau Calon Segur 3eme Cru Classe, Saint-Estephe",Bordeaux,2006,03/06/2021,10074752006,1007475
412,13/05/2021,437,2,220,192,217,17/06/2015,"Chateau Batailley 5eme Cru Classe, Pauillac",Bordeaux,2002,14/05/2021,10063222002,1006322
8040,02/06/2021,8513,22,7950,90,563,12/03/2021,"Chateau Margaux Premier Cru Classe, Margaux",Bordeaux,2000,03/06/2021,10127812000,1012781
4850,27/05/2021,5637,36,4842,8,795,19/05/2021,"Chateau Margaux Premier Cru Classe, Margaux",Bordeaux,2003,03/06/2021,10127812003,1012781
2872,26/05/2021,2872,1,2554,318,318,22/05/2020,"Gaja, Barbaresco",Piedmont,2006,27/05/2021,10996052006,1099605
1020,26/05/2021,1049,9,860,160,189,08/03/2021,"Tignanello, Toscana",Tuscany,2011,27/05/2021,10953912011,1095391
7800,26/05/2021,8198,8,7000,800,1198,26/04/2021,"Domaine Leflaive, Chevalier-Montrachet Grand Cru",Burgundy,2018,27/05/2021,10734012018,1073401
880,26/05/2021,986,13,725,155,261,13/04/2021,"Chateau Calon Segur 3eme Cru Classe, Saint-Estephe",Bordeaux,2007,27/05/2021,10074752007,1007475
2500,22/06/2021,2636,2,2220,280,416,14/06/2021,"Gaja, Barbaresco",Piedmont,2001,23/06/2021,10996052001,1099605
790,13/05/2021,927,41,794,-4,133,20/04/2021,"Chateau Calon Segur 3eme Cru Classe, Saint-Estephe",Bordeaux,2014,14/05/2021,10074752014,1007475
10500,13/05/2021,12365,75,9844,656,2521,29/03/2021,"Chateau Margaux Premier Cru Classe, Margaux",Bordeaux,2015,14/05/2021,10127812015,1012781
10660,26/05/2021,12622,64,9844,816,2778,29/03/2021,"Chateau Margaux Premier Cru Classe, Margaux",Bordeaux,2015,27/05/2021,10127812015,1012781
1408,22/06/2021,1389,4,1238,170,151,02/11/2020,"Tignanello, Toscana",Tuscany,2006,23/06/2021,10953912006,1095391
3750,14/06/2021,4211,40,3560,190,651,20/11/2020,"Chateau Margaux Premier Cru Classe, Margaux",Bordeaux,2012,23/06/2021,10127812012,1012781
1245,22/06/2021,1615,2,882,363,733,26/04/2019,"Tignanello, Toscana",Tuscany,2003,23/06/2021,10953912003,1095391
3631,06/08/2021,3500,9,3155,476,345,08/07/2021,"Chateau Angelus Premier Grand Cru Classe B, Saint-Emilion Grand Cru",Bordeaux,2003,07/08/2021,10060452003,1006045
550,13/05/2021,532,3,420,130,112,09/07/2019,"Chateau Batailley 5eme Cru Classe, Pauillac",Bordeaux,2003,14/05/2021,10063222003,1006322
3631,04/08/2021,3504,9,3155,476,349,08/07/2021,"Chateau Angelus Premier Grand Cru Classe B, Saint-Emilion Grand Cru",Bordeaux,2003,05/08/2021,10060452003,1006045
1500,26/05/2021,1687,50,1408,92,279,09/04/2021,"Gaja, Barbaresco",Piedmont,2016,27/05/2021,10996052016,1099605
1200,12/05/2021,1148,124,1108,92,40,08/05/2021,"Tignanello, Toscana",Tuscany,2016,14/05/2021,10953912016,1095391
3758,13/05/2021,4375,127,3690,68,685,13/04/2021,"Chateau Margaux Premier Cru Classe, Margaux",Bordeaux,2011,14/05/2021,10127812011,1012781
6400,22/06/2021,7417,41,6776,-376,641,10/06/2021,"Chateau Margaux Premier Cru Classe, Margaux",Bordeaux,2005,23/06/2021,10127812005,1012781
3631,04/08/2021,3504,9,3155,476,349,08/07/2021,"Chateau Angelus Premier Grand Cru Classe B, Saint-Emilion Grand Cru",Bordeaux,2003,05/08/2021,10060452003,1006045
3900,02/06/2021,4700,78,3861,39,839,28/05/2021,"Chateau Margaux Premier Cru Classe, Margaux",Bordeaux,2006,03/06/2021,10127812006,1012781
1280,26/05/2021,1367,8,1172,108,195,07/04/2021,"Tignanello, Toscana",Tuscany,2010,27/05/2021,10953912010,1095391
3631,02/08/2021,3516,10,3155,476,361,08/07/2021,"Chateau Angelus Premier Grand Cru Classe B, Saint-Emilion Grand Cru",Bordeaux,2003,03/08/2021,10060452003,1006045
550,13/05/2021,550,2,420,130,130,09/07/2019,"Chateau Batailley 5eme Cru Classe, Pauillac",Bordeaux,2003,16/05/2021,10063222003,1006322
3758,02/06/2021,4047,98,3690,68,357,13/04/2021,"Chateau Margaux Premier Cru Classe, Margaux",Bordeaux,2011,03/06/2021,10127812011,1012781
950,26/05/2021,1003,58,863,87,140,10/05/2021,"Chateau Calon Segur 3eme Cru Classe, Saint-Estephe",Bordeaux,2006,27/05/2021,10074752006,1007475
660,26/05/2021,724,4,390,270,334,18/08/2017,"Tua Rita, Giusto di Notri, Toscana",Tuscany,2006,27/05/2021,11058072006,1105807
3631,02/08/2021,3516,10,3155,476,361,08/07/2021,"Chateau Angelus Premier Grand Cru Classe B, Saint-Emilion Grand Cru",Bordeaux,2003,03/08/2021,10060452003,1006045
4850,18/06/2021,5655,28,4650,200,1005,21/06/2021,"Chateau Margaux Premier Cru Classe, Margaux",Bordeaux,2003,23/06/2021,10127812003,1012781
3300,30/07/2021,3515,10,3155,145,360,08/07/2021,"Chateau Angelus Premier Grand Cru Classe B, Saint-Emilion Grand Cru",Bordeaux,2003,31/07/2021,10060452003,1006045
6250,26/05/2021,7073,39,6360,-110,713,24/05/2021,"Chateau Margaux Premier Cru Classe, Margaux",Bordeaux,2005,27/05/2021,10127812005,1012781
3900,25/05/2021,4505,29,3684,216,821,10/06/2020,"Chateau Margaux Premier Cru Classe, Margaux",Bordeaux,2002,27/05/2021,10127812002,1012781
3300,30/07/2021,3515,10,3155,145,360,08/07/2021,"Chateau Angelus Premier Grand Cru Classe B, Saint-Emilion Grand Cru",Bordeaux,2003,31/07/2021,10060452003,1006045
1200,26/05/2021,1253,40,1124,76,129,19/05/2021,"Tignanello, Toscana",Tuscany,2016,27/05/2021,10953912016,1095391
750,04/05/2021,886,125,760,-10,126,29/04/2021,"Chateau Calon Segur 3eme Cru Classe, Saint-Estephe",Bordeaux,2017,14/05/2021,10074752017,1007475
525,13/05/2021,496,2,300,225,196,15/12/2019,"Chateau Batailley 5eme Cru Classe, Pauillac",Bordeaux,2004,14/05/2021,10063222004,1006322
3300,29/07/2021,3514,10,3155,145,359,08/07/2021,"Chateau Angelus Premier Grand Cru Classe B, Saint-Emilion Grand Cru",Bordeaux,2003,30/07/2021,10060452003,1006045
1120,13/05/2021,1223,12,1172,-52,51,07/04/2021,"Tignanello, Toscana",Tuscany,2010,14/05/2021,10953912010,1095391
525,13/05/2021,538,1,300,225,238,15/12/2019,"Chateau Batailley 5eme Cru Classe, Pauillac",Bordeaux,2004,21/05/2021,10063222004,1006322
1280,26/05/2021,1328,6,1200,80,128,06/03/2021,"Tignanello, Toscana",Tuscany,2007,27/05/2021,10953912007,1095391
1020,26/05/2021,1049,9,860,160,189,08/03/2021,"Tignanello, Toscana",Tuscany,2011,27/05/2021,10953912011,1095391
3300,29/07/2021,3514,10,3155,145,359,08/07/2021,"Chateau Angelus Premier Grand Cru Classe B, Saint-Emilion Grand Cru",Bordeaux,2003,30/07/2021,10060452003,1006045
3300,28/07/2021,3538,9,3155,145,383,08/07/2021,"Chateau Angelus Premier Grand Cru Classe B, Saint-Emilion Grand Cru",Bordeaux,2003,29/07/2021,10060452003,1006045
6400,22/06/2021,7483,53,6190,210,1293,23/05/2021,"Chateau Margaux Premier Cru Classe, Margaux",Bordeaux,2010,23/06/2021,10127812010,1012781
990,22/06/2021,1108,16,990,0,118,16/06/2021,"Chateau Calon Segur 3eme Cru Classe, Saint-Estephe",Bordeaux,2010,23/06/2021,10074752010,1007475
1299,22/06/2021,1459,7,1010,289,449,18/12/2020,"Tignanello, Toscana",Tuscany,2008,23/06/2021,10953912008,1095391
6830,21/06/2021,7698,51,7086,-256,612,11/06/2021,"Chateau Margaux Premier Cru Classe, Margaux",Bordeaux,2009,23/06/2021,10127812009,1012781
3560,02/06/2021,4097,36,3592,-32,505,06/05/2021,"Chateau Margaux Premier Cru Classe, Margaux",Bordeaux,2007,03/06/2021,10127812007,1012781
907,02/06/2021,955,24,805,102,150,20/11/2019,"Chateau Calon Segur 3eme Cru Classe, Saint-Estephe",Bordeaux,2001,03/06/2021,10074752001,1007475
1408,22/06/2021,1436,1,1150,258,286,21/04/2019,"Tignanello, Toscana",Tuscany,2005,23/06/2021,10953912005,1095391
3700,22/06/2021,4228,110,3646,54,582,16/06/2021,"Chateau Margaux Premier Cru Classe, Margaux",Bordeaux,2017,23/06/2021,10127812017,1012781
3560,21/06/2021,4163,44,3525,35,638,18/06/2021,"Chateau Margaux Premier Cru Classe, Margaux",Bordeaux,2007,23/06/2021,10127812007,1012781
857,15/06/2021,947,153,828,29,119,21/06/2021,"Tignanello, Toscana",Tuscany,2017,23/06/2021,10953912017,1095391
6750,02/06/2021,7637,44,6525,225,1112,23/05/2021,"Chateau Margaux Premier Cru Classe, Margaux",Bordeaux,2009,03/06/2021,10127812009,1012781
3300,28/07/2021,3538,9,3155,145,383,08/07/2021,"Chateau Angelus Premier Grand Cru Classe B, Saint-Emilion Grand Cru",Bordeaux,2003,29/07/2021,10060452003,1006045
12402,13/05/2021,12557,2,12850,-448,-293,30/11/2020,"Jacques-Frederic Mugnier, Chambolle-Musigny Premier Cru, Les Amoureuses",Burgundy,2011,14/05/2021,10496422011,1049642
3827,13/05/2021,4522,69,4116,-289,406,25/02/2021,"Chateau Margaux Premier Cru Classe, Margaux",Bordeaux,2004,14/05/2021,10127812004,1012781
990,02/06/2021,1113,22,1000,-10,113,12/04/2021,"Chateau Calon Segur 3eme Cru Classe, Saint-Estephe",Bordeaux,2010,03/06/2021,10074752010,1007475
1000,31/05/2021,1162,42,1030,-30,132,25/05/2021,"Chateau Calon Segur 3eme Cru Classe, Saint-Estephe",Bordeaux,2009,03/06/2021,10074752009,1007475
8000,13/05/2021,8606,8,6974,1026,1632,14/03/2021,"Domaine Leflaive, Chevalier-Montrachet Grand Cru",Burgundy,2017,14/05/2021,10734012017,1073401
3300,27/07/2021,3526,8,3155,145,371,08/07/2021,"Chateau Angelus Premier Grand Cru Classe B, Saint-Emilion Grand Cru",Bordeaux,2003,28/07/2021,10060452003,1006045
589,13/05/2021,623,53,450,139,173,04/05/2021,"Chateau Batailley 5eme Cru Classe, Pauillac",Bordeaux,2005,14/05/2021,10063222005,1006322
6300,13/05/2021,7468,55,5922,378,1546,13/04/2021,"Chateau Margaux Premier Cru Classe, Margaux",Bordeaux,2010,14/05/2021,10127812010,1012781
4386,02/06/2021,4841,22,4400,-14,441,29/09/2020,"Chateau Margaux Premier Cru Classe, Margaux",Bordeaux,2001,03/06/2021,10127812001,1012781
780,02/06/2021,842,12,682,98,160,15/09/2020,"Chateau Calon Segur 3eme Cru Classe, Saint-Estephe",Bordeaux,2013,03/06/2021,10074752013,1007475
3740,13/05/2021,3962,48,3520,220,442,07/04/2021,"Chateau Margaux Premier Cru Classe, Margaux",Bordeaux,2013,14/05/2021,10127812013,1012781
589,13/05/2021,623,53,450,139,173,04/05/2021,"Chateau Batailley 5eme Cru Classe, Pauillac",Bordeaux,2005,14/05/2021,10063222005,1006322
450,13/05/2021,450,1,340,110,110,31/08/2018,"Chateau Batailley 5eme Cru Classe, Pauillac",Bordeaux,2007,14/05/2021,10063222007,1006322
1408,13/05/2021,1442,5,1238,170,204,02/11/2020,"Tignanello, Toscana",Tuscany,2006,14/05/2021,10953912006,1095391
3300,27/07/2021,3526,8,3155,145,371,08/07/2021,"Chateau Angelus Premier Grand Cru Classe B, Saint-Emilion Grand Cru",Bordeaux,2003,28/07/2021,10060452003,1006045
1120,13/05/2021,1274,9,1172,-52,102,07/04/2021,"Tignanello, Toscana",Tuscany,2010,15/05/2021,10953912010,1095391
400,13/05/2021,443,9,332,68,111,06/10/2020,"Chateau Batailley 5eme Cru Classe, Pauillac",Bordeaux,2008,14/05/2021,10063222008,1006322
6250,31/05/2021,7287,55,6360,-110,927,24/05/2021,"Chateau Margaux Premier Cru Classe, Margaux",Bordeaux,2005,03/06/2021,10127812005,1012781
3300,23/07/2021,3526,8,3155,145,371,08/07/2021,"Chateau Angelus Premier Grand Cru Classe B, Saint-Emilion Grand Cru",Bordeaux,2003,24/07/2021,10060452003,1006045
490,13/05/2021,552,21,504,-14,48,06/04/2021,"Chateau Batailley 5eme Cru Classe, Pauillac",Bordeaux,2009,14/05/2021,10063222009,1006322
3300,23/07/2021,3526,8,3155,145,371,08/07/2021,"Chateau Angelus Premier Grand Cru Classe B, Saint-Emilion Grand Cru",Bordeaux,2003,24/07/2021,10060452003,1006045
3300,21/07/2021,3526,8,3155,145,371,08/07/2021,"Chateau Angelus Premier Grand Cru Classe B, Saint-Emilion Grand Cru",Bordeaux,2003,22/07/2021,10060452003,1006045
10446,31/05/2021,12585,60,9844,602,2741,29/03/2021,"Chateau Margaux Premier Cru Classe, Margaux",Bordeaux,2015,03/06/2021,10127812015,1012781
3720,02/06/2021,4213,86,3480,240,733,10/04/2021,"Chateau Margaux Premier Cru Classe, Margaux",Bordeaux,2014,03/06/2021,10127812014,1012781
490,13/05/2021,552,21,504,-14,48,06/04/2021,"Chateau Batailley 5eme Cru Classe, Pauillac",Bordeaux,2009,14/05/2021,10063222009,1006322
3900,02/06/2021,4508,29,3684,216,824,10/06/2020,"Chateau Margaux Premier Cru Classe, Margaux",Bordeaux,2002,03/06/2021,10127812002,1012781
6291,31/05/2021,7467,63,6190,101,1277,23/05/2021,"Chateau Margaux Premier Cru Classe, Margaux",Bordeaux,2010,03/06/2021,10127812010,1012781
3300,21/07/2021,3526,8,3155,145,371,08/07/2021,"Chateau Angelus Premier Grand Cru Classe B, Saint-Emilion Grand Cru",Bordeaux,2003,22/07/2021,10060452003,1006045
885,02/06/2021,939,19,781,104,158,16/11/2020,"Chateau Calon Segur 3eme Cru Classe, Saint-Estephe",Bordeaux,2008,03/06/2021,10074752008,1007475
3900,02/06/2021,4425,92,3800,100,625,12/05/2021,"Chateau Margaux Premier Cru Classe, Margaux",Bordeaux,2008,03/06/2021,10127812008,1012781
900,02/06/2021,1093,30,800,100,293,21/11/2019,"Chateau Calon Segur 3eme Cru Classe, Saint-Estephe",Bordeaux,2003,03/06/2021,10074752003,1007475
870,02/06/2021,945,10,705,165,240,01/02/2021,"Chateau Calon Segur 3eme Cru Classe, Saint-Estephe",Bordeaux,2002,03/06/2021,10074752002,1007475
1408,02/06/2021,1394,5,1238,170,156,02/11/2020,"Tignanello, Toscana",Tuscany,2006,03/06/2021,10953912006,1095391
3740,02/06/2021,3986,53,3520,220,466,07/04/2021,"Chateau Margaux Premier Cru Classe, Margaux",Bordeaux,2013,03/06/2021,10127812013,1012781
490,13/05/2021,593,407,494,-4,99,20/04/2021,"Chateau Batailley 5eme Cru Classe, Pauillac",Bordeaux,2010,18/05/2021,10063222010,1006322
3300,20/07/2021,3538,9,3155,145,383,08/07/2021,"Chateau Angelus Premier Grand Cru Classe B, Saint-Emilion Grand Cru",Bordeaux,2003,21/07/2021,10060452003,1006045
3300,20/07/2021,3538,9,3155,145,383,08/07/2021,"Chateau Angelus Premier Grand Cru Classe B, Saint-Emilion Grand Cru",Bordeaux,2003,21/07/2021,10060452003,1006045
850,02/06/2021,1093,89,860,-10,233,19/04/2021,"Chateau Calon Segur 3eme Cru Classe, Saint-Estephe",Bordeaux,2015,03/06/2021,10074752015,1007475
1000,02/06/2021,1154,98,988,12,166,28/05/2021,"Chateau Calon Segur 3eme Cru Classe, Saint-Estephe",Bordeaux,2005,03/06/2021,10074752005,1007475
975,05/07/2021,1230,49,1026,-51,204,24/06/2021,"Chateau Calon Segur 3eme Cru Classe, Saint-Estephe",Bordeaux,2009,06/07/2021,10074752009,1007475
490,13/05/2021,593,409,494,-4,99,20/04/2021,"Chateau Batailley 5eme Cru Classe, Pauillac",Bordeaux,2010,19/05/2021,10063222010,1006322
3300,19/07/2021,3533,9,3155,145,378,08/07/2021,"Chateau Angelus Premier Grand Cru Classe B, Saint-Emilion Grand Cru",Bordeaux,2003,20/07/2021,10060452003,1006045
3300,19/07/2021,3533,9,3155,145,378,08/07/2021,"Chateau Angelus Premier Grand Cru Classe B, Saint-Emilion Grand Cru",Bordeaux,2003,20/07/2021,10060452003,1006045
3850,14/05/2021,4165,41,3560,290,605,20/11/2020,"Chateau Margaux Premier Cru Classe, Margaux",Bordeaux,2012,16/05/2021,10127812012,1012781
3950,14/05/2021,4461,85,3800,150,661,12/05/2021,"Chateau Margaux Premier Cru Classe, Margaux",Bordeaux,2008,16/05/2021,10127812008,1012781
4400,14/05/2021,4883,27,4400,0,483,29/09/2020,"Chateau Margaux Premier Cru Classe, Margaux",Bordeaux,2001,16/05/2021,10127812001,1012781
490,13/05/2021,593,406,494,-4,99,20/04/2021,"Chateau Batailley 5eme Cru Classe, Pauillac",Bordeaux,2010,14/05/2021,10063222010,1006322
6250,14/05/2021,6929,39,6116,134,813,07/05/2021,"Chateau Margaux Premier Cru Classe, Margaux",Bordeaux,2005,16/05/2021,10127812005,1012781
4800,12/05/2021,5754,26,4800,0,954,11/03/2021,"Chateau Margaux Premier Cru Classe, Margaux",Bordeaux,2003,16/05/2021,10127812003,1012781
3860,10/05/2021,4811,74,3800,60,1011,07/04/2021,"Chateau Margaux Premier Cru Classe, Margaux",Bordeaux,2006,16/05/2021,10127812006,1012781
3758,13/05/2021,4389,122,3690,68,699,13/04/2021,"Chateau Margaux Premier Cru Classe, Margaux",Bordeaux,2011,16/05/2021,10127812011,1012781
3300,16/07/2021,3520,8,3155,145,365,08/07/2021,"Chateau Angelus Premier Grand Cru Classe B, Saint-Emilion Grand Cru",Bordeaux,2003,17/07/2021,10060452003,1006045
3300,16/07/2021,3520,8,3155,145,365,08/07/2021,"Chateau Angelus Premier Grand Cru Classe B, Saint-Emilion Grand Cru",Bordeaux,2003,17/07/2021,10060452003,1006045
3900,14/05/2021,4522,33,3684,216,838,10/06/2020,"Chateau Margaux Premier Cru Classe, Margaux",Bordeaux,2002,16/05/2021,10127812002,1012781
3827,14/05/2021,4531,67,4116,-289,415,25/02/2021,"Chateau Margaux Premier Cru Classe, Margaux",Bordeaux,2004,16/05/2021,10127812004,1012781
790,04/05/2021,964,16,745,45,219,16/11/2020,"Chateau Calon Segur 3eme Cru Classe, Saint-Estephe",Bordeaux,2004,16/05/2021,10074752004,1007475
6650,14/05/2021,7976,70,6500,150,1476,12/05/2021,"Chateau Margaux Premier Cru Classe, Margaux",Bordeaux,2009,16/05/2021,10127812009,1012781
6300,14/05/2021,7576,47,5922,378,1654,13/04/2021,"Chateau Margaux Premier Cru Classe, Margaux",Bordeaux,2010,16/05/2021,10127812010,1012781
3827,14/05/2021,4531,67,4116,-289,415,25/02/2021,"Chateau Margaux Premier Cru Classe, Margaux",Bordeaux,2004,16/05/2021,10127812004,1012781
3300,15/07/2021,3533,9,3155,145,378,08/07/2021,"Chateau Angelus Premier Grand Cru Classe B, Saint-Emilion Grand Cru",Bordeaux,2003,16/07/2021,10060452003,1006045
490,13/05/2021,593,407,494,-4,99,20/04/2021,"Chateau Batailley 5eme Cru Classe, Pauillac",Bordeaux,2010,18/05/2021,10063222010,1006322
3360,15/07/2021,3526,8,3155,205,371,08/07/2021,"Chateau Angelus Premier Grand Cru Classe B, Saint-Emilion Grand Cru",Bordeaux,2003,23/07/2021,10060452003,1006045
1850,05/07/2021,1831,1,1180,670,651,10/03/2017,"Gaja, Barbaresco",Piedmont,2005,06/07/2021,10996052005,1099605
2098,05/07/2021,2366,3,2190,-92,176,01/05/2021,"Gaja, Barbaresco",Piedmont,2004,06/07/2021,10996052004,1099605
1800,05/07/2021,1733,2,1300,500,433,30/05/2019,"Gaja, Barbaresco",Piedmont,2007,06/07/2021,10996052007,1099605
2500,05/07/2021,2632,3,2220,280,412,14/06/2021,"Gaja, Barbaresco",Piedmont,2001,06/07/2021,10996052001,1099605
1700,05/07/2021,1847,4,1378,322,469,29/07/2020,"Tignanello, Toscana",Tuscany,2001,06/07/2021,10953912001,1095391
520,05/07/2021,563,3,460,60,103,05/05/2020,"Tua Rita, Giusto di Notri, Toscana",Tuscany,2008,06/07/2021,11058072008,1105807
660,05/07/2021,727,5,390,270,337,18/08/2017,"Tua Rita, Giusto di Notri, Toscana",Tuscany,2006,06/07/2021,11058072006,1105807
1408,05/07/2021,1389,4,1238,170,151,02/11/2020,"Tignanello, Toscana",Tuscany,2006,06/07/2021,10953912006,1095391
6400,05/07/2021,7550,49,5950,450,1600,23/06/2021,"Chateau Margaux Premier Cru Classe, Margaux",Bordeaux,2010,06/07/2021,10127812010,1012781
3360,15/07/2021,3526,8,3155,205,371,08/07/2021,"Chateau Angelus Premier Grand Cru Classe B, Saint-Emilion Grand Cru",Bordeaux,2003,23/07/2021,10060452003,1006045
3900,06/07/2021,4291,82,3750,150,541,28/06/2021,"Chateau Margaux Premier Cru Classe, Margaux",Bordeaux,2008,07/07/2021,10127812008,1012781
900,21/05/2021,1188,16,850,50,338,28/01/2021,"Tignanello, Toscana",Tuscany,2012,22/05/2021,10953912012,1095391
790,18/05/2021,969,22,745,45,224,16/11/2020,"Chateau Calon Segur 3eme Cru Classe, Saint-Estephe",Bordeaux,2004,22/05/2021,10074752004,1007475
750,19/05/2021,1016,53,790,-40,226,01/06/2020,"Chateau Calon Segur 3eme Cru Classe, Saint-Estephe",Bordeaux,2011,22/05/2021,10074752011,1007475
1020,21/05/2021,1048,10,860,160,188,08/03/2021,"Tignanello, Toscana",Tuscany,2011,22/05/2021,10953912011,1095391
1408,20/05/2021,1405,4,1238,170,167,02/11/2020,"Tignanello, Toscana",Tuscany,2006,22/05/2021,10953912006,1095391
4400,21/05/2021,4861,28,4400,0,461,29/09/2020,"Chateau Margaux Premier Cru Classe, Margaux",Bordeaux,2001,22/05/2021,10127812001,1012781
3300,15/07/2021,3533,9,3155,145,378,08/07/2021,"Chateau Angelus Premier Grand Cru Classe B, Saint-Emilion Grand Cru",Bordeaux,2003,16/07/2021,10060452003,1006045
6250,20/05/2021,7005,42,6300,-50,705,21/05/2021,"Chateau Margaux Premier Cru Classe, Margaux",Bordeaux,2005,22/05/2021,10127812005,1012781
3850,21/05/2021,4177,44,3560,290,617,20/11/2020,"Chateau Margaux Premier Cru Classe, Margaux",Bordeaux,2012,22/05/2021,10127812012,1012781
1000,21/05/2021,1162,86,975,25,187,12/04/2021,"Chateau Calon Segur 3eme Cru Classe, Saint-Estephe",Bordeaux,2005,22/05/2021,10074752005,1007475
840,21/05/2021,938,18,781,59,157,16/11/2020,"Chateau Calon Segur 3eme Cru Classe, Saint-Estephe",Bordeaux,2008,22/05/2021,10074752008,1007475
1678,20/05/2021,1661,4,1180,498,481,25/06/2020,"Tignanello, Toscana",Tuscany,2004,22/05/2021,10953912004,1095391
1280,21/05/2021,1353,8,1172,108,181,07/04/2021,"Tignanello, Toscana",Tuscany,2010,22/05/2021,10953912010,1095391
6300,21/05/2021,7485,60,5922,378,1563,13/04/2021,"Chateau Margaux Premier Cru Classe, Margaux",Bordeaux,2010,22/05/2021,10127812010,1012781
3560,19/05/2021,4110,29,3592,-32,518,06/05/2021,"Chateau Margaux Premier Cru Classe, Margaux",Bordeaux,2007,22/05/2021,10127812007,1012781
3300,14/07/2021,3537,9,3155,145,382,08/07/2021,"Chateau Angelus Premier Grand Cru Classe B, Saint-Emilion Grand Cru",Bordeaux,2003,15/07/2021,10060452003,1006045
790,20/05/2021,933,38,794,-4,139,20/04/2021,"Chateau Calon Segur 3eme Cru Classe, Saint-Estephe",Bordeaux,2014,22/05/2021,10074752014,1007475
3300,14/07/2021,3537,9,3155,145,382,08/07/2021,"Chateau Angelus Premier Grand Cru Classe B, Saint-Emilion Grand Cru",Bordeaux,2003,15/07/2021,10060452003,1006045
3758,21/05/2021,4037,83,3690,68,347,13/04/2021,"Chateau Margaux Premier Cru Classe, Margaux",Bordeaux,2011,22/05/2021,10127812011,1012781
3827,21/05/2021,4485,64,4116,-289,369,25/02/2021,"Chateau Margaux Premier Cru Classe, Margaux",Bordeaux,2004,22/05/2021,10127812004,1012781
1000,21/05/2021,1168,47,1047,-47,121,27/04/2021,"Chateau Calon Segur 3eme Cru Classe, Saint-Estephe",Bordeaux,2009,22/05/2021,10074752009,1007475
1408,20/05/2021,1446,2,1150,258,296,21/04/2019,"Tignanello, Toscana",Tuscany,2005,22/05/2021,10953912005,1095391
490,13/05/2021,594,409,494,-4,100,20/04/2021,"Chateau Batailley 5eme Cru Classe, Pauillac",Bordeaux,2010,20/05/2021,10063222010,1006322
990,05/07/2021,1134,16,990,0,144,16/06/2021,"Chateau Calon Segur 3eme Cru Classe, Saint-Estephe",Bordeaux,2010,06/07/2021,10074752010,1007475
6650,20/05/2021,7645,42,6980,-330,665,21/05/2021,"Chateau Margaux Premier Cru Classe, Margaux",Bordeaux,2009,22/05/2021,10127812009,1012781
907,21/05/2021,1051,39,805,102,246,20/11/2019,"Chateau Calon Segur 3eme Cru Classe, Saint-Estephe",Bordeaux,2001,22/05/2021,10074752001,1007475
490,13/05/2021,593,409,494,-4,99,20/04/2021,"Chateau Batailley 5eme Cru Classe, Pauillac",Bordeaux,2010,19/05/2021,10063222010,1006322
10500,21/05/2021,12480,71,9844,656,2636,29/03/2021,"Chateau Margaux Premier Cru Classe, Margaux",Bordeaux,2015,22/05/2021,10127812015,1012781
995,21/05/2021,1124,23,1000,-5,124,12/04/2021,"Chateau Calon Segur 3eme Cru Classe, Saint-Estephe",Bordeaux,2010,22/05/2021,10074752010,1007475
3740,21/05/2021,3969,50,3520,220,449,07/04/2021,"Chateau Margaux Premier Cru Classe, Margaux",Bordeaux,2013,22/05/2021,10127812013,1012781
1280,21/05/2021,1328,6,1200,80,128,06/03/2021,"Tignanello, Toscana",Tuscany,2007,22/05/2021,10953912007,1095391
3300,13/07/2021,3525,8,3155,145,370,08/07/2021,"Chateau Angelus Premier Grand Cru Classe B, Saint-Emilion Grand Cru",Bordeaux,2003,14/07/2021,10060452003,1006045
3300,13/07/2021,3525,8,3155,145,370,08/07/2021,"Chateau Angelus Premier Grand Cru Classe B, Saint-Emilion Grand Cru",Bordeaux,2003,14/07/2021,10060452003,1006045
3720,21/05/2021,4099,53,3480,240,619,10/04/2021,"Chateau Margaux Premier Cru Classe, Margaux",Bordeaux,2014,22/05/2021,10127812014,1012781
950,21/05/2021,1003,61,863,87,140,10/05/2021,"Chateau Calon Segur 3eme Cru Classe, Saint-Estephe",Bordeaux,2006,22/05/2021,10074752006,1007475
490,13/05/2021,593,406,494,-4,99,20/04/2021,"Chateau Batailley 5eme Cru Classe, Pauillac",Bordeaux,2010,14/05/2021,10063222010,1006322
3300,12/07/2021,3525,8,3155,145,370,08/07/2021,"Chateau Angelus Premier Grand Cru Classe B, Saint-Emilion Grand Cru",Bordeaux,2003,13/07/2021,10060452003,1006045
6830,03/06/2021,7627,40,6525,305,1102,23/05/2021,"Chateau Margaux Premier Cru Classe, Margaux",Bordeaux,2009,06/06/2021,10127812009,1012781
880,21/05/2021,986,13,725,155,261,13/04/2021,"Chateau Calon Segur 3eme Cru Classe, Saint-Estephe",Bordeaux,2007,22/05/2021,10074752007,1007475
490,13/05/2021,594,409,494,-4,100,20/04/2021,"Chateau Batailley 5eme Cru Classe, Pauillac",Bordeaux,2010,20/05/2021,10063222010,1006322
3300,12/07/2021,3525,8,3155,145,370,08/07/2021,"Chateau Angelus Premier Grand Cru Classe B, Saint-Emilion Grand Cru",Bordeaux,2003,13/07/2021,10060452003,1006045
3900,19/05/2021,4518,30,3684,216,834,10/06/2020,"Chateau Margaux Premier Cru Classe, Margaux",Bordeaux,2002,22/05/2021,10127812002,1012781
3300,09/07/2021,3506,10,3155,145,351,08/07/2021,"Chateau Angelus Premier Grand Cru Classe B, Saint-Emilion Grand Cru",Bordeaux,2003,11/07/2021,10060452003,1006045
768,21/05/2021,926,13,705,63,221,01/02/2021,"Chateau Calon Segur 3eme Cru Classe, Saint-Estephe",Bordeaux,2002,22/05/2021,10074752002,1007475
1700,20/05/2021,1653,3,1378,322,275,29/07/2020,"Tignanello, Toscana",Tuscany,2001,22/05/2021,10953912001,1095391
3860,19/05/2021,4720,77,3800,60,920,07/04/2021,"Chateau Margaux Premier Cru Classe, Margaux",Bordeaux,2006,22/05/2021,10127812006,1012781
1299,27/05/2021,1494,7,1010,289,484,18/12/2020,"Tignanello, Toscana",Tuscany,2008,06/06/2021,10953912008,1095391
3826,04/06/2021,4533,56,4116,-290,417,25/02/2021,"Chateau Margaux Premier Cru Classe, Margaux",Bordeaux,2004,06/06/2021,10127812004,1012781
8040,21/05/2021,8385,22,7950,90,435,12/03/2021,"Chateau Margaux Premier Cru Classe, Margaux",Bordeaux,2000,22/05/2021,10127812000,1012781
1244,20/05/2021,1523,3,882,362,641,26/04/2019,"Tignanello, Toscana",Tuscany,2003,22/05/2021,10953912003,1095391
2232,21/05/2021,2343,5,2190,42,153,01/05/2021,"Gaja, Barbaresco",Piedmont,2004,22/05/2021,10996052004,1099605
1176,21/05/2021,1330,1,996,180,334,14/06/2019,"Tignanello, Toscana",Tuscany,2000,22/05/2021,10953912000,1095391
1408,27/05/2021,1368,1,1150,258,218,21/04/2019,"Tignanello, Toscana",Tuscany,2005,06/06/2021,10953912005,1095391
10500,02/06/2021,12169,50,9844,656,2325,29/03/2021,"Chateau Margaux Premier Cru Classe, Margaux",Bordeaux,2015,07/06/2021,10127812015,1012781
1100,21/05/2021,1513,7,1010,90,503,18/12/2020,"Tignanello, Toscana",Tuscany,2008,22/05/2021,10953912008,1095391
400,13/05/2021,468,6,300,100,168,05/11/2020,"Chateau Batailley 5eme Cru Classe, Pauillac",Bordeaux,2011,14/05/2021,10063222011,1006322
1024,19/05/2021,1178,11,1072,-48,106,20/01/2021,"Tignanello, Toscana",Tuscany,2009,22/05/2021,10953912009,1095391
3300,09/07/2021,3503,10,3155,145,348,08/07/2021,"Chateau Angelus Premier Grand Cru Classe B, Saint-Emilion Grand Cru",Bordeaux,2003,10/07/2021,10060452003,1006045
3300,09/07/2021,3503,10,3155,145,348,08/07/2021,"Chateau Angelus Premier Grand Cru Classe B, Saint-Emilion Grand Cru",Bordeaux,2003,10/07/2021,10060452003,1006045
1050,20/05/2021,1137,7,860,190,277,08/03/2021,"Tignanello, Toscana",Tuscany,2013,22/05/2021,10953912013,1095391
3920,21/05/2021,4436,94,3800,120,636,12/05/2021,"Chateau Margaux Premier Cru Classe, Margaux",Bordeaux,2008,22/05/2021,10127812008,1012781
2500,07/07/2021,2632,3,2220,280,412,14/06/2021,"Gaja, Barbaresco",Piedmont,2001,08/07/2021,10996052001,1099605
2098,07/07/2021,2366,3,2190,-92,176,01/05/2021,"Gaja, Barbaresco",Piedmont,2004,08/07/2021,10996052004,1099605
1700,07/07/2021,1847,4,1378,322,469,29/07/2020,"Tignanello, Toscana",Tuscany,2001,08/07/2021,10953912001,1095391
1408,07/07/2021,1389,4,1238,170,151,02/11/2020,"Tignanello, Toscana",Tuscany,2006,08/07/2021,10953912006,1095391
6400,07/07/2021,7562,52,5950,450,1612,23/06/2021,"Chateau Margaux Premier Cru Classe, Margaux",Bordeaux,2010,08/07/2021,10127812010,1012781
400,13/05/2021,468,6,300,100,168,05/11/2020,"Chateau Batailley 5eme Cru Classe, Pauillac",Bordeaux,2011,14/05/2021,10063222011,1006322
990,07/07/2021,1134,16,990,0,144,16/06/2021,"Chateau Calon Segur 3eme Cru Classe, Saint-Estephe",Bordeaux,2010,08/07/2021,10074752010,1007475
4850,20/05/2021,5873,26,4842,8,1031,19/05/2021,"Chateau Margaux Premier Cru Classe, Margaux",Bordeaux,2003,22/05/2021,10127812003,1012781
9600,19/05/2021,9884,2,8000,1600,1884,30/01/2020,"Domaine Leflaive, Chevalier-Montrachet Grand Cru",Burgundy,2014,22/05/2021,10734012014,1073401
6650,20/05/2021,7643,42,6980,-330,663,21/05/2021,"Chateau Margaux Premier Cru Classe, Margaux",Bordeaux,2009,23/05/2021,10127812009,1012781
8040,21/05/2021,8398,21,7950,90,448,12/03/2021,"Chateau Margaux Premier Cru Classe, Margaux",Bordeaux,2000,23/05/2021,10127812000,1012781
3300,09/07/2021,3506,10,3155,145,351,08/07/2021,"Chateau Angelus Premier Grand Cru Classe B, Saint-Emilion Grand Cru",Bordeaux,2003,11/07/2021,10060452003,1006045
3758,21/05/2021,4045,80,3690,68,355,13/04/2021,"Chateau Margaux Premier Cru Classe, Margaux",Bordeaux,2011,23/05/2021,10127812011,1012781
6300,21/05/2021,7510,59,5922,378,1588,13/04/2021,"Chateau Margaux Premier Cru Classe, Margaux",Bordeaux,2010,23/05/2021,10127812010,1012781
6250,20/05/2021,7017,41,6300,-50,717,21/05/2021,"Chateau Margaux Premier Cru Classe, Margaux",Bordeaux,2005,23/05/2021,10127812005,1012781
995,21/05/2021,1126,22,1000,-5,126,12/04/2021,"Chateau Calon Segur 3eme Cru Classe, Saint-Estephe",Bordeaux,2010,23/05/2021,10074752010,1007475
8240,09/06/2021,8933,1,5960,2280,2973,01/08/2017,"Domaine Leflaive, Chevalier-Montrachet Grand Cru",Burgundy,2010,10/06/2021,10734012010,1073401
6300,09/06/2021,7458,64,6190,110,1268,23/05/2021,"Chateau Margaux Premier Cru Classe, Margaux",Bordeaux,2010,10/06/2021,10127812010,1012781
1550,09/06/2021,1557,1,1300,250,257,27/04/2021,"Gaja, Barbaresco",Piedmont,2012,10/06/2021,10996052012,1099605
1000,09/06/2021,1157,98,988,12,169,28/05/2021,"Chateau Calon Segur 3eme Cru Classe, Saint-Estephe",Bordeaux,2005,10/06/2021,10074752005,1007475
3900,09/06/2021,4472,28,3684,216,788,10/06/2020,"Chateau Margaux Premier Cru Classe, Margaux",Bordeaux,2002,10/06/2021,10127812002,1012781
3300,08/07/2021,3515,11,3155,145,360,08/07/2021,"Chateau Angelus Premier Grand Cru Classe B, Saint-Emilion Grand Cru",Bordeaux,2003,09/07/2021,10060452003,1006045
6557,09/06/2021,6557,0,3920,2637,2637,26/04/2017,"Domaine Leflaive, Chevalier-Montrachet Grand Cru",Burgundy,2006,10/06/2021,10734012006,1073401
1408,09/06/2021,1386,5,1238,170,148,02/11/2020,"Tignanello, Toscana",Tuscany,2006,10/06/2021,10953912006,1095391
520,09/06/2021,557,4,460,60,97,05/05/2020,"Tua Rita, Giusto di Notri, Toscana",Tuscany,2008,10/06/2021,11058072008,1105807
400,13/05/2021,463,9,355,45,108,15/04/2021,"Chateau Batailley 5eme Cru Classe, Pauillac",Bordeaux,2012,14/05/2021,10063222012,1006322
1080,09/06/2021,1161,58,1036,44,125,27/05/2021,"Chateau Calon Segur 3eme Cru Classe, Saint-Estephe",Bordeaux,2016,10/06/2021,10074752016,1007475
686,09/06/2021,828,13,682,4,146,15/09/2020,"Chateau Calon Segur 3eme Cru Classe, Saint-Estephe",Bordeaux,2013,10/06/2021,10074752013,1007475
400,13/05/2021,463,9,355,45,108,15/04/2021,"Chateau Batailley 5eme Cru Classe, Pauillac",Bordeaux,2012,14/05/2021,10063222012,1006322
860,09/06/2021,1025,69,916,-56,109,04/06/2021,"Tignanello, Toscana",Tuscany,2018,10/06/2021,10953912018,1095391
300,13/05/2021,301,110,304,-4,-3,10/01/2021,"Chateau Batailley 5eme Cru Classe, Pauillac",Bordeaux,2013,14/05/2021,10063222013,1006322
3300,08/07/2021,3515,11,3155,145,360,08/07/2021,"Chateau Angelus Premier Grand Cru Classe B, Saint-Emilion Grand Cru",Bordeaux,2003,09/07/2021,10060452003,1006045
350,13/05/2021,370,95,324,26,46,20/04/2021,"Chateau Batailley 5eme Cru Classe, Pauillac",Bordeaux,2014,14/05/2021,10063222014,1006322
350,13/05/2021,370,93,324,26,46,20/04/2021,"Chateau Batailley 5eme Cru Classe, Pauillac",Bordeaux,2014,22/05/2021,10063222014,1006322
5490,09/06/2021,5817,107,5254,236,563,26/05/2021,"Chateau Margaux Premier Cru Classe, Margaux",Bordeaux,2018,10/06/2021,10127812018,1012781
3900,09/06/2021,4613,95,3861,39,752,28/05/2021,"Chateau Margaux Premier Cru Classe, Margaux",Bordeaux,2006,10/06/2021,10127812006,1012781
750,09/06/2021,1007,50,790,-40,217,01/06/2020,"Chateau Calon Segur 3eme Cru Classe, Saint-Estephe",Bordeaux,2011,10/06/2021,10074752011,1007475
8100,09/06/2021,8471,19,7950,150,521,12/03/2021,"Chateau Margaux Premier Cru Classe, Margaux",Bordeaux,2000,10/06/2021,10127812000,1012781
3300,07/07/2021,3515,11,3180,120,335,05/03/2021,"Chateau Angelus Premier Grand Cru Classe B, Saint-Emilion Grand Cru",Bordeaux,2003,08/07/2021,10060452003,1006045
1299,08/06/2021,1489,7,1010,289,479,18/12/2020,"Tignanello, Toscana",Tuscany,2008,10/06/2021,10953912008,1095391
5000,09/06/2021,5058,6,4160,840,898,19/03/2021,"Chateau Margaux Premier Cru Classe, Margaux",Bordeaux,2019,10/06/2021,10127812019,1012781
840,09/06/2021,1086,27,842,-2,244,22/08/2020,"Chateau Calon Segur 3eme Cru Classe, Saint-Estephe",Bordeaux,2019,10/06/2021,10074752019,1007475
3300,07/07/2021,3515,11,3180,120,335,05/03/2021,"Chateau Angelus Premier Grand Cru Classe B, Saint-Emilion Grand Cru",Bordeaux,2003,08/07/2021,10060452003,1006045
2500,09/06/2021,3334,3,1200,1300,2134,16/05/2012,"Gaja, Barbaresco",Piedmont,2001,10/06/2021,10996052001,1099605
1000,09/06/2021,1169,44,1030,-30,139,25/05/2021,"Chateau Calon Segur 3eme Cru Classe, Saint-Estephe",Bordeaux,2009,10/06/2021,10074752009,1007475
3300,06/07/2021,3515,11,3180,120,335,05/03/2021,"Chateau Angelus Premier Grand Cru Classe B, Saint-Emilion Grand Cru",Bordeaux,2003,07/07/2021,10060452003,1006045
1150,03/06/2021,1226,10,1202,-52,24,10/05/2021,"Tignanello, Toscana",Tuscany,2015,10/06/2021,10953912015,1095391
990,09/06/2021,1110,21,1000,-10,110,12/04/2021,"Chateau Calon Segur 3eme Cru Classe, Saint-Estephe",Bordeaux,2010,10/06/2021,10074752010,1007475
3826,09/06/2021,4526,58,4116,-290,410,25/02/2021,"Chateau Margaux Premier Cru Classe, Margaux",Bordeaux,2004,10/06/2021,10127812004,1012781
6250,04/06/2021,7437,49,6360,-110,1077,24/05/2021,"Chateau Margaux Premier Cru Classe, Margaux",Bordeaux,2005,10/06/2021,10127812005,1012781
1028,08/06/2021,1057,8,860,168,197,08/03/2021,"Tignanello, Toscana",Tuscany,2011,10/06/2021,10953912011,1095391
3740,09/06/2021,3976,53,3520,220,456,07/04/2021,"Chateau Margaux Premier Cru Classe, Margaux",Bordeaux,2013,10/06/2021,10127812013,1012781
10500,09/06/2021,11988,53,9844,656,2144,29/03/2021,"Chateau Margaux Premier Cru Classe, Margaux",Bordeaux,2015,10/06/2021,10127812015,1012781
408,13/05/2021,414,20,357,51,57,06/05/2021,"Chateau Batailley 5eme Cru Classe, Pauillac",Bordeaux,2018,14/05/2021,10063222018,1006322
660,09/06/2021,724,4,390,270,334,18/08/2017,"Tua Rita, Giusto di Notri, Toscana",Tuscany,2006,10/06/2021,11058072006,1105807
6830,09/06/2021,7662,50,6525,305,1137,23/05/2021,"Chateau Margaux Premier Cru Classe, Margaux",Bordeaux,2009,10/06/2021,10127812009,1012781
3560,09/06/2021,4098,34,3592,-32,506,06/05/2021,"Chateau Margaux Premier Cru Classe, Margaux",Bordeaux,2007,10/06/2021,10127812007,1012781
3300,06/07/2021,3515,11,3180,120,335,05/03/2021,"Chateau Angelus Premier Grand Cru Classe B, Saint-Emilion Grand Cru",Bordeaux,2003,07/07/2021,10060452003,1006045
1300,27/05/2021,1368,7,1172,128,196,07/04/2021,"Tignanello, Toscana",Tuscany,2010,10/06/2021,10953912010,1095391
3300,05/07/2021,3515,11,3180,120,335,05/03/2021,"Chateau Angelus Premier Grand Cru Classe B, Saint-Emilion Grand Cru",Bordeaux,2003,06/07/2021,10060452003,1006045
15600,09/06/2021,15094,6,13000,2600,2094,29/04/2021,"Jacques-Frederic Mugnier, Chambolle-Musigny Premier Cru, Les Amoureuses",Burgundy,2017,10/06/2021,10496422017,1049642
1800,09/06/2021,1815,3,1300,500,515,30/05/2019,"Gaja, Barbaresco",Piedmont,2007,10/06/2021,10996052007,1099605
3300,05/07/2021,3515,11,3180,120,335,05/03/2021,"Chateau Angelus Premier Grand Cru Classe B, Saint-Emilion Grand Cru",Bordeaux,2003,06/07/2021,10060452003,1006045
3900,09/06/2021,4431,108,3700,200,731,07/06/2021,"Chateau Margaux Premier Cru Classe, Margaux",Bordeaux,2008,10/06/2021,10127812008,1012781
900,09/06/2021,1090,29,800,100,290,21/11/2019,"Chateau Calon Segur 3eme Cru Classe, Saint-Estephe",Bordeaux,2003,10/06/2021,10074752003,1007475
450,14/05/2021,450,1,340,110,110,31/08/2018,"Chateau Batailley 5eme Cru Classe, Pauillac",Bordeaux,2007,15/05/2021,10063222007,1006322
828,09/06/2021,937,166,800,28,137,05/06/2021,"Tignanello, Toscana",Tuscany,2017,10/06/2021,10953912017,1095391
3300,02/07/2021,3503,10,3180,120,323,05/03/2021,"Chateau Angelus Premier Grand Cru Classe B, Saint-Emilion Grand Cru",Bordeaux,2003,04/07/2021,10060452003,1006045
3300,02/07/2021,3517,10,3180,120,337,05/03/2021,"Chateau Angelus Premier Grand Cru Classe B, Saint-Emilion Grand Cru",Bordeaux,2003,03/07/2021,10060452003,1006045
870,09/06/2021,948,10,705,165,243,01/02/2021,"Chateau Calon Segur 3eme Cru Classe, Saint-Estephe",Bordeaux,2002,10/06/2021,10074752002,1007475
1024,09/06/2021,1203,9,1072,-48,131,20/01/2021,"Tignanello, Toscana",Tuscany,2009,10/06/2021,10953912009,1095391
4400,20/05/2021,4860,27,4400,0,460,29/09/2020,"Chateau Margaux Premier Cru Classe, Margaux",Bordeaux,2001,21/05/2021,10127812001,1012781
1280,20/05/2021,1338,6,1200,80,138,06/03/2021,"Tignanello, Toscana",Tuscany,2007,21/05/2021,10953912007,1095391
2199,09/06/2021,2219,2,1340,859,879,13/03/2020,"Gaja, Barbaresco",Piedmont,2009,10/06/2021,10996052009,1099605
4386,02/06/2021,4703,28,4400,-14,303,29/09/2020,"Chateau Margaux Premier Cru Classe, Margaux",Bordeaux,2001,10/06/2021,10127812001,1012781
400,14/05/2021,443,9,332,68,111,06/10/2020,"Chateau Batailley 5eme Cru Classe, Pauillac",Bordeaux,2008,15/05/2021,10063222008,1006322
860,09/06/2021,1026,69,916,-56,110,12/06/2021,"Tignanello, Toscana",Tuscany,2018,13/06/2021,10953912018,1095391
4850,11/06/2021,5623,31,4842,8,781,19/05/2021,"Chateau Margaux Premier Cru Classe, Margaux",Bordeaux,2003,13/06/2021,10127812003,1012781
490,14/05/2021,552,21,504,-14,48,06/04/2021,"Chateau Batailley 5eme Cru Classe, Pauillac",Bordeaux,2009,15/05/2021,10063222009,1006322
880,03/06/2021,964,12,781,99,183,16/11/2020,"Chateau Calon Segur 3eme Cru Classe, Saint-Estephe",Bordeaux,2008,13/06/2021,10074752008,1007475
490,14/05/2021,552,21,504,-14,48,06/04/2021,"Chateau Batailley 5eme Cru Classe, Pauillac",Bordeaux,2009,15/05/2021,10063222009,1006322
880,03/06/2021,964,12,781,99,183,16/11/2020,"Chateau Calon Segur 3eme Cru Classe, Saint-Estephe",Bordeaux,2008,13/06/2021,10074752008,1007475
686,11/06/2021,838,12,682,4,156,15/09/2020,"Chateau Calon Segur 3eme Cru Classe, Saint-Estephe",Bordeaux,2013,13/06/2021,10074752013,1007475
400,14/05/2021,463,9,355,45,108,15/04/2021,"Chateau Batailley 5eme Cru Classe, Pauillac",Bordeaux,2012,15/05/2021,10063222012,1006322
1050,18/05/2021,1205,21,940,110,265,18/03/2021,"Chateau Calon Segur 3eme Cru Classe, Saint-Estephe",Bordeaux,2000,21/05/2021,10074752000,1007475
1050,20/05/2021,1213,12,860,190,353,08/03/2021,"Tignanello, Toscana",Tuscany,2013,21/05/2021,10953912013,1095391
3850,20/05/2021,4179,43,3560,290,619,20/11/2020,"Chateau Margaux Premier Cru Classe, Margaux",Bordeaux,2012,21/05/2021,10127812012,1012781
5800,09/06/2021,5852,1,4400,1400,1452,06/11/2017,"Domaine Leflaive, Chevalier-Montrachet Grand Cru",Burgundy,2013,10/06/2021,10734012013,1073401
1700,09/06/2021,1658,4,1378,322,280,29/07/2020,"Tignanello, Toscana",Tuscany,2001,10/06/2021,10953912001,1095391
540,09/06/2021,533,3,300,240,233,03/11/2011,"Tua Rita, Giusto di Notri, Toscana",Tuscany,2007,10/06/2021,11058072007,1105807
1408,20/05/2021,1445,5,1238,170,207,02/11/2020,"Tignanello, Toscana",Tuscany,2006,21/05/2021,10953912006,1095391
3300,02/07/2021,3517,10,3180,120,337,05/03/2021,"Chateau Angelus Premier Grand Cru Classe B, Saint-Emilion Grand Cru",Bordeaux,2003,03/07/2021,10060452003,1006045
1280,20/05/2021,1355,8,1172,108,183,07/04/2021,"Tignanello, Toscana",Tuscany,2010,21/05/2021,10953912010,1095391
1390,09/06/2021,1420,10,1276,114,144,05/03/2021,"Gaja, Barbaresco",Piedmont,2013,10/06/2021,10996052013,1099605
3720,20/05/2021,4102,51,3480,240,622,10/04/2021,"Chateau Margaux Premier Cru Classe, Margaux",Bordeaux,2014,21/05/2021,10127812014,1012781
3758,20/05/2021,4033,79,3690,68,343,13/04/2021,"Chateau Margaux Premier Cru Classe, Margaux",Bordeaux,2011,21/05/2021,10127812011,1012781
3300,02/07/2021,3503,10,3180,120,323,05/03/2021,"Chateau Angelus Premier Grand Cru Classe B, Saint-Emilion Grand Cru",Bordeaux,2003,04/07/2021,10060452003,1006045
790,20/05/2021,929,41,794,-4,135,20/04/2021,"Chateau Calon Segur 3eme Cru Classe, Saint-Estephe",Bordeaux,2014,21/05/2021,10074752014,1007475
1000,20/05/2021,1168,47,1047,-47,121,27/04/2021,"Chateau Calon Segur 3eme Cru Classe, Saint-Estephe",Bordeaux,2009,21/05/2021,10074752009,1007475
3860,19/05/2021,4747,73,3800,60,947,07/04/2021,"Chateau Margaux Premier Cru Classe, Margaux",Bordeaux,2006,21/05/2021,10127812006,1012781
1100,20/05/2021,1531,7,1010,90,521,18/12/2020,"Tignanello, Toscana",Tuscany,2008,21/05/2021,10953912008,1095391
2232,20/05/2021,2335,5,2190,42,145,01/05/2021,"Gaja, Barbaresco",Piedmont,2004,21/05/2021,10996052004,1099605
3300,01/07/2021,3520,11,3180,120,340,05/03/2021,"Chateau Angelus Premier Grand Cru Classe B, Saint-Emilion Grand Cru",Bordeaux,2003,02/07/2021,10060452003,1006045
1024,19/05/2021,1182,11,1072,-48,110,20/01/2021,"Tignanello, Toscana",Tuscany,2009,21/05/2021,10953912009,1095391
1020,20/05/2021,1048,10,860,160,188,08/03/2021,"Tignanello, Toscana",Tuscany,2011,21/05/2021,10953912011,1095391
4850,20/05/2021,5849,27,4842,8,1007,19/05/2021,"Chateau Margaux Premier Cru Classe, Margaux",Bordeaux,2003,21/05/2021,10127812003,1012781
6250,20/05/2021,7004,40,6116,134,888,07/05/2021,"Chateau Margaux Premier Cru Classe, Margaux",Bordeaux,2005,21/05/2021,10127812005,1012781
6650,20/05/2021,7645,42,6500,150,1145,12/05/2021,"Chateau Margaux Premier Cru Classe, Margaux",Bordeaux,2009,21/05/2021,10127812009,1012781
3300,01/07/2021,3520,11,3180,120,340,05/03/2021,"Chateau Angelus Premier Grand Cru Classe B, Saint-Emilion Grand Cru",Bordeaux,2003,02/07/2021,10060452003,1006045
3300,30/06/2021,3520,11,3180,120,340,05/03/2021,"Chateau Angelus Premier Grand Cru Classe B, Saint-Emilion Grand Cru",Bordeaux,2003,01/07/2021,10060452003,1006045
8040,20/05/2021,8372,22,7950,90,422,12/03/2021,"Chateau Margaux Premier Cru Classe, Margaux",Bordeaux,2000,21/05/2021,10127812000,1012781
400,14/05/2021,463,9,355,45,108,15/04/2021,"Chateau Batailley 5eme Cru Classe, Pauillac",Bordeaux,2012,15/05/2021,10063222012,1006322
7527,28/06/2021,9867,3,7290,237,2577,21/08/2020,"Domaine Denis Mortet, Chambertin Grand Cru",Burgundy,2017,30/06/2021,10490202017,1049020
1408,20/05/2021,1518,1,1150,258,368,21/04/2019,"Tignanello, Toscana",Tuscany,2005,21/05/2021,10953912005,1095391
995,20/05/2021,1124,23,1000,-5,124,12/04/2021,"Chateau Calon Segur 3eme Cru Classe, Saint-Estephe",Bordeaux,2010,21/05/2021,10074752010,1007475
907,19/05/2021,1051,39,805,102,246,20/11/2019,"Chateau Calon Segur 3eme Cru Classe, Saint-Estephe",Bordeaux,2001,21/05/2021,10074752001,1007475
880,20/05/2021,986,13,725,155,261,13/04/2021,"Chateau Calon Segur 3eme Cru Classe, Saint-Estephe",Bordeaux,2007,21/05/2021,10074752007,1007475
840,18/05/2021,1082,97,860,-20,222,19/04/2021,"Chateau Calon Segur 3eme Cru Classe, Saint-Estephe",Bordeaux,2015,21/05/2021,10074752015,1007475
3560,19/05/2021,4107,30,3592,-32,515,06/05/2021,"Chateau Margaux Premier Cru Classe, Margaux",Bordeaux,2007,21/05/2021,10127812007,1012781
3300,30/06/2021,3520,11,3180,120,340,05/03/2021,"Chateau Angelus Premier Grand Cru Classe B, Saint-Emilion Grand Cru",Bordeaux,2003,01/07/2021,10060452003,1006045
1850,01/07/2021,1831,1,1180,670,651,10/03/2017,"Gaja, Barbaresco",Piedmont,2005,02/07/2021,10996052005,1099605
2500,01/07/2021,2636,2,2220,280,416,14/06/2021,"Gaja, Barbaresco",Piedmont,2001,02/07/2021,10996052001,1099605
2098,30/06/2021,2366,3,2190,-92,176,01/05/2021,"Gaja, Barbaresco",Piedmont,2004,02/07/2021,10996052004,1099605
1800,30/06/2021,1733,2,1300,500,433,30/05/2019,"Gaja, Barbaresco",Piedmont,2007,02/07/2021,10996052007,1099605
2437,01/07/2021,2311,1,1768,669,543,22/05/2020,"Gaja, Barbaresco",Piedmont,2000,02/07/2021,10996052000,1099605
574,01/07/2021,574,1,351,223,223,25/07/2016,"Tua Rita, Giusto di Notri, Toscana",Tuscany,2004,02/07/2021,11058072004,1105807
520,01/07/2021,563,3,460,60,103,05/05/2020,"Tua Rita, Giusto di Notri, Toscana",Tuscany,2008,02/07/2021,11058072008,1105807
1299,29/06/2021,1626,6,1010,289,616,18/12/2020,"Tignanello, Toscana",Tuscany,2008,02/07/2021,10953912008,1095391
6400,01/07/2021,7576,51,5950,450,1626,23/06/2021,"Chateau Margaux Premier Cru Classe, Margaux",Bordeaux,2010,02/07/2021,10127812010,1012781
990,01/07/2021,1134,16,990,0,144,16/06/2021,"Chateau Calon Segur 3eme Cru Classe, Saint-Estephe",Bordeaux,2010,02/07/2021,10074752010,1007475
300,14/05/2021,301,110,304,-4,-3,10/01/2021,"Chateau Batailley 5eme Cru Classe, Pauillac",Bordeaux,2013,15/05/2021,10063222013,1006322
3300,29/06/2021,3496,9,3180,120,316,05/03/2021,"Chateau Angelus Premier Grand Cru Classe B, Saint-Emilion Grand Cru",Bordeaux,2003,30/06/2021,10060452003,1006045
1000,20/05/2021,1162,86,975,25,187,12/04/2021,"Chateau Calon Segur 3eme Cru Classe, Saint-Estephe",Bordeaux,2005,21/05/2021,10074752005,1007475
10500,20/05/2021,12516,69,9844,656,2672,29/03/2021,"Chateau Margaux Premier Cru Classe, Margaux",Bordeaux,2015,21/05/2021,10127812015,1012781
3920,20/05/2021,4447,88,3800,120,647,12/05/2021,"Chateau Margaux Premier Cru Classe, Margaux",Bordeaux,2008,21/05/2021,10127812008,1012781
3300,29/06/2021,3496,9,3180,120,316,05/03/2021,"Chateau Angelus Premier Grand Cru Classe B, Saint-Emilion Grand Cru",Bordeaux,2003,30/06/2021,10060452003,1006045
950,20/05/2021,1003,61,863,87,140,10/05/2021,"Chateau Calon Segur 3eme Cru Classe, Saint-Estephe",Bordeaux,2006,21/05/2021,10074752006,1007475
3900,19/05/2021,4529,30,3684,216,845,10/06/2020,"Chateau Margaux Premier Cru Classe, Margaux",Bordeaux,2002,21/05/2021,10127812002,1012781
1678,20/05/2021,1702,4,1180,498,522,25/06/2020,"Tignanello, Toscana",Tuscany,2004,21/05/2021,10953912004,1095391
6300,20/05/2021,7565,55,5922,378,1643,13/04/2021,"Chateau Margaux Premier Cru Classe, Margaux",Bordeaux,2010,21/05/2021,10127812010,1012781
1700,20/05/2021,1674,3,1378,322,296,29/07/2020,"Tignanello, Toscana",Tuscany,2001,21/05/2021,10953912001,1095391
750,05/07/2021,989,35,790,-40,199,01/06/2020,"Chateau Calon Segur 3eme Cru Classe, Saint-Estephe",Bordeaux,2011,06/07/2021,10074752011,1007475
1024,05/07/2021,1255,4,1072,-48,183,20/01/2021,"Tignanello, Toscana",Tuscany,2009,06/07/2021,10953912009,1095391
1404,20/05/2021,1407,1,996,408,411,14/06/2019,"Tignanello, Toscana",Tuscany,2000,21/05/2021,10953912000,1095391
3300,28/06/2021,3496,9,3180,120,316,05/03/2021,"Chateau Angelus Premier Grand Cru Classe B, Saint-Emilion Grand Cru",Bordeaux,2003,29/06/2021,10060452003,1006045
3300,28/06/2021,3496,9,3180,120,316,05/03/2021,"Chateau Angelus Premier Grand Cru Classe B, Saint-Emilion Grand Cru",Bordeaux,2003,29/06/2021,10060452003,1006045
3300,25/06/2021,3479,8,3180,120,299,05/03/2021,"Chateau Angelus Premier Grand Cru Classe B, Saint-Emilion Grand Cru",Bordeaux,2003,27/06/2021,10060452003,1006045
3300,25/06/2021,3496,9,3180,120,316,05/03/2021,"Chateau Angelus Premier Grand Cru Classe B, Saint-Emilion Grand Cru",Bordeaux,2003,26/06/2021,10060452003,1006045
3740,20/05/2021,3978,48,3520,220,458,07/04/2021,"Chateau Margaux Premier Cru Classe, Margaux",Bordeaux,2013,21/05/2021,10127812013,1012781
1244,20/05/2021,1578,3,882,362,696,26/04/2019,"Tignanello, Toscana",Tuscany,2003,21/05/2021,10953912003,1095391
3300,25/06/2021,3496,9,3180,120,316,05/03/2021,"Chateau Angelus Premier Grand Cru Classe B, Saint-Emilion Grand Cru",Bordeaux,2003,26/06/2021,10060452003,1006045
3827,20/05/2021,4484,63,4116,-289,368,25/02/2021,"Chateau Margaux Premier Cru Classe, Margaux",Bordeaux,2004,21/05/2021,10127812004,1012781
3560,19/05/2021,4110,29,3592,-32,518,06/05/2021,"Chateau Margaux Premier Cru Classe, Margaux",Bordeaux,2007,22/05/2021,10127812007,1012781
750,07/07/2021,989,35,790,-40,199,01/06/2020,"Chateau Calon Segur 3eme Cru Classe, Saint-Estephe",Bordeaux,2011,08/07/2021,10074752011,1007475
4850,20/05/2021,5849,27,4842,8,1007,19/05/2021,"Chateau Margaux Premier Cru Classe, Margaux",Bordeaux,2003,21/05/2021,10127812003,1012781
460,20/05/2021,486,149,420,40,66,23/03/2021,"Tua Rita, Giusto di Notri, Toscana",Tuscany,2016,21/05/2021,11058072016,1105807
790,20/05/2021,929,41,794,-4,135,20/04/2021,"Chateau Calon Segur 3eme Cru Classe, Saint-Estephe",Bordeaux,2014,21/05/2021,10074752014,1007475
3300,25/06/2021,3479,8,3180,120,299,05/03/2021,"Chateau Angelus Premier Grand Cru Classe B, Saint-Emilion Grand Cru",Bordeaux,2003,27/06/2021,10060452003,1006045
3720,20/05/2021,4102,51,3480,240,622,10/04/2021,"Chateau Margaux Premier Cru Classe, Margaux",Bordeaux,2014,21/05/2021,10127812014,1012781
1000,20/05/2021,1168,47,1047,-47,121,27/04/2021,"Chateau Calon Segur 3eme Cru Classe, Saint-Estephe",Bordeaux,2009,21/05/2021,10074752009,1007475
3300,24/06/2021,3510,10,3180,120,330,05/03/2021,"Chateau Angelus Premier Grand Cru Classe B, Saint-Emilion Grand Cru",Bordeaux,2003,25/06/2021,10060452003,1006045
1050,20/05/2021,1156,60,1048,2,108,27/04/2021,"Chateau Calon Segur 3eme Cru Classe, Saint-Estephe",Bordeaux,2016,21/05/2021,10074752016,1007475
3920,20/05/2021,4447,88,3800,120,647,12/05/2021,"Chateau Margaux Premier Cru Classe, Margaux",Bordeaux,2008,21/05/2021,10127812008,1012781
1500,20/05/2021,1693,49,1408,92,285,09/04/2021,"Gaja, Barbaresco",Piedmont,2016,21/05/2021,10996052016,1099605
504,20/05/2021,522,1,300,204,222,03/11/2011,"Tua Rita, Giusto di Notri, Toscana",Tuscany,2007,21/05/2021,11058072007,1105807
880,20/05/2021,986,13,725,155,261,13/04/2021,"Chateau Calon Segur 3eme Cru Classe, Saint-Estephe",Bordeaux,2007,21/05/2021,10074752007,1007475
1200,20/05/2021,1148,123,1124,76,24,19/05/2021,"Tignanello, Toscana",Tuscany,2016,21/05/2021,10953912016,1095391
415,14/05/2021,535,46,364,51,171,12/05/2021,"Chateau Batailley 5eme Cru Classe, Pauillac",Bordeaux,2016,15/05/2021,10063222016,1006322
995,20/05/2021,1124,23,1000,-5,124,12/04/2021,"Chateau Calon Segur 3eme Cru Classe, Saint-Estephe",Bordeaux,2010,21/05/2021,10074752010,1007475
3300,24/06/2021,3510,10,3180,120,330,05/03/2021,"Chateau Angelus Premier Grand Cru Classe B, Saint-Emilion Grand Cru",Bordeaux,2003,25/06/2021,10060452003,1006045
7800,20/05/2021,8219,8,7000,800,1219,26/04/2021,"Domaine Leflaive, Chevalier-Montrachet Grand Cru",Burgundy,2018,21/05/2021,10734012018,1073401
408,14/05/2021,414,20,357,51,57,06/05/2021,"Chateau Batailley 5eme Cru Classe, Pauillac",Bordeaux,2018,15/05/2021,10063222018,1006322
6396,19/05/2021,6895,3,7900,-1504,-1005,29/04/2019,"Domaine Leflaive, Chevalier-Montrachet Grand Cru",Burgundy,2015,21/05/2021,10734012015,1073401
3300,23/06/2021,3510,10,3180,120,330,05/03/2021,"Chateau Angelus Premier Grand Cru Classe B, Saint-Emilion Grand Cru",Bordeaux,2003,24/06/2021,10060452003,1006045
840,18/05/2021,1082,97,860,-20,222,19/04/2021,"Chateau Calon Segur 3eme Cru Classe, Saint-Estephe",Bordeaux,2015,21/05/2021,10074752015,1007475
3300,23/06/2021,3510,10,3180,120,330,05/03/2021,"Chateau Angelus Premier Grand Cru Classe B, Saint-Emilion Grand Cru",Bordeaux,2003,24/06/2021,10060452003,1006045
3560,19/05/2021,4107,30,3592,-32,515,06/05/2021,"Chateau Margaux Premier Cru Classe, Margaux",Bordeaux,2007,21/05/2021,10127812007,1012781
1408,20/05/2021,1518,1,1150,258,368,21/04/2019,"Tignanello, Toscana",Tuscany,2005,21/05/2021,10953912005,1095391
3300,22/06/2021,3461,10,3180,120,281,05/03/2021,"Chateau Angelus Premier Grand Cru Classe B, Saint-Emilion Grand Cru",Bordeaux,2003,23/06/2021,10060452003,1006045
1100,20/05/2021,1531,7,1010,90,521,18/12/2020,"Tignanello, Toscana",Tuscany,2008,21/05/2021,10953912008,1095391
3300,22/06/2021,3461,10,3180,120,281,05/03/2021,"Chateau Angelus Premier Grand Cru Classe B, Saint-Emilion Grand Cru",Bordeaux,2003,23/06/2021,10060452003,1006045
1404,20/05/2021,1407,1,996,408,411,14/06/2019,"Tignanello, Toscana",Tuscany,2000,21/05/2021,10953912000,1095391
5580,20/05/2021,5727,82,5238,342,489,17/05/2021,"Chateau Margaux Premier Cru Classe, Margaux",Bordeaux,2016,21/05/2021,10127812016,1012781
3300,21/06/2021,3461,10,3180,120,281,05/03/2021,"Chateau Angelus Premier Grand Cru Classe B, Saint-Emilion Grand Cru",Bordeaux,2003,22/06/2021,10060452003,1006045
1408,20/05/2021,1445,5,1238,170,207,02/11/2020,"Tignanello, Toscana",Tuscany,2006,21/05/2021,10953912006,1095391
1050,18/05/2021,1205,21,940,110,265,18/03/2021,"Chateau Calon Segur 3eme Cru Classe, Saint-Estephe",Bordeaux,2000,21/05/2021,10074752000,1007475
1678,20/05/2021,1702,4,1180,498,522,25/06/2020,"Tignanello, Toscana",Tuscany,2004,21/05/2021,10953912004,1095391
8040,20/05/2021,8372,22,7950,90,422,12/03/2021,"Chateau Margaux Premier Cru Classe, Margaux",Bordeaux,2000,21/05/2021,10127812000,1012781
660,20/05/2021,724,4,390,270,334,18/08/2017,"Tua Rita, Giusto di Notri, Toscana",Tuscany,2006,21/05/2021,11058072006,1105807
1020,20/05/2021,1048,10,860,160,188,08/03/2021,"Tignanello, Toscana",Tuscany,2011,21/05/2021,10953912011,1095391
3300,21/06/2021,3461,10,3180,120,281,05/03/2021,"Chateau Angelus Premier Grand Cru Classe B, Saint-Emilion Grand Cru",Bordeaux,2003,22/06/2021,10060452003,1006045
412,17/05/2021,437,2,220,192,217,17/06/2015,"Chateau Batailley 5eme Cru Classe, Pauillac",Bordeaux,2002,18/05/2021,10063222002,1006322
3300,18/06/2021,3510,10,3180,120,330,05/03/2021,"Chateau Angelus Premier Grand Cru Classe B, Saint-Emilion Grand Cru",Bordeaux,2003,19/06/2021,10060452003,1006045
7906,20/05/2021,8122,2,7124,782,998,15/02/2019,"Domaine Leflaive, Chevalier-Montrachet Grand Cru",Burgundy,2016,21/05/2021,10734012016,1073401
4400,20/05/2021,4860,27,4400,0,460,29/09/2020,"Chateau Margaux Premier Cru Classe, Margaux",Bordeaux,2001,21/05/2021,10127812001,1012781
4400,12/05/2021,5018,7,4160,240,858,19/03/2021,"Chateau Margaux Premier Cru Classe, Margaux",Bordeaux,2019,21/05/2021,10127812019,1012781
589,17/05/2021,622,52,450,139,172,04/05/2021,"Chateau Batailley 5eme Cru Classe, Pauillac",Bordeaux,2005,18/05/2021,10063222005,1006322
3300,18/06/2021,3510,10,3180,120,330,05/03/2021,"Chateau Angelus Premier Grand Cru Classe B, Saint-Emilion Grand Cru",Bordeaux,2003,19/06/2021,10060452003,1006045
3900,19/05/2021,4529,30,3684,216,845,10/06/2020,"Chateau Margaux Premier Cru Classe, Margaux",Bordeaux,2002,21/05/2021,10127812002,1012781
589,17/05/2021,622,52,450,139,172,04/05/2021,"Chateau Batailley 5eme Cru Classe, Pauillac",Bordeaux,2005,18/05/2021,10063222005,1006322
1024,19/05/2021,1182,11,1072,-48,110,20/01/2021,"Tignanello, Toscana",Tuscany,2009,21/05/2021,10953912009,1095391
16200,20/05/2021,16056,0,18750,-2550,-2694,29/08/2018,"Jacques-Frederic Mugnier, Chambolle-Musigny Premier Cru, Les Amoureuses",Burgundy,2015,21/05/2021,10496422015,1049642
1350,20/05/2021,1473,61,1260,90,213,18/02/2021,"Gaja, Barbaresco",Piedmont,2015,21/05/2021,10996052015,1099605
10500,20/05/2021,12516,69,9844,656,2672,29/03/2021,"Chateau Margaux Premier Cru Classe, Margaux",Bordeaux,2015,21/05/2021,10127812015,1012781
450,17/05/2021,450,1,340,110,110,31/08/2018,"Chateau Batailley 5eme Cru Classe, Pauillac",Bordeaux,2007,18/05/2021,10063222007,1006322
1350,20/05/2021,1449,7,1352,-2,97,23/09/2020,"Gaja, Barbaresco",Piedmont,2011,21/05/2021,10996052011,1099605
490,17/05/2021,553,20,504,-14,49,06/04/2021,"Chateau Batailley 5eme Cru Classe, Pauillac",Bordeaux,2009,18/05/2021,10063222009,1006322
2232,20/05/2021,2335,5,2190,42,145,01/05/2021,"Gaja, Barbaresco",Piedmont,2004,21/05/2021,10996052004,1099605
6250,20/05/2021,7004,40,6116,134,888,07/05/2021,"Chateau Margaux Premier Cru Classe, Margaux",Bordeaux,2005,21/05/2021,10127812005,1012781
3300,17/06/2021,3510,10,3180,120,330,05/03/2021,"Chateau Angelus Premier Grand Cru Classe B, Saint-Emilion Grand Cru",Bordeaux,2003,18/06/2021,10060452003,1006045
1300,19/05/2021,1523,12,1300,0,223,28/09/2020,"Gaja, Barbaresco",Piedmont,2014,21/05/2021,10996052014,1099605
490,19/05/2021,553,19,388,102,165,29/09/2020,"Tua Rita, Giusto di Notri, Toscana",Tuscany,2015,21/05/2021,11058072015,1105807
3827,20/05/2021,4484,63,4116,-289,368,25/02/2021,"Chateau Margaux Premier Cru Classe, Margaux",Bordeaux,2004,21/05/2021,10127812004,1012781
8000,20/05/2021,8613,7,6974,1026,1639,14/03/2021,"Domaine Leflaive, Chevalier-Montrachet Grand Cru",Burgundy,2017,21/05/2021,10734012017,1073401
520,20/05/2021,563,5,460,60,103,05/05/2020,"Tua Rita, Giusto di Notri, Toscana",Tuscany,2008,21/05/2021,11058072008,1105807
1050,20/05/2021,1213,12,860,190,353,08/03/2021,"Tignanello, Toscana",Tuscany,2013,21/05/2021,10953912013,1095391
3740,20/05/2021,3978,48,3520,220,458,07/04/2021,"Chateau Margaux Premier Cru Classe, Margaux",Bordeaux,2013,21/05/2021,10127812013,1012781
3300,17/06/2021,3510,10,3180,120,330,05/03/2021,"Chateau Angelus Premier Grand Cru Classe B, Saint-Emilion Grand Cru",Bordeaux,2003,18/06/2021,10060452003,1006045
6300,20/05/2021,7565,55,5922,378,1643,13/04/2021,"Chateau Margaux Premier Cru Classe, Margaux",Bordeaux,2010,21/05/2021,10127812010,1012781
6650,20/05/2021,7645,42,6500,150,1145,12/05/2021,"Chateau Margaux Premier Cru Classe, Margaux",Bordeaux,2009,21/05/2021,10127812009,1012781
1280,20/05/2021,1338,6,1200,80,138,06/03/2021,"Tignanello, Toscana",Tuscany,2007,21/05/2021,10953912007,1095391
1244,20/05/2021,1578,3,882,362,696,26/04/2019,"Tignanello, Toscana",Tuscany,2003,21/05/2021,10953912003,1095391
790,20/05/2021,937,115,814,-24,123,13/05/2021,"Tignanello, Toscana",Tuscany,2017,21/05/2021,10953912017,1095391
950,20/05/2021,1003,61,863,87,140,10/05/2021,"Chateau Calon Segur 3eme Cru Classe, Saint-Estephe",Bordeaux,2006,21/05/2021,10074752006,1007475
490,17/05/2021,553,20,504,-14,49,06/04/2021,"Chateau Batailley 5eme Cru Classe, Pauillac",Bordeaux,2009,18/05/2021,10063222009,1006322
3758,20/05/2021,4033,79,3690,68,343,13/04/2021,"Chateau Margaux Premier Cru Classe, Margaux",Bordeaux,2011,21/05/2021,10127812011,1012781
2872,20/05/2021,2872,2,2554,318,318,22/05/2020,"Gaja, Barbaresco",Piedmont,2006,21/05/2021,10996052006,1099605
907,19/05/2021,1051,39,805,102,246,20/11/2019,"Chateau Calon Segur 3eme Cru Classe, Saint-Estephe",Bordeaux,2001,21/05/2021,10074752001,1007475
3700,20/05/2021,4067,126,3700,0,367,06/05/2021,"Chateau Margaux Premier Cru Classe, Margaux",Bordeaux,2017,21/05/2021,10127812017,1012781
3860,19/05/2021,4747,73,3800,60,947,07/04/2021,"Chateau Margaux Premier Cru Classe, Margaux",Bordeaux,2006,21/05/2021,10127812006,1012781
3300,16/06/2021,3510,10,3180,120,330,05/03/2021,"Chateau Angelus Premier Grand Cru Classe B, Saint-Emilion Grand Cru",Bordeaux,2003,17/06/2021,10060452003,1006045
3850,20/05/2021,4179,43,3560,290,619,20/11/2020,"Chateau Margaux Premier Cru Classe, Margaux",Bordeaux,2012,21/05/2021,10127812012,1012781
12402,20/05/2021,12557,2,12850,-448,-293,30/11/2020,"Jacques-Frederic Mugnier, Chambolle-Musigny Premier Cru, Les Amoureuses",Burgundy,2011,21/05/2021,10496422011,1049642
3300,16/06/2021,3510,10,3180,120,330,05/03/2021,"Chateau Angelus Premier Grand Cru Classe B, Saint-Emilion Grand Cru",Bordeaux,2003,17/06/2021,10060452003,1006045
400,17/05/2021,463,9,355,45,108,15/04/2021,"Chateau Batailley 5eme Cru Classe, Pauillac",Bordeaux,2012,18/05/2021,10063222012,1006322
1000,20/05/2021,1162,86,975,25,187,12/04/2021,"Chateau Calon Segur 3eme Cru Classe, Saint-Estephe",Bordeaux,2005,21/05/2021,10074752005,1007475
1238,28/06/2021,1268,38,1100,138,168,28/06/2021,"Tignanello, Toscana",Tuscany,2016,29/06/2021,10953912016,1095391
400,17/05/2021,463,9,355,45,108,15/04/2021,"Chateau Batailley 5eme Cru Classe, Pauillac",Bordeaux,2012,18/05/2021,10063222012,1006322
460,28/06/2021,489,188,420,40,69,28/05/2021,"Tua Rita, Giusto di Notri, Toscana",Tuscany,2016,29/06/2021,11058072016,1105807
300,17/05/2021,301,110,304,-4,-3,10/01/2021,"Chateau Batailley 5eme Cru Classe, Pauillac",Bordeaux,2013,18/05/2021,10063222013,1006322
10500,28/06/2021,11893,50,9800,700,2093,11/06/2021,"Chateau Margaux Premier Cru Classe, Margaux",Bordeaux,2015,29/06/2021,10127812015,1012781
3900,28/06/2021,4495,25,3684,216,811,10/06/2020,"Chateau Margaux Premier Cru Classe, Margaux",Bordeaux,2002,29/06/2021,10127812002,1012781
3826,28/06/2021,4515,55,4116,-290,399,25/02/2021,"Chateau Margaux Premier Cru Classe, Margaux",Bordeaux,2004,29/06/2021,10127812004,1012781
1024,07/07/2021,1255,4,1072,-48,183,20/01/2021,"Tignanello, Toscana",Tuscany,2009,08/07/2021,10953912009,1095391
1326,07/07/2021,1560,4,1170,156,390,24/06/2021,"Tignanello, Toscana",Tuscany,2010,08/07/2021,10953912010,1095391
7800,28/06/2021,8255,5,7330,470,925,02/06/2021,"Domaine Leflaive, Chevalier-Montrachet Grand Cru",Burgundy,2018,29/06/2021,10734012018,1073401
1408,28/06/2021,1389,4,1238,170,151,02/11/2020,"Tignanello, Toscana",Tuscany,2006,29/06/2021,10953912006,1095391
950,28/06/2021,1019,52,863,87,156,10/05/2021,"Chateau Calon Segur 3eme Cru Classe, Saint-Estephe",Bordeaux,2006,29/06/2021,10074752006,1007475
3750,24/06/2021,4198,39,3560,190,638,20/11/2020,"Chateau Margaux Premier Cru Classe, Margaux",Bordeaux,2012,29/06/2021,10127812012,1012781
6557,28/06/2021,6557,0,3920,2637,2637,26/04/2017,"Domaine Leflaive, Chevalier-Montrachet Grand Cru",Burgundy,2006,29/06/2021,10734012006,1073401
6830,28/06/2021,7741,47,7086,-256,655,11/06/2021,"Chateau Margaux Premier Cru Classe, Margaux",Bordeaux,2009,29/06/2021,10127812009,1012781
3300,15/06/2021,3497,9,3180,120,317,05/03/2021,"Chateau Angelus Premier Grand Cru Classe B, Saint-Emilion Grand Cru",Bordeaux,2003,16/06/2021,10060452003,1006045
1080,28/06/2021,1216,48,950,130,266,03/05/2021,"Chateau Calon Segur 3eme Cru Classe, Saint-Estephe",Bordeaux,2018,29/06/2021,10074752018,1007475
4400,31/05/2021,4852,22,4400,0,452,29/09/2020,"Chateau Margaux Premier Cru Classe, Margaux",Bordeaux,2001,01/06/2021,10127812001,1012781
3300,15/06/2021,3497,9,3180,120,317,05/03/2021,"Chateau Angelus Premier Grand Cru Classe B, Saint-Emilion Grand Cru",Bordeaux,2003,16/06/2021,10060452003,1006045
660,31/05/2021,724,4,390,270,334,18/08/2017,"Tua Rita, Giusto di Notri, Toscana",Tuscany,2006,01/06/2021,11058072006,1105807
415,17/05/2021,535,46,364,51,171,12/05/2021,"Chateau Batailley 5eme Cru Classe, Pauillac",Bordeaux,2016,18/05/2021,10063222016,1006322
3300,14/06/2021,3497,9,3180,120,317,05/03/2021,"Chateau Angelus Premier Grand Cru Classe B, Saint-Emilion Grand Cru",Bordeaux,2003,15/06/2021,10060452003,1006045
880,28/06/2021,967,9,725,155,242,13/04/2021,"Chateau Calon Segur 3eme Cru Classe, Saint-Estephe",Bordeaux,2007,29/06/2021,10074752007,1007475
3300,14/06/2021,3497,9,3180,120,317,05/03/2021,"Chateau Angelus Premier Grand Cru Classe B, Saint-Emilion Grand Cru",Bordeaux,2003,15/06/2021,10060452003,1006045
5000,31/05/2021,5046,8,4160,840,886,19/03/2021,"Chateau Margaux Premier Cru Classe, Margaux",Bordeaux,2019,01/06/2021,10127812019,1012781
990,31/05/2021,1114,22,1000,-10,114,12/04/2021,"Chateau Calon Segur 3eme Cru Classe, Saint-Estephe",Bordeaux,2010,01/06/2021,10074752010,1007475
14520,31/05/2021,14387,1,12000,2520,2387,28/05/2020,"Jacques-Frederic Mugnier, Chambolle-Musigny Premier Cru, Les Amoureuses",Burgundy,2014,01/06/2021,10496422014,1049642
3300,11/06/2021,3497,9,3180,120,317,05/03/2021,"Chateau Angelus Premier Grand Cru Classe B, Saint-Emilion Grand Cru",Bordeaux,2003,13/06/2021,10060452003,1006045
3300,11/06/2021,3455,11,3180,120,275,05/03/2021,"Chateau Angelus Premier Grand Cru Classe B, Saint-Emilion Grand Cru",Bordeaux,2003,12/06/2021,10060452003,1006045
8400,31/05/2021,8933,1,5960,2440,2973,01/08/2017,"Domaine Leflaive, Chevalier-Montrachet Grand Cru",Burgundy,2010,01/06/2021,10734012010,1073401
900,31/05/2021,1092,30,800,100,292,21/11/2019,"Chateau Calon Segur 3eme Cru Classe, Saint-Estephe",Bordeaux,2003,01/06/2021,10074752003,1007475
1500,31/05/2021,1683,49,1408,92,275,09/04/2021,"Gaja, Barbaresco",Piedmont,2016,01/06/2021,10996052016,1099605
415,17/05/2021,536,47,364,51,172,12/05/2021,"Chateau Batailley 5eme Cru Classe, Pauillac",Bordeaux,2016,19/05/2021,10063222016,1006322
17000,26/05/2021,14962,7,13000,4000,1962,29/04/2021,"Jacques-Frederic Mugnier, Chambolle-Musigny Premier Cru, Les Amoureuses",Burgundy,2017,01/06/2021,10496422017,1049642
950,31/05/2021,1080,28,842,108,238,22/08/2020,"Chateau Calon Segur 3eme Cru Classe, Saint-Estephe",Bordeaux,2019,01/06/2021,10074752019,1007475
415,17/05/2021,529,47,364,51,165,12/05/2021,"Chateau Batailley 5eme Cru Classe, Pauillac",Bordeaux,2016,20/05/2021,10063222016,1006322
3790,28/06/2021,4195,99,3646,144,549,16/06/2021,"Chateau Margaux Premier Cru Classe, Margaux",Bordeaux,2017,29/06/2021,10127812017,1012781
1700,28/06/2021,1652,3,1378,322,274,29/07/2020,"Tignanello, Toscana",Tuscany,2001,29/06/2021,10953912001,1095391
6400,28/06/2021,7230,26,6776,-376,454,10/06/2021,"Chateau Margaux Premier Cru Classe, Margaux",Bordeaux,2005,29/06/2021,10127812005,1012781
1800,28/06/2021,1814,1,1300,500,514,30/05/2019,"Gaja, Barbaresco",Piedmont,2007,29/06/2021,10996052007,1099605
3900,28/06/2021,4260,78,3750,150,510,28/06/2021,"Chateau Margaux Premier Cru Classe, Margaux",Bordeaux,2008,29/06/2021,10127812008,1012781
790,27/05/2021,921,31,801,-11,120,31/05/2021,"Chateau Calon Segur 3eme Cru Classe, Saint-Estephe",Bordeaux,2014,01/06/2021,10074752014,1007475
790,31/05/2021,940,143,816,-26,124,27/05/2021,"Tignanello, Toscana",Tuscany,2017,01/06/2021,10953912017,1095391
1350,31/05/2021,1432,7,1352,-2,80,23/09/2020,"Gaja, Barbaresco",Piedmont,2011,01/06/2021,10996052011,1099605
8000,28/06/2021,8692,5,6974,1026,1718,14/03/2021,"Domaine Leflaive, Chevalier-Montrachet Grand Cru",Burgundy,2017,29/06/2021,10734012017,1073401
3300,11/06/2021,3497,9,3180,120,317,05/03/2021,"Chateau Angelus Premier Grand Cru Classe B, Saint-Emilion Grand Cru",Bordeaux,2003,13/06/2021,10060452003,1006045
6400,28/06/2021,7579,50,5950,450,1629,23/06/2021,"Chateau Margaux Premier Cru Classe, Margaux",Bordeaux,2010,29/06/2021,10127812010,1012781
1024,28/06/2021,1255,4,1072,-48,183,20/01/2021,"Tignanello, Toscana",Tuscany,2009,29/06/2021,10953912009,1095391
5380,31/05/2021,5586,90,5254,126,332,26/05/2021,"Chateau Margaux Premier Cru Classe, Margaux",Bordeaux,2018,01/06/2021,10127812018,1012781
3300,11/06/2021,3455,11,3180,120,275,05/03/2021,"Chateau Angelus Premier Grand Cru Classe B, Saint-Emilion Grand Cru",Bordeaux,2003,12/06/2021,10060452003,1006045
880,31/05/2021,986,13,725,155,261,13/04/2021,"Chateau Calon Segur 3eme Cru Classe, Saint-Estephe",Bordeaux,2007,01/06/2021,10074752007,1007475
5307,28/06/2021,5789,117,5238,69,551,17/05/2021,"Chateau Margaux Premier Cru Classe, Margaux",Bordeaux,2016,29/06/2021,10127812016,1012781
487,31/05/2021,524,45,320,167,204,24/03/2021,"Tua Rita, Giusto di Notri, Toscana",Tuscany,2017,01/06/2021,11058072017,1105807
1264,31/05/2021,1363,8,1172,92,191,07/04/2021,"Tignanello, Toscana",Tuscany,2010,01/06/2021,10953912010,1095391
3560,28/06/2021,4183,39,3525,35,658,18/06/2021,"Chateau Margaux Premier Cru Classe, Margaux",Bordeaux,2007,29/06/2021,10127812007,1012781
1100,28/06/2021,1218,68,1036,64,182,27/05/2021,"Chateau Calon Segur 3eme Cru Classe, Saint-Estephe",Bordeaux,2016,29/06/2021,10074752016,1007475
750,30/06/2021,988,36,790,-40,198,01/06/2020,"Chateau Calon Segur 3eme Cru Classe, Saint-Estephe",Bordeaux,2011,02/07/2021,10074752011,1007475
1039,27/05/2021,1021,71,940,99,81,13/05/2021,"Tignanello, Toscana",Tuscany,2018,01/06/2021,10953912018,1095391
430,27/05/2021,461,124,380,50,81,25/03/2021,"Tua Rita, Giusto di Notri, Toscana",Tuscany,2018,01/06/2021,11058072018,1105807
6750,31/05/2021,7629,42,6525,225,1104,23/05/2021,"Chateau Margaux Premier Cru Classe, Margaux",Bordeaux,2009,01/06/2021,10127812009,1012781
2232,31/05/2021,2358,5,2190,42,168,01/05/2021,"Gaja, Barbaresco",Piedmont,2004,01/06/2021,10996052004,1099605
1350,31/05/2021,1473,61,1260,90,213,18/02/2021,"Gaja, Barbaresco",Piedmont,2015,01/06/2021,10996052015,1099605
540,31/05/2021,533,3,300,240,233,03/11/2011,"Tua Rita, Giusto di Notri, Toscana",Tuscany,2007,01/06/2021,11058072007,1105807
3900,31/05/2021,4703,77,3861,39,842,28/05/2021,"Chateau Margaux Premier Cru Classe, Margaux",Bordeaux,2006,01/06/2021,10127812006,1012781
3300,10/06/2021,3455,11,3180,120,275,05/03/2021,"Chateau Angelus Premier Grand Cru Classe B, Saint-Emilion Grand Cru",Bordeaux,2003,11/06/2021,10060452003,1006045
8023,31/05/2021,9841,3,7290,733,2551,21/08/2020,"Domaine Denis Mortet, Chambertin Grand Cru",Burgundy,2017,01/06/2021,10490202017,1049020
14520,28/06/2021,14520,1,12000,2520,2520,28/05/2020,"Jacques-Frederic Mugnier, Chambolle-Musigny Premier Cru, Les Amoureuses",Burgundy,2014,29/06/2021,10496422014,1049642
3600,07/07/2021,4284,81,3690,-90,594,13/04/2021,"Chateau Margaux Premier Cru Classe, Margaux",Bordeaux,2011,08/07/2021,10127812011,1012781
3300,10/06/2021,3455,11,3180,120,275,05/03/2021,"Chateau Angelus Premier Grand Cru Classe B, Saint-Emilion Grand Cru",Bordeaux,2003,11/06/2021,10060452003,1006045
750,17/06/2021,929,104,740,10,189,21/05/2021,"Chateau Calon Segur 3eme Cru Classe, Saint-Estephe",Bordeaux,2017,29/06/2021,10074752017,1007475
880,17/06/2021,980,10,781,99,199,16/11/2020,"Chateau Calon Segur 3eme Cru Classe, Saint-Estephe",Bordeaux,2008,29/06/2021,10074752008,1007475
1550,28/06/2021,1557,1,1300,250,257,27/04/2021,"Gaja, Barbaresco",Piedmont,2012,29/06/2021,10996052012,1099605
4400,17/06/2021,4688,22,4400,0,288,29/09/2020,"Chateau Margaux Premier Cru Classe, Margaux",Bordeaux,2001,29/06/2021,10127812001,1012781
5600,28/06/2021,5851,100,5254,346,597,26/05/2021,"Chateau Margaux Premier Cru Classe, Margaux",Bordeaux,2018,29/06/2021,10127812018,1012781
3750,17/06/2021,4043,74,3690,60,353,13/04/2021,"Chateau Margaux Premier Cru Classe, Margaux",Bordeaux,2011,29/06/2021,10127812011,1012781
1380,28/06/2021,1443,7,1352,28,91,23/09/2020,"Gaja, Barbaresco",Piedmont,2011,29/06/2021,10996052011,1099605
540,28/06/2021,527,2,300,240,227,03/11/2011,"Tua Rita, Giusto di Notri, Toscana",Tuscany,2007,29/06/2021,11058072007,1105807
3300,08/06/2021,3457,13,3180,120,277,05/03/2021,"Chateau Angelus Premier Grand Cru Classe B, Saint-Emilion Grand Cru",Bordeaux,2003,09/06/2021,10060452003,1006045
1050,07/07/2021,1074,8,880,170,194,22/06/2021,"Tignanello, Toscana",Tuscany,2011,08/07/2021,10953912011,1095391
3740,28/06/2021,4016,53,3520,220,496,07/04/2021,"Chateau Margaux Premier Cru Classe, Margaux",Bordeaux,2013,29/06/2021,10127812013,1012781
1350,28/06/2021,1475,60,1260,90,215,18/02/2021,"Gaja, Barbaresco",Piedmont,2015,29/06/2021,10996052015,1099605
950,27/05/2021,1003,59,863,87,140,10/05/2021,"Chateau Calon Segur 3eme Cru Classe, Saint-Estephe",Bordeaux,2006,28/05/2021,10074752006,1007475
3900,27/05/2021,4433,92,3800,100,633,12/05/2021,"Chateau Margaux Premier Cru Classe, Margaux",Bordeaux,2008,28/05/2021,10127812008,1012781
790,27/05/2021,921,31,794,-4,127,20/04/2021,"Chateau Calon Segur 3eme Cru Classe, Saint-Estephe",Bordeaux,2014,28/05/2021,10074752014,1007475
6300,27/05/2021,7563,55,6190,110,1373,23/05/2021,"Chateau Margaux Premier Cru Classe, Margaux",Bordeaux,2010,28/05/2021,10127812010,1012781
1290,26/05/2021,1368,8,1172,118,196,07/04/2021,"Tignanello, Toscana",Tuscany,2010,28/05/2021,10953912010,1095391
789,27/05/2021,977,21,745,44,232,16/11/2020,"Chateau Calon Segur 3eme Cru Classe, Saint-Estephe",Bordeaux,2004,28/05/2021,10074752004,1007475
1050,24/05/2021,1213,22,940,110,273,18/03/2021,"Chateau Calon Segur 3eme Cru Classe, Saint-Estephe",Bordeaux,2000,28/05/2021,10074752000,1007475
1300,27/05/2021,1331,6,1200,100,131,06/03/2021,"Tignanello, Toscana",Tuscany,2007,28/05/2021,10953912007,1095391
3300,08/06/2021,3457,13,3180,120,277,05/03/2021,"Chateau Angelus Premier Grand Cru Classe B, Saint-Emilion Grand Cru",Bordeaux,2003,09/06/2021,10060452003,1006045
990,27/05/2021,1152,98,1000,-10,152,25/05/2021,"Chateau Calon Segur 3eme Cru Classe, Saint-Estephe",Bordeaux,2005,28/05/2021,10074752005,1007475
1245,27/05/2021,1523,3,882,363,641,26/04/2019,"Tignanello, Toscana",Tuscany,2003,28/05/2021,10953912003,1095391
1100,27/05/2021,1464,9,1010,90,454,18/12/2020,"Tignanello, Toscana",Tuscany,2008,28/05/2021,10953912008,1095391
840,21/05/2021,936,18,781,59,155,16/11/2020,"Chateau Calon Segur 3eme Cru Classe, Saint-Estephe",Bordeaux,2008,28/05/2021,10074752008,1007475
1408,27/05/2021,1352,2,996,412,356,14/06/2019,"Tignanello, Toscana",Tuscany,2000,28/05/2021,10953912000,1095391
8040,27/05/2021,8366,18,7950,90,416,12/03/2021,"Chateau Margaux Premier Cru Classe, Margaux",Bordeaux,2000,28/05/2021,10127812000,1012781
3300,07/06/2021,3457,13,3180,120,277,05/03/2021,"Chateau Angelus Premier Grand Cru Classe B, Saint-Emilion Grand Cru",Bordeaux,2003,08/06/2021,10060452003,1006045
3300,07/06/2021,3457,13,3180,120,277,05/03/2021,"Chateau Angelus Premier Grand Cru Classe B, Saint-Emilion Grand Cru",Bordeaux,2003,08/06/2021,10060452003,1006045
830,18/05/2021,973,6,735,95,238,09/09/2020,"Chateau Calon Segur 3eme Cru Classe, Saint-Estephe",Bordeaux,2012,28/05/2021,10074752012,1007475
3300,04/06/2021,3425,13,3180,120,245,05/03/2021,"Chateau Angelus Premier Grand Cru Classe B, Saint-Emilion Grand Cru",Bordeaux,2003,05/06/2021,10060452003,1006045
9600,16/06/2021,9798,2,8000,1600,1798,30/01/2020,"Domaine Leflaive, Chevalier-Montrachet Grand Cru",Burgundy,2014,17/06/2021,10734012014,1073401
3300,04/06/2021,3425,13,3180,120,245,05/03/2021,"Chateau Angelus Premier Grand Cru Classe B, Saint-Emilion Grand Cru",Bordeaux,2003,05/06/2021,10060452003,1006045
2098,16/06/2021,2331,5,2190,-92,141,01/05/2021,"Gaja, Barbaresco",Piedmont,2004,17/06/2021,10996052004,1099605
990,16/06/2021,1109,20,990,0,119,16/06/2021,"Chateau Calon Segur 3eme Cru Classe, Saint-Estephe",Bordeaux,2010,17/06/2021,10074752010,1007475
7527,28/06/2021,9912,3,7290,237,2622,21/08/2020,"Domaine Denis Mortet, Chambertin Grand Cru",Burgundy,2017,29/06/2021,10490202017,1049020
15600,23/06/2021,15231,5,13000,2600,2231,29/04/2021,"Jacques-Frederic Mugnier, Chambolle-Musigny Premier Cru, Les Amoureuses",Burgundy,2017,29/06/2021,10496422017,1049642
3300,03/06/2021,3440,13,3180,120,260,05/03/2021,"Chateau Angelus Premier Grand Cru Classe B, Saint-Emilion Grand Cru",Bordeaux,2003,04/06/2021,10060452003,1006045
408,17/05/2021,414,21,357,51,57,06/05/2021,"Chateau Batailley 5eme Cru Classe, Pauillac",Bordeaux,2018,18/05/2021,10063222018,1006322
820,07/07/2021,937,6,735,85,202,09/09/2020,"Chateau Calon Segur 3eme Cru Classe, Saint-Estephe",Bordeaux,2012,08/07/2021,10074752012,1007475
3750,05/07/2021,4272,47,3560,190,712,20/11/2020,"Chateau Margaux Premier Cru Classe, Margaux",Bordeaux,2012,08/07/2021,10127812012,1012781
6250,27/05/2021,7070,40,6360,-110,710,24/05/2021,"Chateau Margaux Premier Cru Classe, Margaux",Bordeaux,2005,28/05/2021,10127812005,1012781
6750,27/05/2021,7647,42,6525,225,1122,23/05/2021,"Chateau Margaux Premier Cru Classe, Margaux",Bordeaux,2009,28/05/2021,10127812009,1012781
686,16/06/2021,844,13,682,4,162,15/09/2020,"Chateau Calon Segur 3eme Cru Classe, Saint-Estephe",Bordeaux,2013,17/06/2021,10074752013,1007475
3720,16/06/2021,4290,146,3480,240,810,10/04/2021,"Chateau Margaux Premier Cru Classe, Margaux",Bordeaux,2014,17/06/2021,10127812014,1012781
950,16/06/2021,1020,53,863,87,157,10/05/2021,"Chateau Calon Segur 3eme Cru Classe, Saint-Estephe",Bordeaux,2006,17/06/2021,10074752006,1007475
3300,03/06/2021,3440,13,3180,120,260,05/03/2021,"Chateau Angelus Premier Grand Cru Classe B, Saint-Emilion Grand Cru",Bordeaux,2003,04/06/2021,10060452003,1006045
3900,28/06/2021,4638,94,3822,78,816,20/06/2021,"Chateau Margaux Premier Cru Classe, Margaux",Bordeaux,2006,29/06/2021,10127812006,1012781
1500,25/06/2021,1680,48,1408,92,272,09/04/2021,"Gaja, Barbaresco",Piedmont,2016,29/06/2021,10996052016,1099605
860,28/06/2021,1032,69,910,-50,122,23/06/2021,"Tignanello, Toscana",Tuscany,2018,29/06/2021,10953912018,1095391
660,28/06/2021,727,5,390,270,337,18/08/2017,"Tua Rita, Giusto di Notri, Toscana",Tuscany,2006,29/06/2021,11058072006,1105807
1260,16/06/2021,1375,7,1172,88,203,07/04/2021,"Tignanello, Toscana",Tuscany,2010,17/06/2021,10953912010,1095391
4850,27/05/2021,5670,35,4842,8,828,19/05/2021,"Chateau Margaux Premier Cru Classe, Margaux",Bordeaux,2003,28/05/2021,10127812003,1012781
412,18/05/2021,437,2,220,192,217,17/06/2015,"Chateau Batailley 5eme Cru Classe, Pauillac",Bordeaux,2002,19/05/2021,10063222002,1006322
880,27/05/2021,986,13,725,155,261,13/04/2021,"Chateau Calon Segur 3eme Cru Classe, Saint-Estephe",Bordeaux,2007,28/05/2021,10074752007,1007475
3750,27/05/2021,4108,33,3592,158,516,06/05/2021,"Chateau Margaux Premier Cru Classe, Margaux",Bordeaux,2007,28/05/2021,10127812007,1012781
3300,02/06/2021,3439,12,3180,120,259,05/03/2021,"Chateau Angelus Premier Grand Cru Classe B, Saint-Emilion Grand Cru",Bordeaux,2003,03/06/2021,10060452003,1006045
1408,27/05/2021,1446,2,1150,258,296,21/04/2019,"Tignanello, Toscana",Tuscany,2005,28/05/2021,10953912005,1095391
3300,02/06/2021,3439,12,3180,120,259,05/03/2021,"Chateau Angelus Premier Grand Cru Classe B, Saint-Emilion Grand Cru",Bordeaux,2003,03/06/2021,10060452003,1006045
907,16/06/2021,957,24,805,102,152,20/11/2019,"Chateau Calon Segur 3eme Cru Classe, Saint-Estephe",Bordeaux,2001,17/06/2021,10074752001,1007475
880,16/06/2021,986,13,725,155,261,13/04/2021,"Chateau Calon Segur 3eme Cru Classe, Saint-Estephe",Bordeaux,2007,17/06/2021,10074752007,1007475
3826,16/06/2021,4525,55,4116,-290,409,25/02/2021,"Chateau Margaux Premier Cru Classe, Margaux",Bordeaux,2004,17/06/2021,10127812004,1012781
3300,01/06/2021,3421,11,3180,120,241,05/03/2021,"Chateau Angelus Premier Grand Cru Classe B, Saint-Emilion Grand Cru",Bordeaux,2003,02/06/2021,10060452003,1006045
1678,27/05/2021,1661,4,1180,498,481,25/06/2020,"Tignanello, Toscana",Tuscany,2004,28/05/2021,10953912004,1095391
9600,27/05/2021,9895,3,8000,1600,1895,30/01/2020,"Domaine Leflaive, Chevalier-Montrachet Grand Cru",Burgundy,2014,28/05/2021,10734012014,1073401
3300,01/06/2021,3421,11,3180,120,241,05/03/2021,"Chateau Angelus Premier Grand Cru Classe B, Saint-Emilion Grand Cru",Bordeaux,2003,02/06/2021,10060452003,1006045
2500,16/06/2021,3208,4,2220,280,988,14/06/2021,"Gaja, Barbaresco",Piedmont,2001,17/06/2021,10996052001,1099605
3720,27/05/2021,4106,43,3480,240,626,10/04/2021,"Chateau Margaux Premier Cru Classe, Margaux",Bordeaux,2014,28/05/2021,10127812014,1012781
525,18/05/2021,542,3,420,105,122,09/07/2019,"Chateau Batailley 5eme Cru Classe, Pauillac",Bordeaux,2003,19/05/2021,10063222003,1006322
660,21/06/2021,727,5,390,270,337,18/08/2017,"Tua Rita, Giusto di Notri, Toscana",Tuscany,2006,22/06/2021,11058072006,1105807
1079,21/06/2021,1218,67,1036,43,182,27/05/2021,"Chateau Calon Segur 3eme Cru Classe, Saint-Estephe",Bordeaux,2016,22/06/2021,10074752016,1007475
2232,27/05/2021,2359,5,2190,42,169,01/05/2021,"Gaja, Barbaresco",Piedmont,2004,28/05/2021,10996052004,1099605
589,18/05/2021,624,52,450,139,174,04/05/2021,"Chateau Batailley 5eme Cru Classe, Pauillac",Bordeaux,2005,19/05/2021,10063222005,1006322
3300,31/05/2021,3421,11,3180,120,241,05/03/2021,"Chateau Angelus Premier Grand Cru Classe B, Saint-Emilion Grand Cru",Bordeaux,2003,01/06/2021,10060452003,1006045
8100,28/06/2021,8362,12,8100,0,262,21/06/2021,"Chateau Margaux Premier Cru Classe, Margaux",Bordeaux,2000,29/06/2021,10127812000,1012781
3300,31/05/2021,3421,11,3180,120,241,05/03/2021,"Chateau Angelus Premier Grand Cru Classe B, Saint-Emilion Grand Cru",Bordeaux,2003,01/06/2021,10060452003,1006045
1024,25/05/2021,1183,11,1072,-48,111,20/01/2021,"Tignanello, Toscana",Tuscany,2009,28/05/2021,10953912009,1095391
990,27/05/2021,1114,22,1000,-10,114,12/04/2021,"Chateau Calon Segur 3eme Cru Classe, Saint-Estephe",Bordeaux,2010,28/05/2021,10074752010,1007475
3900,27/05/2021,4717,77,3800,100,917,07/04/2021,"Chateau Margaux Premier Cru Classe, Margaux",Bordeaux,2006,28/05/2021,10127812006,1012781
1040,16/06/2021,1212,23,940,100,272,18/03/2021,"Chateau Calon Segur 3eme Cru Classe, Saint-Estephe",Bordeaux,2000,17/06/2021,10074752000,1007475
3758,27/05/2021,4011,98,3690,68,321,13/04/2021,"Chateau Margaux Premier Cru Classe, Margaux",Bordeaux,2011,28/05/2021,10127812011,1012781
10100,11/06/2021,11989,55,9800,300,2189,11/06/2021,"Chateau Margaux Premier Cru Classe, Margaux",Bordeaux,2015,17/06/2021,10127812015,1012781
3758,16/06/2021,4049,97,3690,68,359,13/04/2021,"Chateau Margaux Premier Cru Classe, Margaux",Bordeaux,2011,17/06/2021,10127812011,1012781
3720,21/06/2021,4294,136,3480,240,814,17/06/2021,"Chateau Margaux Premier Cru Classe, Margaux",Bordeaux,2014,22/06/2021,10127812014,1012781
1500,21/06/2021,1681,49,1408,92,273,09/04/2021,"Gaja, Barbaresco",Piedmont,2016,22/06/2021,10996052016,1099605
475,08/06/2021,533,26,388,87,145,29/09/2020,"Tua Rita, Giusto di Notri, Toscana",Tuscany,2015,22/06/2021,11058072015,1105807
3750,14/06/2021,4202,38,3560,190,642,20/11/2020,"Chateau Margaux Premier Cru Classe, Margaux",Bordeaux,2012,22/06/2021,10127812012,1012781
750,17/06/2021,921,19,745,5,176,16/11/2020,"Chateau Calon Segur 3eme Cru Classe, Saint-Estephe",Bordeaux,2004,22/06/2021,10074752004,1007475
3900,21/06/2021,4628,83,3822,78,806,20/06/2021,"Chateau Margaux Premier Cru Classe, Margaux",Bordeaux,2006,22/06/2021,10127812006,1012781
3826,27/05/2021,4507,62,4116,-290,391,25/02/2021,"Chateau Margaux Premier Cru Classe, Margaux",Bordeaux,2004,28/05/2021,10127812004,1012781
3300,28/05/2021,3421,11,3180,120,241,05/03/2021,"Chateau Angelus Premier Grand Cru Classe B, Saint-Emilion Grand Cru",Bordeaux,2003,29/05/2021,10060452003,1006045
3300,28/05/2021,3421,11,3180,120,241,05/03/2021,"Chateau Angelus Premier Grand Cru Classe B, Saint-Emilion Grand Cru",Bordeaux,2003,29/05/2021,10060452003,1006045
3740,27/05/2021,3970,42,3520,220,450,07/04/2021,"Chateau Margaux Premier Cru Classe, Margaux",Bordeaux,2013,28/05/2021,10127812013,1012781
907,21/05/2021,927,19,805,102,122,20/11/2019,"Chateau Calon Segur 3eme Cru Classe, Saint-Estephe",Bordeaux,2001,24/05/2021,10074752001,1007475
840,18/05/2021,1092,90,860,-20,232,19/04/2021,"Chateau Calon Segur 3eme Cru Classe, Saint-Estephe",Bordeaux,2015,24/05/2021,10074752015,1007475
6250,20/05/2021,7046,40,6300,-50,746,21/05/2021,"Chateau Margaux Premier Cru Classe, Margaux",Bordeaux,2005,24/05/2021,10127812005,1012781
1000,21/05/2021,1164,85,975,25,189,12/04/2021,"Chateau Calon Segur 3eme Cru Classe, Saint-Estephe",Bordeaux,2005,24/05/2021,10074752005,1007475
1000,21/05/2021,1158,42,1047,-47,111,27/04/2021,"Chateau Calon Segur 3eme Cru Classe, Saint-Estephe",Bordeaux,2009,24/05/2021,10074752009,1007475
3300,27/05/2021,3421,11,3180,120,241,05/03/2021,"Chateau Angelus Premier Grand Cru Classe B, Saint-Emilion Grand Cru",Bordeaux,2003,28/05/2021,10060452003,1006045
768,21/05/2021,927,12,705,63,222,01/02/2021,"Chateau Calon Segur 3eme Cru Classe, Saint-Estephe",Bordeaux,2002,24/05/2021,10074752002,1007475
950,18/05/2021,1101,41,830,120,271,18/04/2021,"Tignanello, Toscana",Tuscany,2014,24/05/2021,10953912014,1095391
8040,21/05/2021,8344,19,7950,90,394,12/03/2021,"Chateau Margaux Premier Cru Classe, Margaux",Bordeaux,2000,24/05/2021,10127812000,1012781
857,15/06/2021,913,141,828,29,85,21/06/2021,"Tignanello, Toscana",Tuscany,2017,22/06/2021,10953912017,1095391
589,18/05/2021,624,52,450,139,174,04/05/2021,"Chateau Batailley 5eme Cru Classe, Pauillac",Bordeaux,2005,19/05/2021,10063222005,1006322
3300,27/05/2021,3421,11,3180,120,241,05/03/2021,"Chateau Angelus Premier Grand Cru Classe B, Saint-Emilion Grand Cru",Bordeaux,2003,28/05/2021,10060452003,1006045
3720,21/05/2021,4099,52,3480,240,619,10/04/2021,"Chateau Margaux Premier Cru Classe, Margaux",Bordeaux,2014,24/05/2021,10127812014,1012781
6300,21/05/2021,7515,57,6190,110,1325,23/05/2021,"Chateau Margaux Premier Cru Classe, Margaux",Bordeaux,2010,24/05/2021,10127812010,1012781
3920,21/05/2021,4435,93,3800,120,635,12/05/2021,"Chateau Margaux Premier Cru Classe, Margaux",Bordeaux,2008,24/05/2021,10127812008,1012781
6650,20/05/2021,7643,42,6525,125,1118,23/05/2021,"Chateau Margaux Premier Cru Classe, Margaux",Bordeaux,2009,24/05/2021,10127812009,1012781
3300,26/05/2021,3421,11,3180,120,241,05/03/2021,"Chateau Angelus Premier Grand Cru Classe B, Saint-Emilion Grand Cru",Bordeaux,2003,27/05/2021,10060452003,1006045
3300,26/05/2021,3421,11,3180,120,241,05/03/2021,"Chateau Angelus Premier Grand Cru Classe B, Saint-Emilion Grand Cru",Bordeaux,2003,27/05/2021,10060452003,1006045
780,27/05/2021,842,12,682,98,160,15/09/2020,"Chateau Calon Segur 3eme Cru Classe, Saint-Estephe",Bordeaux,2013,28/05/2021,10074752013,1007475
3720,28/05/2021,4118,48,3480,240,638,10/04/2021,"Chateau Margaux Premier Cru Classe, Margaux",Bordeaux,2014,29/05/2021,10127812014,1012781
430,18/05/2021,557,10,400,30,157,11/05/2021,"Chateau Batailley 5eme Cru Classe, Pauillac",Bordeaux,2006,19/05/2021,10063222006,1006322
660,28/05/2021,724,4,390,270,334,18/08/2017,"Tua Rita, Giusto di Notri, Toscana",Tuscany,2006,29/05/2021,11058072006,1105807
3360,25/05/2021,3439,12,3180,180,259,05/03/2021,"Chateau Angelus Premier Grand Cru Classe B, Saint-Emilion Grand Cru",Bordeaux,2003,26/05/2021,10060452003,1006045
10500,21/05/2021,12496,70,9844,656,2652,29/03/2021,"Chateau Margaux Premier Cru Classe, Margaux",Bordeaux,2015,24/05/2021,10127812015,1012781
6250,16/06/2021,7421,48,6776,-526,645,10/06/2021,"Chateau Margaux Premier Cru Classe, Margaux",Bordeaux,2005,17/06/2021,10127812005,1012781
1000,16/06/2021,1147,82,988,12,159,28/05/2021,"Chateau Calon Segur 3eme Cru Classe, Saint-Estephe",Bordeaux,2005,17/06/2021,10074752005,1007475
3360,25/05/2021,3439,12,3180,180,259,05/03/2021,"Chateau Angelus Premier Grand Cru Classe B, Saint-Emilion Grand Cru",Bordeaux,2003,26/05/2021,10060452003,1006045
750,19/05/2021,1021,50,790,-40,231,01/06/2020,"Chateau Calon Segur 3eme Cru Classe, Saint-Estephe",Bordeaux,2011,24/05/2021,10074752011,1007475
1299,15/06/2021,1480,8,1010,289,470,18/12/2020,"Tignanello, Toscana",Tuscany,2008,17/06/2021,10953912008,1095391
3827,21/05/2021,4497,63,4116,-289,381,25/02/2021,"Chateau Margaux Premier Cru Classe, Margaux",Bordeaux,2004,24/05/2021,10127812004,1012781
3300,24/05/2021,3439,12,3180,120,259,05/03/2021,"Chateau Angelus Premier Grand Cru Classe B, Saint-Emilion Grand Cru",Bordeaux,2003,25/05/2021,10060452003,1006045
4400,21/05/2021,4831,24,4400,0,431,29/09/2020,"Chateau Margaux Premier Cru Classe, Margaux",Bordeaux,2001,24/05/2021,10127812001,1012781
8100,21/06/2021,8466,17,8100,0,366,21/06/2021,"Chateau Margaux Premier Cru Classe, Margaux",Bordeaux,2000,22/06/2021,10127812000,1012781
1516,22/06/2021,1565,174,1300,216,265,28/06/2021,"Gaja, Barbaresco",Piedmont,2017,29/06/2021,10996052017,1099605
1850,28/06/2021,1831,1,1180,670,651,10/03/2017,"Gaja, Barbaresco",Piedmont,2005,29/06/2021,10996052005,1099605
3300,24/05/2021,3439,12,3180,120,259,05/03/2021,"Chateau Angelus Premier Grand Cru Classe B, Saint-Emilion Grand Cru",Bordeaux,2003,25/05/2021,10060452003,1006045
3300,21/05/2021,3439,12,3180,120,259,05/03/2021,"Chateau Angelus Premier Grand Cru Classe B, Saint-Emilion Grand Cru",Bordeaux,2003,22/05/2021,10060452003,1006045
5290,28/06/2021,5097,7,4160,1130,937,19/03/2021,"Chateau Margaux Premier Cru Classe, Margaux",Bordeaux,2019,29/06/2021,10127812019,1012781
790,18/05/2021,973,21,745,45,228,16/11/2020,"Chateau Calon Segur 3eme Cru Classe, Saint-Estephe",Bordeaux,2004,24/05/2021,10074752004,1007475
4850,20/05/2021,5867,25,4842,8,1025,19/05/2021,"Chateau Margaux Premier Cru Classe, Margaux",Bordeaux,2003,24/05/2021,10127812003,1012781
1100,25/05/2021,1513,7,1010,90,503,18/12/2020,"Tignanello, Toscana",Tuscany,2008,26/05/2021,10953912008,1095391
4400,03/06/2021,4731,27,4400,0,331,29/09/2020,"Chateau Margaux Premier Cru Classe, Margaux",Bordeaux,2001,17/06/2021,10127812001,1012781
6300,16/06/2021,7464,63,6190,110,1274,23/05/2021,"Chateau Margaux Premier Cru Classe, Margaux",Bordeaux,2010,17/06/2021,10127812010,1012781
3900,16/06/2021,4428,110,3700,200,728,07/06/2021,"Chateau Margaux Premier Cru Classe, Margaux",Bordeaux,2008,17/06/2021,10127812008,1012781
1326,05/07/2021,1560,4,1170,156,390,24/06/2021,"Tignanello, Toscana",Tuscany,2010,06/07/2021,10953912010,1095391
3758,05/07/2021,4290,78,3690,68,600,13/04/2021,"Chateau Margaux Premier Cru Classe, Margaux",Bordeaux,2011,06/07/2021,10127812011,1012781
3300,21/05/2021,3439,12,3180,120,259,05/03/2021,"Chateau Angelus Premier Grand Cru Classe B, Saint-Emilion Grand Cru",Bordeaux,2003,22/05/2021,10060452003,1006045
430,18/05/2021,481,5,400,30,81,11/05/2021,"Chateau Batailley 5eme Cru Classe, Pauillac",Bordeaux,2006,30/05/2021,10063222006,1006322
2098,21/06/2021,2300,4,2190,-92,110,01/05/2021,"Gaja, Barbaresco",Piedmont,2004,22/06/2021,10996052004,1099605
1100,17/06/2021,1158,32,1030,70,128,25/05/2021,"Chateau Calon Segur 3eme Cru Classe, Saint-Estephe",Bordeaux,2009,22/06/2021,10074752009,1007475
1408,21/06/2021,1389,4,1238,170,151,02/11/2020,"Tignanello, Toscana",Tuscany,2006,22/06/2021,10953912006,1095391
1516,15/06/2021,1564,175,1358,158,206,12/05/2021,"Gaja, Barbaresco",Piedmont,2017,22/06/2021,10996052017,1099605
870,16/06/2021,945,10,705,165,240,01/02/2021,"Chateau Calon Segur 3eme Cru Classe, Saint-Estephe",Bordeaux,2002,17/06/2021,10074752002,1007475
3300,20/05/2021,3439,12,3180,120,259,05/03/2021,"Chateau Angelus Premier Grand Cru Classe B, Saint-Emilion Grand Cru",Bordeaux,2003,21/05/2021,10060452003,1006045
880,03/06/2021,1103,42,830,50,273,18/04/2021,"Tignanello, Toscana",Tuscany,2014,17/06/2021,10953912014,1095391
3900,16/06/2021,4616,93,3861,39,755,28/05/2021,"Chateau Margaux Premier Cru Classe, Margaux",Bordeaux,2006,17/06/2021,10127812006,1012781
3300,20/05/2021,3439,12,3180,120,259,05/03/2021,"Chateau Angelus Premier Grand Cru Classe B, Saint-Emilion Grand Cru",Bordeaux,2003,21/05/2021,10060452003,1006045
990,28/06/2021,1116,15,990,0,126,16/06/2021,"Chateau Calon Segur 3eme Cru Classe, Saint-Estephe",Bordeaux,2010,29/06/2021,10074752010,1007475
16200,28/06/2021,16040,0,18750,-2550,-2710,29/08/2018,"Jacques-Frederic Mugnier, Chambolle-Musigny Premier Cru, Les Amoureuses",Burgundy,2015,29/06/2021,10496422015,1049642
3740,16/06/2021,3977,53,3520,220,457,07/04/2021,"Chateau Margaux Premier Cru Classe, Margaux",Bordeaux,2013,17/06/2021,10127812013,1012781
6830,17/06/2021,7659,49,7086,-256,573,11/06/2021,"Chateau Margaux Premier Cru Classe, Margaux",Bordeaux,2009,18/06/2021,10127812009,1012781
3700,17/06/2021,4223,117,3646,54,577,16/06/2021,"Chateau Margaux Premier Cru Classe, Margaux",Bordeaux,2017,18/06/2021,10127812017,1012781
3300,19/05/2021,3439,12,3180,120,259,05/03/2021,"Chateau Angelus Premier Grand Cru Classe B, Saint-Emilion Grand Cru",Bordeaux,2003,20/05/2021,10060452003,1006045
8000,21/06/2021,8689,5,6974,1026,1715,14/03/2021,"Domaine Leflaive, Chevalier-Montrachet Grand Cru",Burgundy,2017,22/06/2021,10734012017,1073401
1320,28/06/2021,1467,3,1170,150,297,24/06/2021,"Tignanello, Toscana",Tuscany,2010,29/06/2021,10953912010,1095391
3300,19/05/2021,3439,12,3180,120,259,05/03/2021,"Chateau Angelus Premier Grand Cru Classe B, Saint-Emilion Grand Cru",Bordeaux,2003,20/05/2021,10060452003,1006045
2199,28/06/2021,2225,2,1340,859,885,13/03/2020,"Gaja, Barbaresco",Piedmont,2009,29/06/2021,10996052009,1099605
907,28/06/2021,966,18,805,102,161,20/11/2019,"Chateau Calon Segur 3eme Cru Classe, Saint-Estephe",Bordeaux,2001,29/06/2021,10074752001,1007475
3300,18/05/2021,3436,12,3180,120,256,05/03/2021,"Chateau Angelus Premier Grand Cru Classe B, Saint-Emilion Grand Cru",Bordeaux,2003,19/05/2021,10060452003,1006045
1000,28/06/2021,1157,92,988,12,169,28/05/2021,"Chateau Calon Segur 3eme Cru Classe, Saint-Estephe",Bordeaux,2005,29/06/2021,10074752005,1007475
3300,18/05/2021,3436,12,3180,120,256,05/03/2021,"Chateau Angelus Premier Grand Cru Classe B, Saint-Emilion Grand Cru",Bordeaux,2003,19/05/2021,10060452003,1006045
487,21/06/2021,535,24,388,99,147,29/09/2020,"Tua Rita, Giusto di Notri, Toscana",Tuscany,2015,29/06/2021,11058072015,1105807
686,28/06/2021,826,7,682,4,144,15/09/2020,"Chateau Calon Segur 3eme Cru Classe, Saint-Estephe",Bordeaux,2013,29/06/2021,10074752013,1007475
6830,11/06/2021,7692,49,7086,-256,606,11/06/2021,"Chateau Margaux Premier Cru Classe, Margaux",Bordeaux,2009,15/06/2021,10127812009,1012781
760,03/06/2021,922,109,740,20,182,21/05/2021,"Chateau Calon Segur 3eme Cru Classe, Saint-Estephe",Bordeaux,2017,15/06/2021,10074752017,1007475
3300,17/05/2021,3436,12,3180,120,256,05/03/2021,"Chateau Angelus Premier Grand Cru Classe B, Saint-Emilion Grand Cru",Bordeaux,2003,18/05/2021,10060452003,1006045
845,21/06/2021,940,23,805,40,135,20/11/2019,"Chateau Calon Segur 3eme Cru Classe, Saint-Estephe",Bordeaux,2001,22/06/2021,10074752001,1007475
460,21/06/2021,493,188,420,40,73,28/05/2021,"Tua Rita, Giusto di Notri, Toscana",Tuscany,2016,22/06/2021,11058072016,1105807
430,11/06/2021,467,101,380,50,87,25/03/2021,"Tua Rita, Giusto di Notri, Toscana",Tuscany,2018,22/06/2021,11058072018,1105807
3300,17/05/2021,3436,12,3180,120,256,05/03/2021,"Chateau Angelus Premier Grand Cru Classe B, Saint-Emilion Grand Cru",Bordeaux,2003,18/05/2021,10060452003,1006045
857,15/06/2021,950,145,844,13,106,25/06/2021,"Tignanello, Toscana",Tuscany,2017,29/06/2021,10953912017,1095391
950,28/06/2021,1272,13,850,100,422,28/01/2021,"Tignanello, Toscana",Tuscany,2012,29/06/2021,10953912012,1095391
6396,27/05/2021,7863,0,7900,-1504,-37,29/04/2019,"Domaine Leflaive, Chevalier-Montrachet Grand Cru",Burgundy,2015,29/06/2021,10734012015,1073401
3720,14/06/2021,4292,146,3480,240,812,10/04/2021,"Chateau Margaux Premier Cru Classe, Margaux",Bordeaux,2014,15/06/2021,10127812014,1012781
990,14/06/2021,1109,20,1000,-10,109,12/04/2021,"Chateau Calon Segur 3eme Cru Classe, Saint-Estephe",Bordeaux,2010,15/06/2021,10074752010,1007475
870,14/06/2021,948,10,705,165,243,01/02/2021,"Chateau Calon Segur 3eme Cru Classe, Saint-Estephe",Bordeaux,2002,15/06/2021,10074752002,1007475
3700,14/06/2021,4222,119,3660,40,562,02/06/2021,"Chateau Margaux Premier Cru Classe, Margaux",Bordeaux,2017,15/06/2021,10127812017,1012781
3300,14/05/2021,3436,12,3180,120,256,05/03/2021,"Chateau Angelus Premier Grand Cru Classe B, Saint-Emilion Grand Cru",Bordeaux,2003,16/05/2021,10060452003,1006045
880,14/06/2021,986,13,725,155,261,13/04/2021,"Chateau Calon Segur 3eme Cru Classe, Saint-Estephe",Bordeaux,2007,15/06/2021,10074752007,1007475
1350,14/06/2021,1445,7,1352,-2,93,23/09/2020,"Gaja, Barbaresco",Piedmont,2011,15/06/2021,10996052011,1099605
2098,28/06/2021,2300,4,2190,-92,110,01/05/2021,"Gaja, Barbaresco",Piedmont,2004,29/06/2021,10996052004,1099605
3300,14/05/2021,3436,12,3180,120,256,05/03/2021,"Chateau Angelus Premier Grand Cru Classe B, Saint-Emilion Grand Cru",Bordeaux,2003,16/05/2021,10060452003,1006045
4850,25/06/2021,5881,19,4650,200,1231,21/06/2021,"Chateau Margaux Premier Cru Classe, Margaux",Bordeaux,2003,29/06/2021,10127812003,1012781
430,18/05/2021,526,5,400,30,126,11/05/2021,"Chateau Batailley 5eme Cru Classe, Pauillac",Bordeaux,2006,01/06/2021,10063222006,1006322
880,21/06/2021,967,9,725,155,242,13/04/2021,"Chateau Calon Segur 3eme Cru Classe, Saint-Estephe",Bordeaux,2007,22/06/2021,10074752007,1007475
1300,21/06/2021,1443,7,1352,-52,91,23/09/2020,"Gaja, Barbaresco",Piedmont,2011,22/06/2021,10996052011,1099605
3225,12/05/2021,3463,10,3180,45,283,05/03/2021,"Chateau Angelus Premier Grand Cru Classe B, Saint-Emilion Grand Cru",Bordeaux,2003,13/05/2021,10060452003,1006045
1200,14/06/2021,1261,37,1050,150,211,10/06/2021,"Tignanello, Toscana",Tuscany,2016,15/06/2021,10953912016,1095391
430,18/05/2021,508,6,400,30,108,11/05/2021,"Chateau Batailley 5eme Cru Classe, Pauillac",Bordeaux,2006,26/05/2021,10063222006,1006322
3225,12/05/2021,3463,10,3180,45,283,05/03/2021,"Chateau Angelus Premier Grand Cru Classe B, Saint-Emilion Grand Cru",Bordeaux,2003,13/05/2021,10060452003,1006045
430,18/05/2021,526,5,400,30,126,11/05/2021,"Chateau Batailley 5eme Cru Classe, Pauillac",Bordeaux,2006,01/06/2021,10063222006,1006322
430,18/05/2021,481,5,400,30,81,11/05/2021,"Chateau Batailley 5eme Cru Classe, Pauillac",Bordeaux,2006,30/05/2021,10063222006,1006322
1592,22/06/2021,1566,15,1300,292,266,28/09/2020,"Gaja, Barbaresco",Piedmont,2014,29/06/2021,10996052014,1099605
900,28/06/2021,1055,23,800,100,255,21/11/2019,"Chateau Calon Segur 3eme Cru Classe, Saint-Estephe",Bordeaux,2003,29/06/2021,10074752003,1007475
3225,12/05/2021,3436,12,3180,45,256,05/03/2021,"Chateau Angelus Premier Grand Cru Classe B, Saint-Emilion Grand Cru",Bordeaux,2003,15/05/2021,10060452003,1006045
3750,14/06/2021,4206,41,3560,190,646,20/11/2020,"Chateau Margaux Premier Cru Classe, Margaux",Bordeaux,2012,15/06/2021,10127812012,1012781
860,09/06/2021,1027,72,916,-56,111,12/06/2021,"Tignanello, Toscana",Tuscany,2018,15/06/2021,10953912018,1095391
7800,03/06/2021,6896,2,7900,-100,-1004,29/04/2019,"Domaine Leflaive, Chevalier-Montrachet Grand Cru",Burgundy,2015,15/06/2021,10734012015,1073401
3225,12/05/2021,3436,12,3180,45,256,05/03/2021,"Chateau Angelus Premier Grand Cru Classe B, Saint-Emilion Grand Cru",Bordeaux,2003,15/05/2021,10060452003,1006045
1260,14/06/2021,1375,7,1172,88,203,07/04/2021,"Tignanello, Toscana",Tuscany,2010,15/06/2021,10953912010,1095391
460,14/06/2021,491,179,420,40,71,28/05/2021,"Tua Rita, Giusto di Notri, Toscana",Tuscany,2016,15/06/2021,11058072016,1105807
430,18/05/2021,557,10,400,30,157,11/05/2021,"Chateau Batailley 5eme Cru Classe, Pauillac",Bordeaux,2006,19/05/2021,10063222006,1006322
3225,10/05/2021,3463,10,3180,45,283,05/03/2021,"Chateau Angelus Premier Grand Cru Classe B, Saint-Emilion Grand Cru",Bordeaux,2003,12/05/2021,10060452003,1006045
3225,10/05/2021,3461,10,3180,45,281,05/03/2021,"Chateau Angelus Premier Grand Cru Classe B, Saint-Emilion Grand Cru",Bordeaux,2003,11/05/2021,10060452003,1006045
870,28/06/2021,954,4,705,165,249,01/02/2021,"Chateau Calon Segur 3eme Cru Classe, Saint-Estephe",Bordeaux,2002,29/06/2021,10074752002,1007475
430,18/05/2021,508,6,400,30,108,11/05/2021,"Chateau Batailley 5eme Cru Classe, Pauillac",Bordeaux,2006,26/05/2021,10063222006,1006322
3225,10/05/2021,3463,10,3180,45,283,05/03/2021,"Chateau Angelus Premier Grand Cru Classe B, Saint-Emilion Grand Cru",Bordeaux,2003,12/05/2021,10060452003,1006045
6300,14/06/2021,7464,63,6190,110,1274,23/05/2021,"Chateau Margaux Premier Cru Classe, Margaux",Bordeaux,2010,15/06/2021,10127812010,1012781
3225,10/05/2021,3461,10,3180,45,281,05/03/2021,"Chateau Angelus Premier Grand Cru Classe B, Saint-Emilion Grand Cru",Bordeaux,2003,11/05/2021,10060452003,1006045
450,18/05/2021,450,1,340,110,110,31/08/2018,"Chateau Batailley 5eme Cru Classe, Pauillac",Bordeaux,2007,19/05/2021,10063222007,1006322
400,18/05/2021,443,9,332,68,111,06/10/2020,"Chateau Batailley 5eme Cru Classe, Pauillac",Bordeaux,2008,19/05/2021,10063222008,1006322
7600,21/06/2021,7792,2,7124,476,668,15/02/2019,"Domaine Leflaive, Chevalier-Montrachet Grand Cru",Burgundy,2016,22/06/2021,10734012016,1073401
1550,21/06/2021,1557,1,1300,250,257,27/04/2021,"Gaja, Barbaresco",Piedmont,2012,22/06/2021,10996052012,1099605
7800,21/06/2021,8255,5,7330,470,925,02/06/2021,"Domaine Leflaive, Chevalier-Montrachet Grand Cru",Burgundy,2018,22/06/2021,10734012018,1073401
3200,07/05/2021,3418,8,3180,20,238,05/03/2021,"Chateau Angelus Premier Grand Cru Classe B, Saint-Emilion Grand Cru",Bordeaux,2003,08/05/2021,10060452003,1006045
3200,07/05/2021,3418,8,3180,20,238,05/03/2021,"Chateau Angelus Premier Grand Cru Classe B, Saint-Emilion Grand Cru",Bordeaux,2003,08/05/2021,10060452003,1006045
400,18/05/2021,431,9,332,68,99,06/10/2020,"Chateau Batailley 5eme Cru Classe, Pauillac",Bordeaux,2008,30/05/2021,10063222008,1006322
1326,30/06/2021,1560,4,1170,156,390,24/06/2021,"Tignanello, Toscana",Tuscany,2010,02/07/2021,10953912010,1095391
3758,01/07/2021,4002,59,3690,68,312,13/04/2021,"Chateau Margaux Premier Cru Classe, Margaux",Bordeaux,2011,02/07/2021,10127812011,1012781
3200,06/05/2021,3418,8,3180,20,238,05/03/2021,"Chateau Angelus Premier Grand Cru Classe B, Saint-Emilion Grand Cru",Bordeaux,2003,07/05/2021,10060452003,1006045
400,18/05/2021,452,10,332,68,120,06/10/2020,"Chateau Batailley 5eme Cru Classe, Pauillac",Bordeaux,2008,20/05/2021,10063222008,1006322
4386,02/06/2021,4731,27,4400,-14,331,29/09/2020,"Chateau Margaux Premier Cru Classe, Margaux",Bordeaux,2001,15/06/2021,10127812001,1012781
3200,06/05/2021,3418,8,3180,20,238,05/03/2021,"Chateau Angelus Premier Grand Cru Classe B, Saint-Emilion Grand Cru",Bordeaux,2003,07/05/2021,10060452003,1006045
1550,14/06/2021,1557,1,1300,250,257,27/04/2021,"Gaja, Barbaresco",Piedmont,2012,15/06/2021,10996052012,1099605
3200,05/05/2021,3420,8,3180,20,240,05/03/2021,"Chateau Angelus Premier Grand Cru Classe B, Saint-Emilion Grand Cru",Bordeaux,2003,06/05/2021,10060452003,1006045
1080,14/06/2021,1162,58,1036,44,126,27/05/2021,"Chateau Calon Segur 3eme Cru Classe, Saint-Estephe",Bordeaux,2016,15/06/2021,10074752016,1007475
490,18/05/2021,554,20,504,-14,50,06/04/2021,"Chateau Batailley 5eme Cru Classe, Pauillac",Bordeaux,2009,19/05/2021,10063222009,1006322
1310,21/06/2021,1403,4,1172,138,231,07/04/2021,"Tignanello, Toscana",Tuscany,2010,22/06/2021,10953912010,1095391
3200,05/05/2021,3420,8,3180,20,240,05/03/2021,"Chateau Angelus Premier Grand Cru Classe B, Saint-Emilion Grand Cru",Bordeaux,2003,06/05/2021,10060452003,1006045
5415,03/06/2021,5679,100,5238,177,441,17/05/2021,"Chateau Margaux Premier Cru Classe, Margaux",Bordeaux,2016,15/06/2021,10127812016,1012781
490,18/05/2021,554,20,504,-14,50,06/04/2021,"Chateau Batailley 5eme Cru Classe, Pauillac",Bordeaux,2009,19/05/2021,10063222009,1006322
1050,17/06/2021,1164,6,860,190,304,08/03/2021,"Tignanello, Toscana",Tuscany,2013,29/06/2021,10953912013,1095391
395,18/05/2021,463,9,355,40,108,15/04/2021,"Chateau Batailley 5eme Cru Classe, Pauillac",Bordeaux,2012,19/05/2021,10063222012,1006322
3200,04/05/2021,3452,9,3180,20,272,05/03/2021,"Chateau Angelus Premier Grand Cru Classe B, Saint-Emilion Grand Cru",Bordeaux,2003,05/05/2021,10060452003,1006045
840,09/08/2021,1050,21,745,95,305,16/11/2020,"Chateau Calon Segur 3eme Cru Classe, Saint-Estephe",Bordeaux,2004,10/08/2021,10074752004,1007475
3900,14/06/2021,4616,93,3861,39,755,28/05/2021,"Chateau Margaux Premier Cru Classe, Margaux",Bordeaux,2006,15/06/2021,10127812006,1012781
1350,14/06/2021,1474,61,1260,90,214,18/02/2021,"Gaja, Barbaresco",Piedmont,2015,15/06/2021,10996052015,1099605
395,18/05/2021,433,9,355,40,78,15/04/2021,"Chateau Batailley 5eme Cru Classe, Pauillac",Bordeaux,2012,30/05/2021,10063222012,1006322
3900,14/06/2021,4428,110,3700,200,728,07/06/2021,"Chateau Margaux Premier Cru Classe, Margaux",Bordeaux,2008,15/06/2021,10127812008,1012781
8000,14/06/2021,8639,6,6974,1026,1665,14/03/2021,"Domaine Leflaive, Chevalier-Montrachet Grand Cru",Burgundy,2017,15/06/2021,10734012017,1073401
7800,14/06/2021,8250,8,7330,470,920,02/06/2021,"Domaine Leflaive, Chevalier-Montrachet Grand Cru",Burgundy,2018,15/06/2021,10734012018,1073401
828,09/06/2021,946,154,800,28,146,05/06/2021,"Tignanello, Toscana",Tuscany,2017,15/06/2021,10953912017,1095391
3200,04/05/2021,3452,9,3180,20,272,05/03/2021,"Chateau Angelus Premier Grand Cru Classe B, Saint-Emilion Grand Cru",Bordeaux,2003,05/05/2021,10060452003,1006045
1300,11/06/2021,1353,4,1200,100,153,06/03/2021,"Tignanello, Toscana",Tuscany,2007,15/06/2021,10953912007,1095391
900,11/06/2021,1223,14,850,50,373,28/01/2021,"Tignanello, Toscana",Tuscany,2012,15/06/2021,10953912012,1095391
900,21/06/2021,1054,22,800,100,254,21/11/2019,"Chateau Calon Segur 3eme Cru Classe, Saint-Estephe",Bordeaux,2003,22/06/2021,10074752003,1007475
395,18/05/2021,461,10,355,40,106,15/04/2021,"Chateau Batailley 5eme Cru Classe, Pauillac",Bordeaux,2012,27/05/2021,10063222012,1006322
1408,15/06/2021,1436,1,1150,258,286,21/04/2019,"Tignanello, Toscana",Tuscany,2005,22/06/2021,10953912005,1095391
6450,21/06/2021,7504,51,6190,260,1314,23/05/2021,"Chateau Margaux Premier Cru Classe, Margaux",Bordeaux,2010,22/06/2021,10127812010,1012781
740,17/06/2021,994,35,790,-50,204,01/06/2020,"Chateau Calon Segur 3eme Cru Classe, Saint-Estephe",Bordeaux,2011,22/06/2021,10074752011,1007475
790,03/06/2021,946,26,745,45,201,16/11/2020,"Chateau Calon Segur 3eme Cru Classe, Saint-Estephe",Bordeaux,2004,12/06/2021,10074752004,1007475
3720,11/06/2021,4292,146,3480,240,812,10/04/2021,"Chateau Margaux Premier Cru Classe, Margaux",Bordeaux,2014,12/06/2021,10127812014,1012781
1050,11/06/2021,1212,23,940,110,272,18/03/2021,"Chateau Calon Segur 3eme Cru Classe, Saint-Estephe",Bordeaux,2000,12/06/2021,10074752000,1007475
750,11/06/2021,1002,51,790,-40,212,01/06/2020,"Chateau Calon Segur 3eme Cru Classe, Saint-Estephe",Bordeaux,2011,12/06/2021,10074752011,1007475
3740,07/07/2021,4000,49,3520,220,480,07/04/2021,"Chateau Margaux Premier Cru Classe, Margaux",Bordeaux,2013,08/07/2021,10127812013,1012781
3200,03/05/2021,3452,9,3180,20,272,05/03/2021,"Chateau Angelus Premier Grand Cru Classe B, Saint-Emilion Grand Cru",Bordeaux,2003,04/05/2021,10060452003,1006045
880,03/06/2021,935,18,781,99,154,16/11/2020,"Chateau Calon Segur 3eme Cru Classe, Saint-Estephe",Bordeaux,2008,04/06/2021,10074752008,1007475
790,11/06/2021,902,24,801,-11,101,31/05/2021,"Chateau Calon Segur 3eme Cru Classe, Saint-Estephe",Bordeaux,2014,12/06/2021,10074752014,1007475
519,11/06/2021,556,4,460,59,96,05/05/2020,"Tua Rita, Giusto di Notri, Toscana",Tuscany,2008,12/06/2021,11058072008,1105807
395,18/05/2021,461,10,355,40,106,15/04/2021,"Chateau Batailley 5eme Cru Classe, Pauillac",Bordeaux,2012,27/05/2021,10063222012,1006322
1310,11/06/2021,1375,6,1172,138,203,07/04/2021,"Tignanello, Toscana",Tuscany,2010,12/06/2021,10953912010,1095391
3700,11/06/2021,4220,119,3660,40,560,02/06/2021,"Chateau Margaux Premier Cru Classe, Margaux",Bordeaux,2017,12/06/2021,10127812017,1012781
1850,21/06/2021,1831,1,1180,670,651,10/03/2017,"Gaja, Barbaresco",Piedmont,2005,22/06/2021,10996052005,1099605
3200,03/05/2021,3452,9,3180,20,272,05/03/2021,"Chateau Angelus Premier Grand Cru Classe B, Saint-Emilion Grand Cru",Bordeaux,2003,04/05/2021,10060452003,1006045
2820,10/08/2021,2963,9,2378,442,585,14/07/2021,"Chateau Angelus Premier Grand Cru Classe B, Saint-Emilion Grand Cru",Bordeaux,2004,11/08/2021,10060452004,1006045
10500,02/06/2021,12604,57,9844,656,2760,29/03/2021,"Chateau Margaux Premier Cru Classe, Margaux",Bordeaux,2015,04/06/2021,10127812015,1012781
686,14/06/2021,838,12,682,4,156,15/09/2020,"Chateau Calon Segur 3eme Cru Classe, Saint-Estephe",Bordeaux,2013,15/06/2021,10074752013,1007475
2820,10/08/2021,2963,9,2378,442,585,14/07/2021,"Chateau Angelus Premier Grand Cru Classe B, Saint-Emilion Grand Cru",Bordeaux,2004,11/08/2021,10060452004,1006045
395,18/05/2021,433,9,355,40,78,15/04/2021,"Chateau Batailley 5eme Cru Classe, Pauillac",Bordeaux,2012,30/05/2021,10063222012,1006322
790,18/05/2021,979,21,745,45,234,16/11/2020,"Chateau Calon Segur 3eme Cru Classe, Saint-Estephe",Bordeaux,2004,25/05/2021,10074752004,1007475
1280,24/05/2021,1367,8,1172,108,195,07/04/2021,"Tignanello, Toscana",Tuscany,2010,25/05/2021,10953912010,1095391
395,18/05/2021,463,9,355,40,108,15/04/2021,"Chateau Batailley 5eme Cru Classe, Pauillac",Bordeaux,2012,19/05/2021,10063222012,1006322
2850,09/08/2021,2963,9,2378,472,585,14/07/2021,"Chateau Angelus Premier Grand Cru Classe B, Saint-Emilion Grand Cru",Bordeaux,2004,10/08/2021,10060452004,1006045
300,18/05/2021,301,110,304,-4,-3,10/01/2021,"Chateau Batailley 5eme Cru Classe, Pauillac",Bordeaux,2013,19/05/2021,10063222013,1006322
1000,11/06/2021,1145,83,988,12,157,28/05/2021,"Chateau Calon Segur 3eme Cru Classe, Saint-Estephe",Bordeaux,2005,12/06/2021,10074752005,1007475
1800,11/06/2021,1691,2,1440,360,251,04/01/2018,"Gaja, Barbaresco",Piedmont,2010,12/06/2021,10996052010,1099605
2850,09/08/2021,2963,9,2378,472,585,14/07/2021,"Chateau Angelus Premier Grand Cru Classe B, Saint-Emilion Grand Cru",Bordeaux,2004,10/08/2021,10060452004,1006045
1050,24/05/2021,1212,20,940,110,272,18/03/2021,"Chateau Calon Segur 3eme Cru Classe, Saint-Estephe",Bordeaux,2000,25/05/2021,10074752000,1007475
6300,24/05/2021,7525,57,6190,110,1335,23/05/2021,"Chateau Margaux Premier Cru Classe, Margaux",Bordeaux,2010,25/05/2021,10127812010,1012781
880,03/06/2021,986,13,725,155,261,13/04/2021,"Chateau Calon Segur 3eme Cru Classe, Saint-Estephe",Bordeaux,2007,04/06/2021,10074752007,1007475
789,03/06/2021,973,22,745,44,228,16/11/2020,"Chateau Calon Segur 3eme Cru Classe, Saint-Estephe",Bordeaux,2004,04/06/2021,10074752004,1007475
1000,31/05/2021,1160,41,1030,-30,130,25/05/2021,"Chateau Calon Segur 3eme Cru Classe, Saint-Estephe",Bordeaux,2009,01/06/2021,10074752009,1007475
496,18/05/2021,518,9,312,184,206,12/03/2021,"Chateau Batailley 5eme Cru Classe, Pauillac",Bordeaux,2015,19/05/2021,10063222015,1006322
990,31/05/2021,1153,97,988,2,165,28/05/2021,"Chateau Calon Segur 3eme Cru Classe, Saint-Estephe",Bordeaux,2005,01/06/2021,10074752005,1007475
2850,06/08/2021,2963,9,2378,472,585,14/07/2021,"Chateau Angelus Premier Grand Cru Classe B, Saint-Emilion Grand Cru",Bordeaux,2004,07/08/2021,10060452004,1006045
2850,06/08/2021,2963,9,2378,472,585,14/07/2021,"Chateau Angelus Premier Grand Cru Classe B, Saint-Emilion Grand Cru",Bordeaux,2004,07/08/2021,10060452004,1006045
496,18/05/2021,528,33,312,184,216,12/03/2021,"Chateau Batailley 5eme Cru Classe, Pauillac",Bordeaux,2015,31/05/2021,10063222015,1006322
1150,03/06/2021,1225,10,1202,-52,23,10/05/2021,"Tignanello, Toscana",Tuscany,2015,12/06/2021,10953912015,1095391
1080,11/06/2021,1162,58,1036,44,126,27/05/2021,"Chateau Calon Segur 3eme Cru Classe, Saint-Estephe",Bordeaux,2016,12/06/2021,10074752016,1007475
1000,10/06/2021,1057,8,860,140,197,08/03/2021,"Tignanello, Toscana",Tuscany,2011,12/06/2021,10953912011,1095391
950,11/06/2021,1020,53,863,87,157,10/05/2021,"Chateau Calon Segur 3eme Cru Classe, Saint-Estephe",Bordeaux,2006,12/06/2021,10074752006,1007475
496,18/05/2021,534,9,312,184,222,12/03/2021,"Chateau Batailley 5eme Cru Classe, Pauillac",Bordeaux,2015,20/05/2021,10063222015,1006322
2700,30/07/2021,2964,9,2378,322,586,14/07/2021,"Chateau Angelus Premier Grand Cru Classe B, Saint-Emilion Grand Cru",Bordeaux,2004,03/08/2021,10060452004,1006045
2700,30/07/2021,2970,9,2378,322,592,14/07/2021,"Chateau Angelus Premier Grand Cru Classe B, Saint-Emilion Grand Cru",Bordeaux,2004,31/07/2021,10060452004,1006045
1280,24/05/2021,1328,6,1200,80,128,06/03/2021,"Tignanello, Toscana",Tuscany,2007,25/05/2021,10953912007,1095391
3758,24/05/2021,4045,78,3690,68,355,13/04/2021,"Chateau Margaux Premier Cru Classe, Margaux",Bordeaux,2011,25/05/2021,10127812011,1012781
1700,24/05/2021,1666,4,1378,322,288,29/07/2020,"Tignanello, Toscana",Tuscany,2001,25/05/2021,10953912001,1095391
8100,11/06/2021,8469,19,7950,150,519,12/03/2021,"Chateau Margaux Premier Cru Classe, Margaux",Bordeaux,2000,15/06/2021,10127812000,1012781
790,27/05/2021,920,32,801,-11,119,31/05/2021,"Chateau Calon Segur 3eme Cru Classe, Saint-Estephe",Bordeaux,2014,04/06/2021,10074752014,1007475
950,03/06/2021,1006,62,863,87,143,10/05/2021,"Chateau Calon Segur 3eme Cru Classe, Saint-Estephe",Bordeaux,2006,04/06/2021,10074752006,1007475
496,18/05/2021,531,34,312,184,219,12/03/2021,"Chateau Batailley 5eme Cru Classe, Pauillac",Bordeaux,2015,29/05/2021,10063222015,1006322
2430,14/06/2021,3208,4,2220,210,988,14/06/2021,"Gaja, Barbaresco",Piedmont,2001,15/06/2021,10996052001,1099605
1390,09/06/2021,1424,10,1276,114,148,05/03/2021,"Gaja, Barbaresco",Piedmont,2013,15/06/2021,10996052013,1099605
3827,24/05/2021,4507,62,4116,-289,391,25/02/2021,"Chateau Margaux Premier Cru Classe, Margaux",Bordeaux,2004,25/05/2021,10127812004,1012781
870,03/06/2021,945,10,705,165,240,01/02/2021,"Chateau Calon Segur 3eme Cru Classe, Saint-Estephe",Bordeaux,2002,04/06/2021,10074752002,1007475
1050,01/06/2021,1209,24,940,110,269,18/03/2021,"Chateau Calon Segur 3eme Cru Classe, Saint-Estephe",Bordeaux,2000,04/06/2021,10074752000,1007475
1290,03/06/2021,1351,8,1172,118,179,07/04/2021,"Tignanello, Toscana",Tuscany,2010,04/06/2021,10953912010,1095391
408,18/05/2021,414,21,357,51,57,06/05/2021,"Chateau Batailley 5eme Cru Classe, Pauillac",Bordeaux,2018,19/05/2021,10063222018,1006322
3900,11/06/2021,4610,94,3861,39,749,28/05/2021,"Chateau Margaux Premier Cru Classe, Margaux",Bordeaux,2006,12/06/2021,10127812006,1012781
540,11/06/2021,544,1,544,-4,0,18/09/2020,"Tua Rita, Giusto di Notri, Toscana",Tuscany,2013,12/06/2021,11058072013,1105807
3750,24/05/2021,4162,46,3560,190,602,20/11/2020,"Chateau Margaux Premier Cru Classe, Margaux",Bordeaux,2012,25/05/2021,10127812012,1012781
3740,24/05/2021,3967,45,3520,220,447,07/04/2021,"Chateau Margaux Premier Cru Classe, Margaux",Bordeaux,2013,25/05/2021,10127812013,1012781
1678,27/05/2021,1663,4,1180,498,483,25/06/2020,"Tignanello, Toscana",Tuscany,2004,04/06/2021,10953912004,1095391
4386,02/06/2021,4774,27,4400,-14,374,29/09/2020,"Chateau Margaux Premier Cru Classe, Margaux",Bordeaux,2001,04/06/2021,10127812001,1012781
840,18/05/2021,1092,91,860,-20,232,19/04/2021,"Chateau Calon Segur 3eme Cru Classe, Saint-Estephe",Bordeaux,2015,25/05/2021,10074752015,1007475
6250,24/05/2021,7070,39,6360,-110,710,24/05/2021,"Chateau Margaux Premier Cru Classe, Margaux",Bordeaux,2005,25/05/2021,10127812005,1012781
7527,14/06/2021,9789,3,7290,237,2499,21/08/2020,"Domaine Denis Mortet, Chambertin Grand Cru",Burgundy,2017,15/06/2021,10490202017,1049020
950,14/06/2021,1020,53,863,87,157,10/05/2021,"Chateau Calon Segur 3eme Cru Classe, Saint-Estephe",Bordeaux,2006,15/06/2021,10074752006,1007475
5490,11/06/2021,5845,105,5254,236,591,26/05/2021,"Chateau Margaux Premier Cru Classe, Margaux",Bordeaux,2018,15/06/2021,10127812018,1012781
648,19/05/2021,680,8,470,178,210,29/03/2018,"Chateau Batailley 5eme Cru Classe, Pauillac",Bordeaux,2000,20/05/2021,10063222000,1006322
10446,31/05/2021,12579,63,9844,602,2735,29/03/2021,"Chateau Margaux Premier Cru Classe, Margaux",Bordeaux,2015,01/06/2021,10127812015,1012781
3758,31/05/2021,4049,98,3690,68,359,13/04/2021,"Chateau Margaux Premier Cru Classe, Margaux",Bordeaux,2011,01/06/2021,10127812011,1012781
10500,24/05/2021,12574,68,9844,656,2730,29/03/2021,"Chateau Margaux Premier Cru Classe, Margaux",Bordeaux,2015,25/05/2021,10127812015,1012781
6750,24/05/2021,7647,42,6525,225,1122,23/05/2021,"Chateau Margaux Premier Cru Classe, Margaux",Bordeaux,2009,25/05/2021,10127812009,1012781
990,03/06/2021,1113,22,1000,-10,113,12/04/2021,"Chateau Calon Segur 3eme Cru Classe, Saint-Estephe",Bordeaux,2010,04/06/2021,10074752010,1007475
900,02/06/2021,1091,31,800,100,291,21/11/2019,"Chateau Calon Segur 3eme Cru Classe, Saint-Estephe",Bordeaux,2003,04/06/2021,10074752003,1007475
995,24/05/2021,1115,22,1000,-5,115,12/04/2021,"Chateau Calon Segur 3eme Cru Classe, Saint-Estephe",Bordeaux,2010,25/05/2021,10074752010,1007475
950,24/05/2021,1003,61,863,87,140,10/05/2021,"Chateau Calon Segur 3eme Cru Classe, Saint-Estephe",Bordeaux,2006,25/05/2021,10074752006,1007475
2199,11/06/2021,2219,3,1340,859,879,13/03/2020,"Gaja, Barbaresco",Piedmont,2009,12/06/2021,10996052009,1099605
8100,11/06/2021,8471,19,7950,150,521,12/03/2021,"Chateau Margaux Premier Cru Classe, Margaux",Bordeaux,2000,12/06/2021,10127812000,1012781
648,19/05/2021,680,8,470,178,210,29/03/2018,"Chateau Batailley 5eme Cru Classe, Pauillac",Bordeaux,2000,20/05/2021,10063222000,1006322
1000,24/05/2021,1158,42,1047,-47,111,27/04/2021,"Chateau Calon Segur 3eme Cru Classe, Saint-Estephe",Bordeaux,2009,25/05/2021,10074752009,1007475
6750,03/06/2021,7631,44,6525,225,1106,23/05/2021,"Chateau Margaux Premier Cru Classe, Margaux",Bordeaux,2009,04/06/2021,10127812009,1012781
1000,03/06/2021,1152,99,988,12,164,28/05/2021,"Chateau Calon Segur 3eme Cru Classe, Saint-Estephe",Bordeaux,2005,04/06/2021,10074752005,1007475
3758,03/06/2021,4047,99,3690,68,357,13/04/2021,"Chateau Margaux Premier Cru Classe, Margaux",Bordeaux,2011,04/06/2021,10127812011,1012781
3920,24/05/2021,4435,93,3800,120,635,12/05/2021,"Chateau Margaux Premier Cru Classe, Margaux",Bordeaux,2008,25/05/2021,10127812008,1012781
900,21/05/2021,1240,13,850,50,390,28/01/2021,"Tignanello, Toscana",Tuscany,2012,25/05/2021,10953912012,1095391
6830,21/06/2021,7675,46,7086,-256,589,11/06/2021,"Chateau Margaux Premier Cru Classe, Margaux",Bordeaux,2009,22/06/2021,10127812009,1012781
2700,30/07/2021,2970,9,2378,322,592,14/07/2021,"Chateau Angelus Premier Grand Cru Classe B, Saint-Emilion Grand Cru",Bordeaux,2004,31/07/2021,10060452004,1006045
1299,11/06/2021,1564,15,1300,-1,264,28/09/2020,"Gaja, Barbaresco",Piedmont,2014,22/06/2021,10996052014,1099605
468,19/05/2021,582,2,465,3,117,04/05/2020,"Chateau Batailley 5eme Cru Classe, Pauillac",Bordeaux,2001,20/05/2021,10063222001,1006322
750,24/05/2021,1016,51,790,-40,226,01/06/2020,"Chateau Calon Segur 3eme Cru Classe, Saint-Estephe",Bordeaux,2011,25/05/2021,10074752011,1007475
1480,24/05/2021,1558,173,1358,122,200,12/05/2021,"Gaja, Barbaresco",Piedmont,2017,01/06/2021,10996052017,1099605
460,31/05/2021,492,182,420,40,72,28/05/2021,"Tua Rita, Giusto di Notri, Toscana",Tuscany,2016,01/06/2021,11058072016,1105807
3560,02/06/2021,4098,36,3592,-32,506,06/05/2021,"Chateau Margaux Premier Cru Classe, Margaux",Bordeaux,2007,04/06/2021,10127812007,1012781
3560,19/05/2021,4099,30,3592,-32,507,06/05/2021,"Chateau Margaux Premier Cru Classe, Margaux",Bordeaux,2007,25/05/2021,10127812007,1012781
2700,30/07/2021,2963,9,2378,322,585,14/07/2021,"Chateau Angelus Premier Grand Cru Classe B, Saint-Emilion Grand Cru",Bordeaux,2004,04/08/2021,10060452004,1006045
2700,30/07/2021,2963,9,2378,322,585,14/07/2021,"Chateau Angelus Premier Grand Cru Classe B, Saint-Emilion Grand Cru",Bordeaux,2004,03/08/2021,10060452004,1006045
3900,19/05/2021,4517,30,3684,216,833,10/06/2020,"Chateau Margaux Premier Cru Classe, Margaux",Bordeaux,2002,25/05/2021,10127812002,1012781
1020,24/05/2021,1048,10,860,160,188,08/03/2021,"Tignanello, Toscana",Tuscany,2011,25/05/2021,10953912011,1095391
880,24/05/2021,986,13,725,155,261,13/04/2021,"Chateau Calon Segur 3eme Cru Classe, Saint-Estephe",Bordeaux,2007,25/05/2021,10074752007,1007475
412,19/05/2021,437,2,220,192,217,17/06/2015,"Chateau Batailley 5eme Cru Classe, Pauillac",Bordeaux,2002,20/05/2021,10063222002,1006322
1100,24/05/2021,1513,7,1010,90,503,18/12/2020,"Tignanello, Toscana",Tuscany,2008,25/05/2021,10953912008,1095391
963,24/05/2021,1156,96,975,-12,181,12/04/2021,"Chateau Calon Segur 3eme Cru Classe, Saint-Estephe",Bordeaux,2005,25/05/2021,10074752005,1007475
8040,24/05/2021,8359,18,7950,90,409,12/03/2021,"Chateau Margaux Premier Cru Classe, Margaux",Bordeaux,2000,25/05/2021,10127812000,1012781
530,19/05/2021,674,91,450,80,224,04/05/2021,"Chateau Batailley 5eme Cru Classe, Pauillac",Bordeaux,2005,22/05/2021,10063222005,1006322
900,28/05/2021,1239,13,850,50,389,28/01/2021,"Tignanello, Toscana",Tuscany,2012,01/06/2021,10953912012,1095391
3694,31/05/2021,4073,138,3700,-6,373,06/05/2021,"Chateau Margaux Premier Cru Classe, Margaux",Bordeaux,2017,01/06/2021,10127812017,1012781
16200,31/05/2021,16577,0,18750,-2550,-2173,29/08/2018,"Jacques-Frederic Mugnier, Chambolle-Musigny Premier Cru, Les Amoureuses",Burgundy,2015,01/06/2021,10496422015,1049642
2700,30/07/2021,2964,9,2378,322,586,14/07/2021,"Chateau Angelus Premier Grand Cru Classe B, Saint-Emilion Grand Cru",Bordeaux,2004,03/08/2021,10060452004,1006045
530,19/05/2021,674,93,450,80,224,04/05/2021,"Chateau Batailley 5eme Cru Classe, Pauillac",Bordeaux,2005,25/05/2021,10063222005,1006322
2700,30/07/2021,2973,9,2378,322,595,14/07/2021,"Chateau Angelus Premier Grand Cru Classe B, Saint-Emilion Grand Cru",Bordeaux,2004,02/08/2021,10060452004,1006045
2232,24/05/2021,2351,5,2190,42,161,01/05/2021,"Gaja, Barbaresco",Piedmont,2004,25/05/2021,10996052004,1099605
2872,31/05/2021,2872,1,2554,318,318,22/05/2020,"Gaja, Barbaresco",Piedmont,2006,01/06/2021,10996052006,1099605
9600,27/05/2021,9847,2,8000,1600,1847,30/01/2020,"Domaine Leflaive, Chevalier-Montrachet Grand Cru",Burgundy,2014,01/06/2021,10734012014,1073401
2700,30/07/2021,2973,9,2378,322,595,14/07/2021,"Chateau Angelus Premier Grand Cru Classe B, Saint-Emilion Grand Cru",Bordeaux,2004,02/08/2021,10060452004,1006045
3720,24/05/2021,4108,42,3480,240,628,10/04/2021,"Chateau Margaux Premier Cru Classe, Margaux",Bordeaux,2014,25/05/2021,10127812014,1012781
1408,20/05/2021,1409,5,1238,170,171,02/11/2020,"Tignanello, Toscana",Tuscany,2006,25/05/2021,10953912006,1095391
3900,03/06/2021,4690,79,3861,39,829,28/05/2021,"Chateau Margaux Premier Cru Classe, Margaux",Bordeaux,2006,04/06/2021,10127812006,1012781
2795,28/07/2021,3007,9,2378,417,629,14/07/2021,"Chateau Angelus Premier Grand Cru Classe B, Saint-Emilion Grand Cru",Bordeaux,2004,29/07/2021,10060452004,1006045
2795,28/07/2021,3007,9,2378,417,629,14/07/2021,"Chateau Angelus Premier Grand Cru Classe B, Saint-Emilion Grand Cru",Bordeaux,2004,29/07/2021,10060452004,1006045
2795,27/07/2021,3007,9,2378,417,629,14/07/2021,"Chateau Angelus Premier Grand Cru Classe B, Saint-Emilion Grand Cru",Bordeaux,2004,28/07/2021,10060452004,1006045
530,19/05/2021,673,92,450,80,223,04/05/2021,"Chateau Batailley 5eme Cru Classe, Pauillac",Bordeaux,2005,20/05/2021,10063222005,1006322
5490,11/06/2021,5829,104,5254,236,575,26/05/2021,"Chateau Margaux Premier Cru Classe, Margaux",Bordeaux,2018,12/06/2021,10127812018,1012781
907,24/05/2021,927,19,805,102,122,20/11/2019,"Chateau Calon Segur 3eme Cru Classe, Saint-Estephe",Bordeaux,2001,25/05/2021,10074752001,1007475
2795,27/07/2021,3007,9,2378,417,629,14/07/2021,"Chateau Angelus Premier Grand Cru Classe B, Saint-Emilion Grand Cru",Bordeaux,2004,28/07/2021,10060452004,1006045
3750,24/05/2021,4149,42,3560,190,589,20/11/2020,"Chateau Margaux Premier Cru Classe, Margaux",Bordeaux,2012,04/06/2021,10127812012,1012781
2795,26/07/2021,3007,9,2378,417,629,14/07/2021,"Chateau Angelus Premier Grand Cru Classe B, Saint-Emilion Grand Cru",Bordeaux,2004,27/07/2021,10060452004,1006045
2795,26/07/2021,3007,9,2378,417,629,14/07/2021,"Chateau Angelus Premier Grand Cru Classe B, Saint-Emilion Grand Cru",Bordeaux,2004,27/07/2021,10060452004,1006045
530,19/05/2021,673,92,450,80,223,04/05/2021,"Chateau Batailley 5eme Cru Classe, Pauillac",Bordeaux,2005,20/05/2021,10063222005,1006322
1200,31/05/2021,1261,37,1124,76,137,19/05/2021,"Tignanello, Toscana",Tuscany,2016,01/06/2021,10953912016,1095391
2795,23/07/2021,3007,9,2378,417,629,14/07/2021,"Chateau Angelus Premier Grand Cru Classe B, Saint-Emilion Grand Cru",Bordeaux,2004,24/07/2021,10060452004,1006045
530,19/05/2021,674,91,450,80,224,04/05/2021,"Chateau Batailley 5eme Cru Classe, Pauillac",Bordeaux,2005,22/05/2021,10063222005,1006322
2795,23/07/2021,3007,9,2378,417,629,14/07/2021,"Chateau Angelus Premier Grand Cru Classe B, Saint-Emilion Grand Cru",Bordeaux,2004,24/07/2021,10060452004,1006045
2795,22/07/2021,3007,9,2378,417,629,14/07/2021,"Chateau Angelus Premier Grand Cru Classe B, Saint-Emilion Grand Cru",Bordeaux,2004,23/07/2021,10060452004,1006045
1050,24/05/2021,1137,7,860,190,277,08/03/2021,"Tignanello, Toscana",Tuscany,2013,25/05/2021,10953912013,1095391
4400,24/05/2021,4862,22,4400,0,462,29/09/2020,"Chateau Margaux Premier Cru Classe, Margaux",Bordeaux,2001,25/05/2021,10127812001,1012781
2795,22/07/2021,3007,9,2378,417,629,14/07/2021,"Chateau Angelus Premier Grand Cru Classe B, Saint-Emilion Grand Cru",Bordeaux,2004,23/07/2021,10060452004,1006045
1800,14/06/2021,1815,3,1300,500,515,30/05/2019,"Gaja, Barbaresco",Piedmont,2007,15/06/2021,10996052007,1099605
2795,21/07/2021,3007,9,2378,417,629,14/07/2021,"Chateau Angelus Premier Grand Cru Classe B, Saint-Emilion Grand Cru",Bordeaux,2004,22/07/2021,10060452004,1006045
3740,14/06/2021,3977,53,3520,220,457,07/04/2021,"Chateau Margaux Premier Cru Classe, Margaux",Bordeaux,2013,15/06/2021,10127812013,1012781
900,28/05/2021,1245,13,850,50,395,28/01/2021,"Tignanello, Toscana",Tuscany,2012,04/06/2021,10953912012,1095391
1024,02/06/2021,1201,9,1072,-48,129,20/01/2021,"Tignanello, Toscana",Tuscany,2009,04/06/2021,10953912009,1095391
880,03/06/2021,1107,40,830,50,277,18/04/2021,"Tignanello, Toscana",Tuscany,2014,04/06/2021,10953912014,1095391
1020,03/06/2021,1049,9,860,160,189,08/03/2021,"Tignanello, Toscana",Tuscany,2011,04/06/2021,10953912011,1095391
530,19/05/2021,674,93,450,80,224,04/05/2021,"Chateau Batailley 5eme Cru Classe, Pauillac",Bordeaux,2005,25/05/2021,10063222005,1006322
8040,31/05/2021,8487,22,7950,90,537,12/03/2021,"Chateau Margaux Premier Cru Classe, Margaux",Bordeaux,2000,01/06/2021,10127812000,1012781
3750,24/05/2021,4135,37,3560,190,575,20/11/2020,"Chateau Margaux Premier Cru Classe, Margaux",Bordeaux,2012,01/06/2021,10127812012,1012781
5300,31/05/2021,5657,67,5238,62,419,17/05/2021,"Chateau Margaux Premier Cru Classe, Margaux",Bordeaux,2016,01/06/2021,10127812016,1012781
6557,31/05/2021,6557,0,3920,2637,2637,26/04/2017,"Domaine Leflaive, Chevalier-Montrachet Grand Cru",Burgundy,2006,01/06/2021,10734012006,1073401
2795,21/07/2021,3007,9,2378,417,629,14/07/2021,"Chateau Angelus Premier Grand Cru Classe B, Saint-Emilion Grand Cru",Bordeaux,2004,22/07/2021,10060452004,1006045
2795,20/07/2021,3007,9,2378,417,629,14/07/2021,"Chateau Angelus Premier Grand Cru Classe B, Saint-Emilion Grand Cru",Bordeaux,2004,21/07/2021,10060452004,1006045
3740,11/06/2021,3977,53,3520,220,457,07/04/2021,"Chateau Margaux Premier Cru Classe, Margaux",Bordeaux,2013,12/06/2021,10127812013,1012781
1800,11/06/2021,1717,2,1440,360,277,04/01/2018,"Gaja, Barbaresco",Piedmont,2010,15/06/2021,10996052010,1099605
660,14/06/2021,726,5,390,270,336,18/08/2017,"Tua Rita, Giusto di Notri, Toscana",Tuscany,2006,15/06/2021,11058072006,1105807
420,19/05/2021,555,10,400,20,155,11/05/2021,"Chateau Batailley 5eme Cru Classe, Pauillac",Bordeaux,2006,22/05/2021,10063222006,1006322
1516,08/06/2021,1559,177,1358,158,201,12/05/2021,"Gaja, Barbaresco",Piedmont,2017,15/06/2021,10996052017,1099605
6557,14/06/2021,6557,0,3920,2637,2637,26/04/2017,"Domaine Leflaive, Chevalier-Montrachet Grand Cru",Burgundy,2006,15/06/2021,10734012006,1073401
660,11/06/2021,726,5,390,270,336,18/08/2017,"Tua Rita, Giusto di Notri, Toscana",Tuscany,2006,12/06/2021,11058072006,1105807
5000,11/06/2021,5058,6,4160,840,898,19/03/2021,"Chateau Margaux Premier Cru Classe, Margaux",Bordeaux,2019,12/06/2021,10127812019,1012781
2795,20/07/2021,3007,9,2378,417,629,14/07/2021,"Chateau Angelus Premier Grand Cru Classe B, Saint-Emilion Grand Cru",Bordeaux,2004,21/07/2021,10060452004,1006045
790,03/06/2021,1093,89,860,-70,233,19/04/2021,"Chateau Calon Segur 3eme Cru Classe, Saint-Estephe",Bordeaux,2015,04/06/2021,10074752015,1007475
6250,31/05/2021,7279,55,6360,-110,919,24/05/2021,"Chateau Margaux Premier Cru Classe, Margaux",Bordeaux,2005,04/06/2021,10127812005,1012781
6300,03/06/2021,7467,62,6190,110,1277,23/05/2021,"Chateau Margaux Premier Cru Classe, Margaux",Bordeaux,2010,04/06/2021,10127812010,1012781
3720,03/06/2021,4216,86,3480,240,736,10/04/2021,"Chateau Margaux Premier Cru Classe, Margaux",Bordeaux,2014,04/06/2021,10127812014,1012781
460,11/06/2021,491,179,420,40,71,28/05/2021,"Tua Rita, Giusto di Notri, Toscana",Tuscany,2016,12/06/2021,11058072016,1105807
1300,11/06/2021,1333,5,1200,100,133,06/03/2021,"Tignanello, Toscana",Tuscany,2007,12/06/2021,10953912007,1095391
2795,19/07/2021,3007,9,2378,417,629,14/07/2021,"Chateau Angelus Premier Grand Cru Classe B, Saint-Emilion Grand Cru",Bordeaux,2004,20/07/2021,10060452004,1006045
1350,11/06/2021,1445,7,1352,-2,93,23/09/2020,"Gaja, Barbaresco",Piedmont,2011,12/06/2021,10996052011,1099605
2795,19/07/2021,3007,9,2378,417,629,14/07/2021,"Chateau Angelus Premier Grand Cru Classe B, Saint-Emilion Grand Cru",Bordeaux,2004,20/07/2021,10060452004,1006045
8040,03/06/2021,8513,22,7950,90,563,12/03/2021,"Chateau Margaux Premier Cru Classe, Margaux",Bordeaux,2000,04/06/2021,10127812000,1012781
1009,31/05/2021,1048,9,860,149,188,08/03/2021,"Tignanello, Toscana",Tuscany,2011,01/06/2021,10953912011,1095391
780,31/05/2021,842,12,682,98,160,15/09/2020,"Chateau Calon Segur 3eme Cru Classe, Saint-Estephe",Bordeaux,2013,01/06/2021,10074752013,1007475
7800,31/05/2021,8198,8,7000,800,1198,26/04/2021,"Domaine Leflaive, Chevalier-Montrachet Grand Cru",Burgundy,2018,01/06/2021,10734012018,1073401
420,19/05/2021,550,11,400,20,150,11/05/2021,"Chateau Batailley 5eme Cru Classe, Pauillac",Bordeaux,2006,20/05/2021,10063222006,1006322
420,19/05/2021,550,11,400,20,150,11/05/2021,"Chateau Batailley 5eme Cru Classe, Pauillac",Bordeaux,2006,20/05/2021,10063222006,1006322
420,19/05/2021,555,10,400,20,155,11/05/2021,"Chateau Batailley 5eme Cru Classe, Pauillac",Bordeaux,2006,22/05/2021,10063222006,1006322
1024,31/05/2021,1198,10,1072,-48,126,20/01/2021,"Tignanello, Toscana",Tuscany,2009,01/06/2021,10953912009,1095391
3900,03/06/2021,4425,92,3800,100,625,12/05/2021,"Chateau Margaux Premier Cru Classe, Margaux",Bordeaux,2008,04/06/2021,10127812008,1012781
2795,16/07/2021,3109,11,2378,417,731,14/07/2021,"Chateau Angelus Premier Grand Cru Classe B, Saint-Emilion Grand Cru",Bordeaux,2004,18/07/2021,10060452004,1006045
900,11/06/2021,1212,15,850,50,362,28/01/2021,"Tignanello, Toscana",Tuscany,2012,12/06/2021,10953912012,1095391
3826,11/06/2021,4525,55,4116,-290,409,25/02/2021,"Chateau Margaux Premier Cru Classe, Margaux",Bordeaux,2004,12/06/2021,10127812004,1012781
9600,11/06/2021,9798,2,8000,1600,1798,30/01/2020,"Domaine Leflaive, Chevalier-Montrachet Grand Cru",Burgundy,2014,12/06/2021,10734012014,1073401
2795,16/07/2021,3109,11,2378,417,731,14/07/2021,"Chateau Angelus Premier Grand Cru Classe B, Saint-Emilion Grand Cru",Bordeaux,2004,18/07/2021,10060452004,1006045
2650,14/07/2021,3109,11,2378,272,731,14/07/2021,"Chateau Angelus Premier Grand Cru Classe B, Saint-Emilion Grand Cru",Bordeaux,2004,15/07/2021,10060452004,1006045
3826,31/05/2021,4532,59,4116,-290,416,25/02/2021,"Chateau Margaux Premier Cru Classe, Margaux",Bordeaux,2004,01/06/2021,10127812004,1012781
9600,14/06/2021,9798,2,8000,1600,1798,30/01/2020,"Domaine Leflaive, Chevalier-Montrachet Grand Cru",Burgundy,2014,15/06/2021,10734012014,1073401
3560,09/06/2021,4071,32,3592,-32,479,06/05/2021,"Chateau Margaux Premier Cru Classe, Margaux",Bordeaux,2007,15/06/2021,10127812007,1012781
450,19/05/2021,450,1,340,110,110,31/08/2018,"Chateau Batailley 5eme Cru Classe, Pauillac",Bordeaux,2007,20/05/2021,10063222007,1006322
2650,14/07/2021,3109,11,2378,272,731,14/07/2021,"Chateau Angelus Premier Grand Cru Classe B, Saint-Emilion Grand Cru",Bordeaux,2004,15/07/2021,10060452004,1006045
960,31/05/2021,1110,40,830,130,280,18/04/2021,"Tignanello, Toscana",Tuscany,2014,02/06/2021,10953912014,1095391
2795,13/07/2021,3130,11,2680,115,450,04/01/2021,"Chateau Angelus Premier Grand Cru Classe B, Saint-Emilion Grand Cru",Bordeaux,2004,14/07/2021,10060452004,1006045
6291,31/05/2021,7448,58,6190,101,1258,23/05/2021,"Chateau Margaux Premier Cru Classe, Margaux",Bordeaux,2010,02/06/2021,10127812010,1012781
1000,31/05/2021,1161,41,1030,-30,131,25/05/2021,"Chateau Calon Segur 3eme Cru Classe, Saint-Estephe",Bordeaux,2009,02/06/2021,10074752009,1007475
750,31/05/2021,1016,51,790,-40,226,01/06/2020,"Chateau Calon Segur 3eme Cru Classe, Saint-Estephe",Bordeaux,2011,01/06/2021,10074752011,1007475
3720,31/05/2021,4215,86,3480,240,735,10/04/2021,"Chateau Margaux Premier Cru Classe, Margaux",Bordeaux,2014,01/06/2021,10127812014,1012781
950,31/05/2021,1003,59,863,87,140,10/05/2021,"Chateau Calon Segur 3eme Cru Classe, Saint-Estephe",Bordeaux,2006,01/06/2021,10074752006,1007475
1050,01/06/2021,1208,22,940,110,268,18/03/2021,"Chateau Calon Segur 3eme Cru Classe, Saint-Estephe",Bordeaux,2000,02/06/2021,10074752000,1007475
4400,01/06/2021,4852,22,4400,0,452,29/09/2020,"Chateau Margaux Premier Cru Classe, Margaux",Bordeaux,2001,02/06/2021,10127812001,1012781
990,01/06/2021,1113,22,1000,-10,113,12/04/2021,"Chateau Calon Segur 3eme Cru Classe, Saint-Estephe",Bordeaux,2010,02/06/2021,10074752010,1007475
952,26/05/2021,958,6,735,217,223,09/09/2020,"Chateau Calon Segur 3eme Cru Classe, Saint-Estephe",Bordeaux,2012,02/06/2021,10074752012,1007475
2795,13/07/2021,3130,11,2680,115,450,04/01/2021,"Chateau Angelus Premier Grand Cru Classe B, Saint-Emilion Grand Cru",Bordeaux,2004,14/07/2021,10060452004,1006045
3740,03/06/2021,3986,53,3520,220,466,07/04/2021,"Chateau Margaux Premier Cru Classe, Margaux",Bordeaux,2013,04/06/2021,10127812013,1012781
6300,11/06/2021,7477,63,6190,110,1287,23/05/2021,"Chateau Margaux Premier Cru Classe, Margaux",Bordeaux,2010,12/06/2021,10127812010,1012781
490,19/05/2021,585,28,504,-14,81,06/04/2021,"Chateau Batailley 5eme Cru Classe, Pauillac",Bordeaux,2009,20/05/2021,10063222009,1006322
830,03/06/2021,958,6,735,95,223,09/09/2020,"Chateau Calon Segur 3eme Cru Classe, Saint-Estephe",Bordeaux,2012,04/06/2021,10074752012,1007475
3826,03/06/2021,4532,59,4116,-290,416,25/02/2021,"Chateau Margaux Premier Cru Classe, Margaux",Bordeaux,2004,04/06/2021,10127812004,1012781
907,02/06/2021,958,23,805,102,153,20/11/2019,"Chateau Calon Segur 3eme Cru Classe, Saint-Estephe",Bordeaux,2001,04/06/2021,10074752001,1007475
900,31/05/2021,1093,30,800,100,293,21/11/2019,"Chateau Calon Segur 3eme Cru Classe, Saint-Estephe",Bordeaux,2003,02/06/2021,10074752003,1007475
2795,12/07/2021,3130,11,2680,115,450,04/01/2021,"Chateau Angelus Premier Grand Cru Classe B, Saint-Emilion Grand Cru",Bordeaux,2004,13/07/2021,10060452004,1006045
1000,03/06/2021,1161,43,1030,-30,131,25/05/2021,"Chateau Calon Segur 3eme Cru Classe, Saint-Estephe",Bordeaux,2009,04/06/2021,10074752009,1007475
2795,12/07/2021,3130,11,2680,115,450,04/01/2021,"Chateau Angelus Premier Grand Cru Classe B, Saint-Emilion Grand Cru",Bordeaux,2004,13/07/2021,10060452004,1006045
4850,27/05/2021,5671,34,4842,8,829,19/05/2021,"Chateau Margaux Premier Cru Classe, Margaux",Bordeaux,2003,02/06/2021,10127812003,1012781
3758,01/06/2021,4047,98,3690,68,357,13/04/2021,"Chateau Margaux Premier Cru Classe, Margaux",Bordeaux,2011,02/06/2021,10127812011,1012781
8040,01/06/2021,8497,22,7950,90,547,12/03/2021,"Chateau Margaux Premier Cru Classe, Margaux",Bordeaux,2000,02/06/2021,10127812000,1012781
3900,01/06/2021,4425,90,3800,100,625,12/05/2021,"Chateau Margaux Premier Cru Classe, Margaux",Bordeaux,2008,02/06/2021,10127812008,1012781
490,19/05/2021,585,28,504,-14,81,06/04/2021,"Chateau Batailley 5eme Cru Classe, Pauillac",Bordeaux,2009,20/05/2021,10063222009,1006322
300,19/05/2021,301,110,304,-4,-3,10/01/2021,"Chateau Batailley 5eme Cru Classe, Pauillac",Bordeaux,2013,20/05/2021,10063222013,1006322
3900,31/05/2021,4508,29,3684,216,824,10/06/2020,"Chateau Margaux Premier Cru Classe, Margaux",Bordeaux,2002,01/06/2021,10127812002,1012781
789,31/05/2021,976,21,745,44,231,16/11/2020,"Chateau Calon Segur 3eme Cru Classe, Saint-Estephe",Bordeaux,2004,01/06/2021,10074752004,1007475
2795,09/07/2021,3130,11,2680,115,450,04/01/2021,"Chateau Angelus Premier Grand Cru Classe B, Saint-Emilion Grand Cru",Bordeaux,2004,10/07/2021,10060452004,1006045
1000,11/06/2021,1169,44,1030,-30,139,25/05/2021,"Chateau Calon Segur 3eme Cru Classe, Saint-Estephe",Bordeaux,2009,12/06/2021,10074752009,1007475
1700,11/06/2021,1658,4,1378,322,280,29/07/2020,"Tignanello, Toscana",Tuscany,2001,12/06/2021,10953912001,1095391
2795,09/07/2021,3130,11,2680,115,450,04/01/2021,"Chateau Angelus Premier Grand Cru Classe B, Saint-Emilion Grand Cru",Bordeaux,2004,10/07/2021,10060452004,1006045
1029,31/05/2021,1160,6,860,169,300,08/03/2021,"Tignanello, Toscana",Tuscany,2013,02/06/2021,10953912013,1095391
3740,01/06/2021,3991,52,3520,220,471,07/04/2021,"Chateau Margaux Premier Cru Classe, Margaux",Bordeaux,2013,02/06/2021,10127812013,1012781
2232,01/06/2021,2358,5,2190,42,168,01/05/2021,"Gaja, Barbaresco",Piedmont,2004,02/06/2021,10996052004,1099605
1700,03/06/2021,1658,4,1378,322,280,29/07/2020,"Tignanello, Toscana",Tuscany,2001,04/06/2021,10953912001,1095391
6250,31/05/2021,7283,54,6360,-110,923,24/05/2021,"Chateau Margaux Premier Cru Classe, Margaux",Bordeaux,2005,02/06/2021,10127812005,1012781
408,19/05/2021,414,21,357,51,57,06/05/2021,"Chateau Batailley 5eme Cru Classe, Pauillac",Bordeaux,2018,20/05/2021,10063222018,1006322
6250,14/06/2021,7420,48,6776,-526,644,10/06/2021,"Chateau Margaux Premier Cru Classe, Margaux",Bordeaux,2005,15/06/2021,10127812005,1012781
8000,31/05/2021,8668,7,6974,1026,1694,14/03/2021,"Domaine Leflaive, Chevalier-Montrachet Grand Cru",Burgundy,2017,01/06/2021,10734012017,1073401
907,31/05/2021,927,19,805,102,122,20/11/2019,"Chateau Calon Segur 3eme Cru Classe, Saint-Estephe",Bordeaux,2001,01/06/2021,10074752001,1007475
2795,08/07/2021,3130,11,2680,115,450,04/01/2021,"Chateau Angelus Premier Grand Cru Classe B, Saint-Emilion Grand Cru",Bordeaux,2004,09/07/2021,10060452004,1006045
468,20/05/2021,582,2,465,3,117,04/05/2020,"Chateau Batailley 5eme Cru Classe, Pauillac",Bordeaux,2001,21/05/2021,10063222001,1006322
3900,01/06/2021,4703,77,3861,39,842,28/05/2021,"Chateau Margaux Premier Cru Classe, Margaux",Bordeaux,2006,02/06/2021,10127812006,1012781
6750,01/06/2021,7629,42,6525,225,1104,23/05/2021,"Chateau Margaux Premier Cru Classe, Margaux",Bordeaux,2009,02/06/2021,10127812009,1012781
1050,03/06/2021,1144,6,860,190,284,08/03/2021,"Tignanello, Toscana",Tuscany,2013,04/06/2021,10953912013,1095391
2795,08/07/2021,3130,11,2680,115,450,04/01/2021,"Chateau Angelus Premier Grand Cru Classe B, Saint-Emilion Grand Cru",Bordeaux,2004,09/07/2021,10060452004,1006045
950,01/06/2021,1003,59,863,87,140,10/05/2021,"Chateau Calon Segur 3eme Cru Classe, Saint-Estephe",Bordeaux,2006,02/06/2021,10074752006,1007475
2795,07/07/2021,3130,11,2680,115,450,04/01/2021,"Chateau Angelus Premier Grand Cru Classe B, Saint-Emilion Grand Cru",Bordeaux,2004,08/07/2021,10060452004,1006045
2795,07/07/2021,3130,11,2680,115,450,04/01/2021,"Chateau Angelus Premier Grand Cru Classe B, Saint-Emilion Grand Cru",Bordeaux,2004,08/07/2021,10060452004,1006045
4850,27/05/2021,5672,34,4842,8,830,19/05/2021,"Chateau Margaux Premier Cru Classe, Margaux",Bordeaux,2003,31/05/2021,10127812003,1012781
1480,24/05/2021,1575,123,1358,122,217,12/05/2021,"Gaja, Barbaresco",Piedmont,2017,31/05/2021,10996052017,1099605
1500,28/05/2021,1683,49,1408,92,275,09/04/2021,"Gaja, Barbaresco",Piedmont,2016,31/05/2021,10996052016,1099605
412,20/05/2021,437,2,220,192,217,17/06/2015,"Chateau Batailley 5eme Cru Classe, Pauillac",Bordeaux,2002,21/05/2021,10063222002,1006322
6250,17/06/2021,7412,49,6776,-526,636,10/06/2021,"Chateau Margaux Premier Cru Classe, Margaux",Bordeaux,2005,18/06/2021,10127812005,1012781
870,01/06/2021,945,10,705,165,240,01/02/2021,"Chateau Calon Segur 3eme Cru Classe, Saint-Estephe",Bordeaux,2002,02/06/2021,10074752002,1007475
1024,25/05/2021,1199,10,1072,-48,127,20/01/2021,"Tignanello, Toscana",Tuscany,2009,31/05/2021,10953912009,1095391
2795,06/07/2021,3130,11,2680,115,450,04/01/2021,"Chateau Angelus Premier Grand Cru Classe B, Saint-Emilion Grand Cru",Bordeaux,2004,07/07/2021,10060452004,1006045
450,20/05/2021,450,1,340,110,110,31/08/2018,"Chateau Batailley 5eme Cru Classe, Pauillac",Bordeaux,2007,21/05/2021,10063222007,1006322
1408,27/05/2021,1451,2,1150,258,301,21/04/2019,"Tignanello, Toscana",Tuscany,2005,31/05/2021,10953912005,1095391
490,20/05/2021,584,28,504,-14,80,06/04/2021,"Chateau Batailley 5eme Cru Classe, Pauillac",Bordeaux,2009,21/05/2021,10063222009,1006322
490,27/05/2021,555,20,388,102,167,29/09/2020,"Tua Rita, Giusto di Notri, Toscana",Tuscany,2015,31/05/2021,11058072015,1105807
10200,28/05/2021,12549,63,9844,356,2705,29/03/2021,"Chateau Margaux Premier Cru Classe, Margaux",Bordeaux,2015,31/05/2021,10127812015,1012781
1050,07/05/2021,1356,38,940,110,416,18/03/2021,"Chateau Calon Segur 3eme Cru Classe, Saint-Estephe",Bordeaux,2000,09/05/2021,10074752000,1007475
1700,07/05/2021,1674,3,1378,322,296,29/07/2020,"Tignanello, Toscana",Tuscany,2001,09/05/2021,10953912001,1095391
1300,05/05/2021,1332,3,1200,100,132,06/03/2021,"Tignanello, Toscana",Tuscany,2007,09/05/2021,10953912007,1095391
789,01/06/2021,976,21,745,44,231,16/11/2020,"Chateau Calon Segur 3eme Cru Classe, Saint-Estephe",Bordeaux,2004,02/06/2021,10074752004,1007475
1200,28/05/2021,1262,37,1124,76,138,19/05/2021,"Tignanello, Toscana",Tuscany,2016,31/05/2021,10953912016,1095391
2199,28/05/2021,2184,1,1340,859,844,13/03/2020,"Gaja, Barbaresco",Piedmont,2009,31/05/2021,10996052009,1099605
490,20/05/2021,584,28,504,-14,80,06/04/2021,"Chateau Batailley 5eme Cru Classe, Pauillac",Bordeaux,2009,21/05/2021,10063222009,1006322
7000,10/05/2021,7000,1,5360,1640,1640,18/09/2020,"Domaine Leflaive, Chevalier-Montrachet Grand Cru",Burgundy,2009,31/05/2021,10734012009,1073401
300,20/05/2021,301,110,304,-4,-3,10/01/2021,"Chateau Batailley 5eme Cru Classe, Pauillac",Bordeaux,2013,21/05/2021,10063222013,1006322
1050,28/05/2021,1147,7,860,190,287,08/03/2021,"Tignanello, Toscana",Tuscany,2013,31/05/2021,10953912013,1095391
790,28/05/2021,941,142,816,-26,125,27/05/2021,"Tignanello, Toscana",Tuscany,2017,31/05/2021,10953912017,1095391
477,20/05/2021,529,47,364,113,165,12/05/2021,"Chateau Batailley 5eme Cru Classe, Pauillac",Bordeaux,2016,21/05/2021,10063222016,1006322
1029,05/05/2021,1181,69,975,54,206,12/04/2021,"Chateau Calon Segur 3eme Cru Classe, Saint-Estephe",Bordeaux,2005,09/05/2021,10074752005,1007475
8000,07/05/2021,8230,20,7950,50,280,12/03/2021,"Chateau Margaux Premier Cru Classe, Margaux",Bordeaux,2000,09/05/2021,10127812000,1012781
3800,07/05/2021,4154,36,3560,240,594,20/11/2020,"Chateau Margaux Premier Cru Classe, Margaux",Bordeaux,2012,09/05/2021,10127812012,1012781
1000,04/05/2021,1208,11,860,140,348,08/03/2021,"Tignanello, Toscana",Tuscany,2013,10/05/2021,10953912013,1095391
1000,07/05/2021,1244,15,1047,-47,197,27/04/2021,"Chateau Calon Segur 3eme Cru Classe, Saint-Estephe",Bordeaux,2009,10/05/2021,10074752009,1007475
2795,06/07/2021,3130,11,2680,115,450,04/01/2021,"Chateau Angelus Premier Grand Cru Classe B, Saint-Emilion Grand Cru",Bordeaux,2004,07/07/2021,10060452004,1006045
17180,04/05/2021,17180,0,6538,10642,10642,05/07/2016,"Jacques-Frederic Mugnier, Chambolle-Musigny Premier Cru, Les Amoureuses",Burgundy,2012,10/05/2021,10496422012,1049642
7800,07/05/2021,8143,6,7000,800,1143,26/04/2021,"Domaine Leflaive, Chevalier-Montrachet Grand Cru",Burgundy,2018,10/05/2021,10734012018,1073401
5530,07/05/2021,5517,48,5288,242,229,03/05/2021,"Chateau Margaux Premier Cru Classe, Margaux",Bordeaux,2016,10/05/2021,10127812016,1012781
5490,07/05/2021,5659,136,5150,340,509,03/05/2021,"Chateau Margaux Premier Cru Classe, Margaux",Bordeaux,2018,10/05/2021,10127812018,1012781
2795,05/07/2021,3130,11,2680,115,450,04/01/2021,"Chateau Angelus Premier Grand Cru Classe B, Saint-Emilion Grand Cru",Bordeaux,2004,06/07/2021,10060452004,1006045
3800,07/05/2021,4158,36,3560,240,598,20/11/2020,"Chateau Margaux Premier Cru Classe, Margaux",Bordeaux,2012,10/05/2021,10127812012,1012781
790,05/05/2021,897,34,794,-4,103,20/04/2021,"Chateau Calon Segur 3eme Cru Classe, Saint-Estephe",Bordeaux,2014,10/05/2021,10074752014,1007475
3758,14/06/2021,4050,97,3690,68,360,13/04/2021,"Chateau Margaux Premier Cru Classe, Margaux",Bordeaux,2011,15/06/2021,10127812011,1012781
15600,09/06/2021,15068,6,13000,2600,2068,29/04/2021,"Jacques-Frederic Mugnier, Chambolle-Musigny Premier Cru, Les Amoureuses",Burgundy,2017,15/06/2021,10496422017,1049642
850,01/06/2021,1091,90,860,-10,231,19/04/2021,"Chateau Calon Segur 3eme Cru Classe, Saint-Estephe",Bordeaux,2015,02/06/2021,10074752015,1007475
3720,01/06/2021,4213,87,3480,240,733,10/04/2021,"Chateau Margaux Premier Cru Classe, Margaux",Bordeaux,2014,02/06/2021,10127812014,1012781
3720,28/05/2021,4085,42,3480,240,605,10/04/2021,"Chateau Margaux Premier Cru Classe, Margaux",Bordeaux,2014,31/05/2021,10127812014,1012781
3700,28/05/2021,4072,137,3700,0,372,06/05/2021,"Chateau Margaux Premier Cru Classe, Margaux",Bordeaux,2017,31/05/2021,10127812017,1012781
2795,05/07/2021,3130,11,2680,115,450,04/01/2021,"Chateau Angelus Premier Grand Cru Classe B, Saint-Emilion Grand Cru",Bordeaux,2004,06/07/2021,10060452004,1006045
1408,27/05/2021,1451,2,1150,258,301,21/04/2019,"Tignanello, Toscana",Tuscany,2005,31/05/2021,10953912005,1095391
4850,27/05/2021,5672,34,4842,8,830,19/05/2021,"Chateau Margaux Premier Cru Classe, Margaux",Bordeaux,2003,31/05/2021,10127812003,1012781
10100,11/06/2021,11967,52,9800,300,2167,11/06/2021,"Chateau Margaux Premier Cru Classe, Margaux",Bordeaux,2015,15/06/2021,10127812015,1012781
2232,10/06/2021,2343,5,2190,42,153,01/05/2021,"Gaja, Barbaresco",Piedmont,2004,15/06/2021,10996052004,1099605
907,14/06/2021,957,24,805,102,152,20/11/2019,"Chateau Calon Segur 3eme Cru Classe, Saint-Estephe",Bordeaux,2001,15/06/2021,10074752001,1007475
2795,30/06/2021,3129,11,2680,115,449,04/01/2021,"Chateau Angelus Premier Grand Cru Classe B, Saint-Emilion Grand Cru",Bordeaux,2004,01/07/2021,10060452004,1006045
1500,14/06/2021,1681,50,1408,92,273,09/04/2021,"Gaja, Barbaresco",Piedmont,2016,15/06/2021,10996052016,1099605
408,20/05/2021,414,20,357,51,57,06/05/2021,"Chateau Batailley 5eme Cru Classe, Pauillac",Bordeaux,2018,21/05/2021,10063222018,1006322
2795,30/06/2021,3129,11,2680,115,449,04/01/2021,"Chateau Angelus Premier Grand Cru Classe B, Saint-Emilion Grand Cru",Bordeaux,2004,01/07/2021,10060452004,1006045
1195,31/05/2021,1224,9,1202,-7,22,10/05/2021,"Tignanello, Toscana",Tuscany,2015,01/06/2021,10953912015,1095391
2500,17/06/2021,3208,4,2220,280,988,14/06/2021,"Gaja, Barbaresco",Piedmont,2001,18/06/2021,10996052001,1099605
1000,01/06/2021,1153,97,988,12,165,28/05/2021,"Chateau Calon Segur 3eme Cru Classe, Saint-Estephe",Bordeaux,2005,02/06/2021,10074752005,1007475
2795,29/06/2021,3129,11,2680,115,449,04/01/2021,"Chateau Angelus Premier Grand Cru Classe B, Saint-Emilion Grand Cru",Bordeaux,2004,30/06/2021,10060452004,1006045
2795,29/06/2021,3129,11,2680,115,449,04/01/2021,"Chateau Angelus Premier Grand Cru Classe B, Saint-Emilion Grand Cru",Bordeaux,2004,30/06/2021,10060452004,1006045
780,01/06/2021,842,12,682,98,160,15/09/2020,"Chateau Calon Segur 3eme Cru Classe, Saint-Estephe",Bordeaux,2013,02/06/2021,10074752013,1007475
880,01/06/2021,986,13,725,155,261,13/04/2021,"Chateau Calon Segur 3eme Cru Classe, Saint-Estephe",Bordeaux,2007,02/06/2021,10074752007,1007475
6291,31/05/2021,7447,58,6190,101,1257,23/05/2021,"Chateau Margaux Premier Cru Classe, Margaux",Bordeaux,2010,01/06/2021,10127812010,1012781
3826,01/06/2021,4532,59,4116,-290,416,25/02/2021,"Chateau Margaux Premier Cru Classe, Margaux",Bordeaux,2004,02/06/2021,10127812004,1012781
1398,18/05/2021,1416,9,1276,122,140,05/03/2021,"Gaja, Barbaresco",Piedmont,2013,01/06/2021,10996052013,1099605
3740,31/05/2021,3991,52,3520,220,471,07/04/2021,"Chateau Margaux Premier Cru Classe, Margaux",Bordeaux,2013,01/06/2021,10127812013,1012781
2199,31/05/2021,2184,1,1340,859,844,13/03/2020,"Gaja, Barbaresco",Piedmont,2009,01/06/2021,10996052009,1099605
950,18/05/2021,1110,40,830,120,280,18/04/2021,"Tignanello, Toscana",Tuscany,2014,01/06/2021,10953912014,1095391
3900,31/05/2021,4425,90,3800,100,625,12/05/2021,"Chateau Margaux Premier Cru Classe, Margaux",Bordeaux,2008,01/06/2021,10127812008,1012781
1700,31/05/2021,1658,4,1378,322,280,29/07/2020,"Tignanello, Toscana",Tuscany,2001,01/06/2021,10953912001,1095391
1029,31/05/2021,1161,6,860,169,301,08/03/2021,"Tignanello, Toscana",Tuscany,2013,01/06/2021,10953912013,1095391
885,31/05/2021,936,18,781,104,155,16/11/2020,"Chateau Calon Segur 3eme Cru Classe, Saint-Estephe",Bordeaux,2008,01/06/2021,10074752008,1007475
880,17/06/2021,975,11,781,99,194,16/11/2020,"Chateau Calon Segur 3eme Cru Classe, Saint-Estephe",Bordeaux,2008,18/06/2021,10074752008,1007475
1000,17/06/2021,1147,82,988,12,159,28/05/2021,"Chateau Calon Segur 3eme Cru Classe, Saint-Estephe",Bordeaux,2005,18/06/2021,10074752005,1007475
2820,29/06/2021,3130,11,2680,140,450,04/01/2021,"Chateau Angelus Premier Grand Cru Classe B, Saint-Emilion Grand Cru",Bordeaux,2004,02/07/2021,10060452004,1006045
2820,29/06/2021,3130,11,2680,140,450,04/01/2021,"Chateau Angelus Premier Grand Cru Classe B, Saint-Emilion Grand Cru",Bordeaux,2004,02/07/2021,10060452004,1006045
885,01/06/2021,936,18,781,104,155,16/11/2020,"Chateau Calon Segur 3eme Cru Classe, Saint-Estephe",Bordeaux,2008,02/06/2021,10074752008,1007475
2795,28/06/2021,3132,10,2680,115,452,04/01/2021,"Chateau Angelus Premier Grand Cru Classe B, Saint-Emilion Grand Cru",Bordeaux,2004,29/06/2021,10060452004,1006045
468,21/05/2021,582,2,465,3,117,04/05/2020,"Chateau Batailley 5eme Cru Classe, Pauillac",Bordeaux,2001,22/05/2021,10063222001,1006322
520,31/05/2021,563,5,460,60,103,05/05/2020,"Tua Rita, Giusto di Notri, Toscana",Tuscany,2008,01/06/2021,11058072008,1105807
412,21/05/2021,437,2,220,192,217,17/06/2015,"Chateau Batailley 5eme Cru Classe, Pauillac",Bordeaux,2002,22/05/2021,10063222002,1006322
8000,02/06/2021,8668,7,6974,1026,1694,14/03/2021,"Domaine Leflaive, Chevalier-Montrachet Grand Cru",Burgundy,2017,03/06/2021,10734012017,1073401
686,07/07/2021,809,7,682,4,127,15/09/2020,"Chateau Calon Segur 3eme Cru Classe, Saint-Estephe",Bordeaux,2013,08/07/2021,10074752013,1007475
2795,28/06/2021,3132,10,2680,115,452,04/01/2021,"Chateau Angelus Premier Grand Cru Classe B, Saint-Emilion Grand Cru",Bordeaux,2004,29/06/2021,10060452004,1006045
3724,31/05/2021,4097,36,3592,132,505,06/05/2021,"Chateau Margaux Premier Cru Classe, Margaux",Bordeaux,2007,01/06/2021,10127812007,1012781
2795,25/06/2021,3132,10,2680,115,452,04/01/2021,"Chateau Angelus Premier Grand Cru Classe B, Saint-Emilion Grand Cru",Bordeaux,2004,26/06/2021,10060452004,1006045
2795,25/06/2021,3132,10,2680,115,452,04/01/2021,"Chateau Angelus Premier Grand Cru Classe B, Saint-Emilion Grand Cru",Bordeaux,2004,26/06/2021,10060452004,1006045
990,17/06/2021,1109,20,990,0,119,16/06/2021,"Chateau Calon Segur 3eme Cru Classe, Saint-Estephe",Bordeaux,2010,18/06/2021,10074752010,1007475
750,17/06/2021,945,26,745,5,200,16/11/2020,"Chateau Calon Segur 3eme Cru Classe, Saint-Estephe",Bordeaux,2004,18/06/2021,10074752004,1007475
1090,09/07/2021,1140,7,860,230,280,08/03/2021,"Tignanello, Toscana",Tuscany,2013,10/07/2021,10953912013,1095391
984,09/07/2021,1106,45,830,154,276,22/06/2021,"Tignanello, Toscana",Tuscany,2014,10/07/2021,10953912014,1095391
2795,24/06/2021,3122,10,2680,115,442,04/01/2021,"Chateau Angelus Premier Grand Cru Classe B, Saint-Emilion Grand Cru",Bordeaux,2004,25/06/2021,10060452004,1006045
900,17/06/2021,1090,29,800,100,290,21/11/2019,"Chateau Calon Segur 3eme Cru Classe, Saint-Estephe",Bordeaux,2003,18/06/2021,10074752003,1007475
6830,17/06/2021,7659,49,7086,-256,573,11/06/2021,"Chateau Margaux Premier Cru Classe, Margaux",Bordeaux,2009,18/06/2021,10127812009,1012781
3750,17/06/2021,4051,95,3690,60,361,13/04/2021,"Chateau Margaux Premier Cru Classe, Margaux",Bordeaux,2011,18/06/2021,10127812011,1012781
840,17/06/2021,1088,79,860,-20,228,19/04/2021,"Chateau Calon Segur 3eme Cru Classe, Saint-Estephe",Bordeaux,2015,18/06/2021,10074752015,1007475
686,17/06/2021,852,11,682,4,170,15/09/2020,"Chateau Calon Segur 3eme Cru Classe, Saint-Estephe",Bordeaux,2013,18/06/2021,10074752013,1007475
2795,24/06/2021,3122,10,2680,115,442,04/01/2021,"Chateau Angelus Premier Grand Cru Classe B, Saint-Emilion Grand Cru",Bordeaux,2004,25/06/2021,10060452004,1006045
2795,23/06/2021,3122,10,2680,115,442,04/01/2021,"Chateau Angelus Premier Grand Cru Classe B, Saint-Emilion Grand Cru",Bordeaux,2004,24/06/2021,10060452004,1006045
3560,17/06/2021,4047,33,3592,-32,455,06/05/2021,"Chateau Margaux Premier Cru Classe, Margaux",Bordeaux,2007,18/06/2021,10127812007,1012781
3900,17/06/2021,4472,28,3684,216,788,10/06/2020,"Chateau Margaux Premier Cru Classe, Margaux",Bordeaux,2002,18/06/2021,10127812002,1012781
10100,11/06/2021,11991,55,9800,300,2191,11/06/2021,"Chateau Margaux Premier Cru Classe, Margaux",Bordeaux,2015,18/06/2021,10127812015,1012781
450,21/05/2021,450,1,340,110,110,31/08/2018,"Chateau Batailley 5eme Cru Classe, Pauillac",Bordeaux,2007,22/05/2021,10063222007,1006322
2098,17/06/2021,2331,5,2190,-92,141,01/05/2021,"Gaja, Barbaresco",Piedmont,2004,18/06/2021,10996052004,1099605
1408,15/06/2021,1370,1,1150,258,220,21/04/2019,"Tignanello, Toscana",Tuscany,2005,18/06/2021,10953912005,1095391
3900,17/06/2021,4608,91,3861,39,747,28/05/2021,"Chateau Margaux Premier Cru Classe, Margaux",Bordeaux,2006,18/06/2021,10127812006,1012781
2795,23/06/2021,3122,10,2680,115,442,04/01/2021,"Chateau Angelus Premier Grand Cru Classe B, Saint-Emilion Grand Cru",Bordeaux,2004,24/06/2021,10060452004,1006045
1310,17/06/2021,1378,7,1172,138,206,07/04/2021,"Tignanello, Toscana",Tuscany,2010,18/06/2021,10953912010,1095391
8100,17/06/2021,8478,19,7950,150,528,12/03/2021,"Chateau Margaux Premier Cru Classe, Margaux",Bordeaux,2000,18/06/2021,10127812000,1012781
490,21/05/2021,584,28,504,-14,80,06/04/2021,"Chateau Batailley 5eme Cru Classe, Pauillac",Bordeaux,2009,22/05/2021,10063222009,1006322
1700,17/06/2021,1658,4,1378,322,280,29/07/2020,"Tignanello, Toscana",Tuscany,2001,18/06/2021,10953912001,1095391
3720,17/06/2021,4286,146,3480,240,806,17/06/2021,"Chateau Margaux Premier Cru Classe, Margaux",Bordeaux,2014,18/06/2021,10127812014,1012781
1040,16/06/2021,1204,22,940,100,264,18/03/2021,"Chateau Calon Segur 3eme Cru Classe, Saint-Estephe",Bordeaux,2000,18/06/2021,10074752000,1007475
880,17/06/2021,986,13,725,155,261,13/04/2021,"Chateau Calon Segur 3eme Cru Classe, Saint-Estephe",Bordeaux,2007,18/06/2021,10074752007,1007475
1100,17/06/2021,1177,44,1030,70,147,25/05/2021,"Chateau Calon Segur 3eme Cru Classe, Saint-Estephe",Bordeaux,2009,18/06/2021,10074752009,1007475
2795,22/06/2021,3122,10,2680,115,442,04/01/2021,"Chateau Angelus Premier Grand Cru Classe B, Saint-Emilion Grand Cru",Bordeaux,2004,23/06/2021,10060452004,1006045
1408,17/06/2021,1386,5,1238,170,148,02/11/2020,"Tignanello, Toscana",Tuscany,2006,18/06/2021,10953912006,1095391
2795,22/06/2021,3122,10,2680,115,442,04/01/2021,"Chateau Angelus Premier Grand Cru Classe B, Saint-Emilion Grand Cru",Bordeaux,2004,23/06/2021,10060452004,1006045
2795,21/06/2021,3122,10,2680,115,442,04/01/2021,"Chateau Angelus Premier Grand Cru Classe B, Saint-Emilion Grand Cru",Bordeaux,2004,22/06/2021,10060452004,1006045
490,21/05/2021,584,28,504,-14,80,06/04/2021,"Chateau Batailley 5eme Cru Classe, Pauillac",Bordeaux,2009,22/05/2021,10063222009,1006322
830,17/06/2021,989,6,735,95,254,09/09/2020,"Chateau Calon Segur 3eme Cru Classe, Saint-Estephe",Bordeaux,2012,18/06/2021,10074752012,1007475
3740,17/06/2021,3975,54,3520,220,455,07/04/2021,"Chateau Margaux Premier Cru Classe, Margaux",Bordeaux,2013,18/06/2021,10127812013,1012781
940,17/06/2021,1106,42,830,110,276,18/04/2021,"Tignanello, Toscana",Tuscany,2014,18/06/2021,10953912014,1095391
6450,17/06/2021,7447,63,6190,260,1257,23/05/2021,"Chateau Margaux Premier Cru Classe, Margaux",Bordeaux,2010,18/06/2021,10127812010,1012781
950,17/06/2021,1020,53,863,87,157,10/05/2021,"Chateau Calon Segur 3eme Cru Classe, Saint-Estephe",Bordeaux,2006,18/06/2021,10074752006,1007475
2795,21/06/2021,3122,10,2680,115,442,04/01/2021,"Chateau Angelus Premier Grand Cru Classe B, Saint-Emilion Grand Cru",Bordeaux,2004,22/06/2021,10060452004,1006045
1024,17/06/2021,1213,6,1072,-48,141,20/01/2021,"Tignanello, Toscana",Tuscany,2009,18/06/2021,10953912009,1095391
2795,18/06/2021,3119,10,2680,115,439,04/01/2021,"Chateau Angelus Premier Grand Cru Classe B, Saint-Emilion Grand Cru",Bordeaux,2004,19/06/2021,10060452004,1006045
2795,18/06/2021,3119,10,2680,115,439,04/01/2021,"Chateau Angelus Premier Grand Cru Classe B, Saint-Emilion Grand Cru",Bordeaux,2004,19/06/2021,10060452004,1006045
2795,16/06/2021,3119,10,2680,115,439,04/01/2021,"Chateau Angelus Premier Grand Cru Classe B, Saint-Emilion Grand Cru",Bordeaux,2004,17/06/2021,10060452004,1006045
2199,05/07/2021,2225,2,1340,859,885,13/03/2020,"Gaja, Barbaresco",Piedmont,2009,06/07/2021,10996052009,1099605
1000,17/06/2021,1053,8,860,140,193,08/03/2021,"Tignanello, Toscana",Tuscany,2011,18/06/2021,10953912011,1095391
4850,11/06/2021,5651,30,4842,8,809,19/05/2021,"Chateau Margaux Premier Cru Classe, Margaux",Bordeaux,2003,18/06/2021,10127812003,1012781
1050,17/06/2021,1144,6,860,190,284,08/03/2021,"Tignanello, Toscana",Tuscany,2013,18/06/2021,10953912013,1095391
740,17/06/2021,1002,51,790,-50,212,01/06/2020,"Chateau Calon Segur 3eme Cru Classe, Saint-Estephe",Bordeaux,2011,18/06/2021,10074752011,1007475
3826,16/06/2021,4517,55,4116,-290,401,25/02/2021,"Chateau Margaux Premier Cru Classe, Margaux",Bordeaux,2004,18/06/2021,10127812004,1012781
900,11/06/2021,1257,12,850,50,407,28/01/2021,"Tignanello, Toscana",Tuscany,2012,18/06/2021,10953912012,1095391
3900,17/06/2021,4421,111,3700,200,721,07/06/2021,"Chateau Margaux Premier Cru Classe, Margaux",Bordeaux,2008,18/06/2021,10127812008,1012781
4400,17/06/2021,4731,27,4400,0,331,29/09/2020,"Chateau Margaux Premier Cru Classe, Margaux",Bordeaux,2001,18/06/2021,10127812001,1012781
9600,17/06/2021,9798,2,8000,1600,1798,30/01/2020,"Domaine Leflaive, Chevalier-Montrachet Grand Cru",Burgundy,2014,18/06/2021,10734012014,1073401
960,30/06/2021,1037,10,880,80,157,22/06/2021,"Tignanello, Toscana",Tuscany,2011,02/07/2021,10953912011,1095391
2795,16/06/2021,3119,10,2680,115,439,04/01/2021,"Chateau Angelus Premier Grand Cru Classe B, Saint-Emilion Grand Cru",Bordeaux,2004,17/06/2021,10060452004,1006045
490,21/05/2021,594,408,494,-4,100,20/04/2021,"Chateau Batailley 5eme Cru Classe, Pauillac",Bordeaux,2010,22/05/2021,10063222010,1006322
820,01/07/2021,937,6,735,85,202,09/09/2020,"Chateau Calon Segur 3eme Cru Classe, Saint-Estephe",Bordeaux,2012,02/07/2021,10074752012,1007475
2795,15/06/2021,3123,10,2680,115,443,04/01/2021,"Chateau Angelus Premier Grand Cru Classe B, Saint-Emilion Grand Cru",Bordeaux,2004,16/06/2021,10060452004,1006045
870,17/06/2021,957,8,705,165,252,01/02/2021,"Chateau Calon Segur 3eme Cru Classe, Saint-Estephe",Bordeaux,2002,18/06/2021,10074752002,1007475
3826,18/06/2021,4510,52,4116,-290,394,25/02/2021,"Chateau Margaux Premier Cru Classe, Margaux",Bordeaux,2004,19/06/2021,10127812004,1012781
3720,18/06/2021,4285,141,3480,240,805,17/06/2021,"Chateau Margaux Premier Cru Classe, Margaux",Bordeaux,2014,19/06/2021,10127812014,1012781
600,18/06/2021,600,14,408,192,192,09/04/2019,"Tua Rita, Giusto di Notri, Toscana",Tuscany,2012,19/06/2021,11058072012,1105807
1700,17/06/2021,1651,4,1378,322,273,29/07/2020,"Tignanello, Toscana",Tuscany,2001,19/06/2021,10953912001,1095391
490,21/05/2021,594,408,494,-4,100,20/04/2021,"Chateau Batailley 5eme Cru Classe, Pauillac",Bordeaux,2010,22/05/2021,10063222010,1006322
1500,12/07/2021,1675,42,1400,100,275,08/07/2021,"Gaja, Barbaresco",Piedmont,2016,13/07/2021,10996052016,1099605
2795,15/06/2021,3123,10,2680,115,443,04/01/2021,"Chateau Angelus Premier Grand Cru Classe B, Saint-Emilion Grand Cru",Bordeaux,2004,16/06/2021,10060452004,1006045
300,21/05/2021,301,110,304,-4,-3,10/01/2021,"Chateau Batailley 5eme Cru Classe, Pauillac",Bordeaux,2013,22/05/2021,10063222013,1006322
820,05/07/2021,937,6,735,85,202,09/09/2020,"Chateau Calon Segur 3eme Cru Classe, Saint-Estephe",Bordeaux,2012,06/07/2021,10074752012,1007475
3750,05/07/2021,4178,41,3560,190,618,20/11/2020,"Chateau Margaux Premier Cru Classe, Margaux",Bordeaux,2012,06/07/2021,10127812012,1012781
1800,02/07/2021,1727,1,1440,360,287,04/01/2018,"Gaja, Barbaresco",Piedmont,2010,06/07/2021,10996052010,1099605
2795,11/06/2021,3123,10,2680,115,443,04/01/2021,"Chateau Angelus Premier Grand Cru Classe B, Saint-Emilion Grand Cru",Bordeaux,2004,12/06/2021,10060452004,1006045
907,25/06/2021,966,18,805,102,161,20/11/2019,"Chateau Calon Segur 3eme Cru Classe, Saint-Estephe",Bordeaux,2001,27/06/2021,10074752001,1007475
477,21/05/2021,529,47,364,113,165,12/05/2021,"Chateau Batailley 5eme Cru Classe, Pauillac",Bordeaux,2016,22/05/2021,10063222016,1006322
6396,27/05/2021,7057,1,7900,-1504,-843,29/04/2019,"Domaine Leflaive, Chevalier-Montrachet Grand Cru",Burgundy,2015,27/06/2021,10734012015,1073401
1592,22/06/2021,1564,15,1300,292,264,28/09/2020,"Gaja, Barbaresco",Piedmont,2014,27/06/2021,10996052014,1099605
3750,24/06/2021,4214,39,3560,190,654,20/11/2020,"Chateau Margaux Premier Cru Classe, Margaux",Bordeaux,2012,27/06/2021,10127812012,1012781
1100,17/06/2021,1265,45,1026,74,239,24/06/2021,"Chateau Calon Segur 3eme Cru Classe, Saint-Estephe",Bordeaux,2009,27/06/2021,10074752009,1007475
1570,22/06/2021,1385,2,1200,370,185,06/03/2021,"Tignanello, Toscana",Tuscany,2007,27/06/2021,10953912007,1095391
8100,23/06/2021,8506,17,8100,0,406,21/06/2021,"Chateau Margaux Premier Cru Classe, Margaux",Bordeaux,2000,27/06/2021,10127812000,1012781
5600,23/06/2021,5857,97,5254,346,603,26/05/2021,"Chateau Margaux Premier Cru Classe, Margaux",Bordeaux,2018,27/06/2021,10127812018,1012781
2795,11/06/2021,3123,10,2680,115,443,04/01/2021,"Chateau Angelus Premier Grand Cru Classe B, Saint-Emilion Grand Cru",Bordeaux,2004,12/06/2021,10060452004,1006045
940,09/07/2021,1091,77,822,118,269,28/06/2021,"Chateau Calon Segur 3eme Cru Classe, Saint-Estephe",Bordeaux,2015,10/07/2021,10074752015,1007475
10400,09/07/2021,11900,47,9800,600,2100,11/06/2021,"Chateau Margaux Premier Cru Classe, Margaux",Bordeaux,2015,10/07/2021,10127812015,1012781
960,07/07/2021,1285,11,850,110,435,28/01/2021,"Tignanello, Toscana",Tuscany,2012,08/07/2021,10953912012,1095391
2795,10/06/2021,3123,10,2680,115,443,04/01/2021,"Chateau Angelus Premier Grand Cru Classe B, Saint-Emilion Grand Cru",Bordeaux,2004,11/06/2021,10060452004,1006045
6400,25/06/2021,7446,55,5950,450,1496,23/06/2021,"Chateau Margaux Premier Cru Classe, Margaux",Bordeaux,2010,26/06/2021,10127812010,1012781
6400,25/06/2021,7417,41,6776,-376,641,10/06/2021,"Chateau Margaux Premier Cru Classe, Margaux",Bordeaux,2005,26/06/2021,10127812005,1012781
1040,23/06/2021,1204,23,940,100,264,18/03/2021,"Chateau Calon Segur 3eme Cru Classe, Saint-Estephe",Bordeaux,2000,26/06/2021,10074752000,1007475
857,15/06/2021,944,153,844,13,100,25/06/2021,"Tignanello, Toscana",Tuscany,2017,26/06/2021,10953912017,1095391
1380,25/06/2021,1443,7,1352,28,91,23/09/2020,"Gaja, Barbaresco",Piedmont,2011,26/06/2021,10996052011,1099605
6116,25/06/2021,6116,0,3920,2196,2196,26/04/2017,"Domaine Leflaive, Chevalier-Montrachet Grand Cru",Burgundy,2006,26/06/2021,10734012006,1073401
3900,25/06/2021,4630,95,3822,78,808,20/06/2021,"Chateau Margaux Premier Cru Classe, Margaux",Bordeaux,2006,26/06/2021,10127812006,1012781
1024,25/06/2021,1232,5,1072,-48,160,20/01/2021,"Tignanello, Toscana",Tuscany,2009,26/06/2021,10953912009,1095391
3750,24/06/2021,4175,42,3560,190,615,20/11/2020,"Chateau Margaux Premier Cru Classe, Margaux",Bordeaux,2012,02/07/2021,10127812012,1012781
13200,01/07/2021,12867,1,12850,350,17,30/11/2020,"Jacques-Frederic Mugnier, Chambolle-Musigny Premier Cru, Les Amoureuses",Burgundy,2011,02/07/2021,10496422011,1049642
2795,10/06/2021,3123,10,2680,115,443,04/01/2021,"Chateau Angelus Premier Grand Cru Classe B, Saint-Emilion Grand Cru",Bordeaux,2004,11/06/2021,10060452004,1006045
1550,25/06/2021,1557,1,1300,250,257,27/04/2021,"Gaja, Barbaresco",Piedmont,2012,26/06/2021,10996052012,1099605
2795,09/06/2021,3163,10,2680,115,483,04/01/2021,"Chateau Angelus Premier Grand Cru Classe B, Saint-Emilion Grand Cru",Bordeaux,2004,10/06/2021,10060452004,1006045
408,21/05/2021,414,20,357,51,57,06/05/2021,"Chateau Batailley 5eme Cru Classe, Pauillac",Bordeaux,2018,22/05/2021,10063222018,1006322
1000,25/06/2021,1157,92,988,12,169,28/05/2021,"Chateau Calon Segur 3eme Cru Classe, Saint-Estephe",Bordeaux,2005,26/06/2021,10074752005,1007475
3800,07/07/2021,4339,126,3480,320,859,17/06/2021,"Chateau Margaux Premier Cru Classe, Margaux",Bordeaux,2014,08/07/2021,10127812014,1012781
2795,09/06/2021,3163,10,2680,115,483,04/01/2021,"Chateau Angelus Premier Grand Cru Classe B, Saint-Emilion Grand Cru",Bordeaux,2004,10/06/2021,10060452004,1006045
880,25/06/2021,967,9,725,155,242,13/04/2021,"Chateau Calon Segur 3eme Cru Classe, Saint-Estephe",Bordeaux,2007,26/06/2021,10074752007,1007475
574,25/06/2021,574,1,351,223,223,25/07/2016,"Tua Rita, Giusto di Notri, Toscana",Tuscany,2004,26/06/2021,11058072004,1105807
907,25/06/2021,953,23,805,102,148,20/11/2019,"Chateau Calon Segur 3eme Cru Classe, Saint-Estephe",Bordeaux,2001,26/06/2021,10074752001,1007475
1000,24/06/2021,1265,45,1026,-26,239,24/06/2021,"Chateau Calon Segur 3eme Cru Classe, Saint-Estephe",Bordeaux,2009,26/06/2021,10074752009,1007475
860,25/06/2021,1033,70,910,-50,123,23/06/2021,"Tignanello, Toscana",Tuscany,2018,26/06/2021,10953912018,1095391
4850,25/06/2021,5660,29,4650,200,1010,21/06/2021,"Chateau Margaux Premier Cru Classe, Margaux",Bordeaux,2003,26/06/2021,10127812003,1012781
2795,08/06/2021,3163,10,2680,115,483,04/01/2021,"Chateau Angelus Premier Grand Cru Classe B, Saint-Emilion Grand Cru",Bordeaux,2004,09/06/2021,10060452004,1006045
1070,25/06/2021,1220,51,950,120,270,03/05/2021,"Chateau Calon Segur 3eme Cru Classe, Saint-Estephe",Bordeaux,2018,26/06/2021,10074752018,1007475
1800,25/06/2021,1691,2,1440,360,251,04/01/2018,"Gaja, Barbaresco",Piedmont,2010,26/06/2021,10996052010,1099605
1408,25/06/2021,1389,4,1238,170,151,02/11/2020,"Tignanello, Toscana",Tuscany,2006,26/06/2021,10953912006,1095391
660,25/06/2021,721,6,390,270,331,18/08/2017,"Tua Rita, Giusto di Notri, Toscana",Tuscany,2006,26/06/2021,11058072006,1105807
3740,25/06/2021,4026,63,3520,220,506,07/04/2021,"Chateau Margaux Premier Cru Classe, Margaux",Bordeaux,2013,26/06/2021,10127812013,1012781
13200,05/07/2021,12867,1,12850,350,17,30/11/2020,"Jacques-Frederic Mugnier, Chambolle-Musigny Premier Cru, Les Amoureuses",Burgundy,2011,06/07/2021,10496422011,1049642
1090,07/07/2021,1140,7,860,230,280,08/03/2021,"Tignanello, Toscana",Tuscany,2013,08/07/2021,10953912013,1095391
984,07/07/2021,1104,42,830,154,274,22/06/2021,"Tignanello, Toscana",Tuscany,2014,08/07/2021,10953912014,1095391
3740,05/07/2021,4000,49,3520,220,480,07/04/2021,"Chateau Margaux Premier Cru Classe, Margaux",Bordeaux,2013,06/07/2021,10127812013,1012781
2795,08/06/2021,3163,10,2680,115,483,04/01/2021,"Chateau Angelus Premier Grand Cru Classe B, Saint-Emilion Grand Cru",Bordeaux,2004,09/06/2021,10060452004,1006045
468,24/05/2021,582,2,465,3,117,04/05/2020,"Chateau Batailley 5eme Cru Classe, Pauillac",Bordeaux,2001,25/05/2021,10063222001,1006322
686,05/07/2021,809,7,682,4,127,15/09/2020,"Chateau Calon Segur 3eme Cru Classe, Saint-Estephe",Bordeaux,2013,06/07/2021,10074752013,1007475
1380,05/07/2021,1442,7,1352,28,90,23/09/2020,"Gaja, Barbaresco",Piedmont,2011,06/07/2021,10996052011,1099605
870,27/07/2021,966,5,705,165,261,01/02/2021,"Chateau Calon Segur 3eme Cru Classe, Saint-Estephe",Bordeaux,2002,28/07/2021,10074752002,1007475
8200,27/07/2021,9028,16,8200,0,828,26/07/2021,"Chateau Margaux Premier Cru Classe, Margaux",Bordeaux,2000,28/07/2021,10127812000,1012781
2795,07/06/2021,3163,10,2680,115,483,04/01/2021,"Chateau Angelus Premier Grand Cru Classe B, Saint-Emilion Grand Cru",Bordeaux,2004,08/06/2021,10060452004,1006045
4450,27/07/2021,4750,24,4400,50,350,29/09/2020,"Chateau Margaux Premier Cru Classe, Margaux",Bordeaux,2001,28/07/2021,10127812001,1012781
3840,27/07/2021,4583,50,4116,-276,467,25/02/2021,"Chateau Margaux Premier Cru Classe, Margaux",Bordeaux,2004,28/07/2021,10127812004,1012781
5040,27/07/2021,6002,22,4650,390,1352,21/06/2021,"Chateau Margaux Premier Cru Classe, Margaux",Bordeaux,2003,28/07/2021,10127812003,1012781
2795,07/06/2021,3163,10,2680,115,483,04/01/2021,"Chateau Angelus Premier Grand Cru Classe B, Saint-Emilion Grand Cru",Bordeaux,2004,08/06/2021,10060452004,1006045
840,27/07/2021,1059,20,745,95,314,16/11/2020,"Chateau Calon Segur 3eme Cru Classe, Saint-Estephe",Bordeaux,2004,28/07/2021,10074752004,1007475
2795,04/06/2021,3163,10,2680,115,483,04/01/2021,"Chateau Angelus Premier Grand Cru Classe B, Saint-Emilion Grand Cru",Bordeaux,2004,05/06/2021,10060452004,1006045
6500,27/07/2021,7515,26,6400,100,1115,22/07/2021,"Chateau Margaux Premier Cru Classe, Margaux",Bordeaux,2005,28/07/2021,10127812005,1012781
990,26/07/2021,1177,64,1029,-39,148,21/07/2021,"Chateau Calon Segur 3eme Cru Classe, Saint-Estephe",Bordeaux,2005,28/07/2021,10074752005,1007475
3900,27/07/2021,4680,87,3822,78,858,20/06/2021,"Chateau Margaux Premier Cru Classe, Margaux",Bordeaux,2006,28/07/2021,10127812006,1012781
3750,27/07/2021,4268,89,3525,225,743,18/06/2021,"Chateau Margaux Premier Cru Classe, Margaux",Bordeaux,2007,28/07/2021,10127812007,1012781
880,27/07/2021,980,7,725,155,255,13/04/2021,"Chateau Calon Segur 3eme Cru Classe, Saint-Estephe",Bordeaux,2007,28/07/2021,10074752007,1007475
2795,04/06/2021,3163,10,2680,115,483,04/01/2021,"Chateau Angelus Premier Grand Cru Classe B, Saint-Emilion Grand Cru",Bordeaux,2004,05/06/2021,10060452004,1006045
2795,03/06/2021,3188,9,2680,115,508,04/01/2021,"Chateau Angelus Premier Grand Cru Classe B, Saint-Emilion Grand Cru",Bordeaux,2004,04/06/2021,10060452004,1006045
3900,27/07/2021,4375,83,3780,120,595,23/07/2021,"Chateau Margaux Premier Cru Classe, Margaux",Bordeaux,2008,28/07/2021,10127812008,1012781
895,27/07/2021,953,8,781,114,172,16/11/2020,"Chateau Calon Segur 3eme Cru Classe, Saint-Estephe",Bordeaux,2008,28/07/2021,10074752008,1007475
6930,26/07/2021,7715,60,7086,-156,629,11/06/2021,"Chateau Margaux Premier Cru Classe, Margaux",Bordeaux,2009,28/07/2021,10127812009,1012781
2795,03/06/2021,3188,9,2680,115,508,04/01/2021,"Chateau Angelus Premier Grand Cru Classe B, Saint-Emilion Grand Cru",Bordeaux,2004,04/06/2021,10060452004,1006045
2386,27/07/2021,2397,3,2190,196,207,01/05/2021,"Gaja, Barbaresco",Piedmont,2004,28/07/2021,10996052004,1099605
1700,26/07/2021,1665,4,1378,322,287,29/07/2020,"Tignanello, Toscana",Tuscany,2001,28/07/2021,10953912001,1095391
1299,06/07/2021,1523,5,1150,149,373,27/07/2021,"Tignanello, Toscana",Tuscany,2008,28/07/2021,10953912008,1095391
1408,27/07/2021,1310,4,1238,170,72,02/11/2020,"Tignanello, Toscana",Tuscany,2006,28/07/2021,10953912006,1095391
1680,23/07/2021,1693,2,1420,260,273,29/06/2021,"Tignanello, Toscana",Tuscany,2004,28/07/2021,10953912004,1095391
1300,08/07/2021,1412,3,1200,100,212,06/03/2021,"Tignanello, Toscana",Tuscany,2007,28/07/2021,10953912007,1095391
1408,06/07/2021,1443,1,996,412,447,14/06/2019,"Tignanello, Toscana",Tuscany,2000,28/07/2021,10953912000,1095391
1624,27/07/2021,1810,2,882,742,928,26/04/2019,"Tignanello, Toscana",Tuscany,2003,28/07/2021,10953912003,1095391
6400,27/07/2021,7545,57,6188,212,1357,16/07/2021,"Chateau Margaux Premier Cru Classe, Margaux",Bordeaux,2010,28/07/2021,10127812010,1012781
412,24/05/2021,437,2,220,192,217,17/06/2015,"Chateau Batailley 5eme Cru Classe, Pauillac",Bordeaux,2002,25/05/2021,10063222002,1006322
990,27/07/2021,1117,17,993,-3,124,27/07/2021,"Chateau Calon Segur 3eme Cru Classe, Saint-Estephe",Bordeaux,2010,28/07/2021,10074752010,1007475
1326,26/07/2021,1602,3,1170,156,432,24/06/2021,"Tignanello, Toscana",Tuscany,2010,28/07/2021,10953912010,1095391
3758,27/07/2021,4370,80,3690,68,680,13/04/2021,"Chateau Margaux Premier Cru Classe, Margaux",Bordeaux,2011,28/07/2021,10127812011,1012781
2795,02/06/2021,3188,9,2680,115,508,04/01/2021,"Chateau Angelus Premier Grand Cru Classe B, Saint-Emilion Grand Cru",Bordeaux,2004,03/06/2021,10060452004,1006045
1050,26/07/2021,1117,9,880,170,237,22/06/2021,"Tignanello, Toscana",Tuscany,2011,28/07/2021,10953912011,1095391
2795,02/06/2021,3188,9,2680,115,508,04/01/2021,"Chateau Angelus Premier Grand Cru Classe B, Saint-Emilion Grand Cru",Bordeaux,2004,03/06/2021,10060452004,1006045
820,27/07/2021,920,4,735,85,185,09/09/2020,"Chateau Calon Segur 3eme Cru Classe, Saint-Estephe",Bordeaux,2012,28/07/2021,10074752012,1007475
3750,26/07/2021,4292,51,3650,100,642,27/07/2021,"Chateau Margaux Premier Cru Classe, Margaux",Bordeaux,2012,28/07/2021,10127812012,1012781
3700,27/07/2021,4171,36,3520,180,651,07/04/2021,"Chateau Margaux Premier Cru Classe, Margaux",Bordeaux,2013,28/07/2021,10127812013,1012781
2795,01/06/2021,3188,9,2680,115,508,04/01/2021,"Chateau Angelus Premier Grand Cru Classe B, Saint-Emilion Grand Cru",Bordeaux,2004,02/06/2021,10060452004,1006045
800,27/07/2021,792,19,682,118,110,15/09/2020,"Chateau Calon Segur 3eme Cru Classe, Saint-Estephe",Bordeaux,2013,28/07/2021,10074752013,1007475
960,26/07/2021,1309,13,850,110,459,28/01/2021,"Tignanello, Toscana",Tuscany,2012,28/07/2021,10953912012,1095391
3800,27/07/2021,4354,129,3480,320,874,17/06/2021,"Chateau Margaux Premier Cru Classe, Margaux",Bordeaux,2014,28/07/2021,10127812014,1012781
790,27/07/2021,877,18,801,-11,76,31/05/2021,"Chateau Calon Segur 3eme Cru Classe, Saint-Estephe",Bordeaux,2014,28/07/2021,10074752014,1007475
950,27/07/2021,1128,9,960,-10,168,27/07/2021,"Tignanello, Toscana",Tuscany,2013,28/07/2021,10953912013,1095391
984,27/07/2021,1048,7,854,130,194,15/07/2021,"Tignanello, Toscana",Tuscany,2014,28/07/2021,10953912014,1095391
940,27/07/2021,1074,79,866,74,208,20/07/2021,"Chateau Calon Segur 3eme Cru Classe, Saint-Estephe",Bordeaux,2015,28/07/2021,10074752015,1007475
10620,27/07/2021,11774,44,9800,820,1974,11/06/2021,"Chateau Margaux Premier Cru Classe, Margaux",Bordeaux,2015,28/07/2021,10127812015,1012781
870,28/07/2021,966,5,705,165,261,01/02/2021,"Chateau Calon Segur 3eme Cru Classe, Saint-Estephe",Bordeaux,2002,29/07/2021,10074752002,1007475
900,28/07/2021,1115,23,800,100,315,21/11/2019,"Chateau Calon Segur 3eme Cru Classe, Saint-Estephe",Bordeaux,2003,29/07/2021,10074752003,1007475
2795,01/06/2021,3188,9,2680,115,508,04/01/2021,"Chateau Angelus Premier Grand Cru Classe B, Saint-Emilion Grand Cru",Bordeaux,2004,02/06/2021,10060452004,1006045
3900,28/07/2021,4417,22,3684,216,733,10/06/2020,"Chateau Margaux Premier Cru Classe, Margaux",Bordeaux,2002,29/07/2021,10127812002,1012781
4450,28/07/2021,4693,16,4400,50,293,29/09/2020,"Chateau Margaux Premier Cru Classe, Margaux",Bordeaux,2001,29/07/2021,10127812001,1012781
3840,28/07/2021,4594,48,4116,-276,478,25/02/2021,"Chateau Margaux Premier Cru Classe, Margaux",Bordeaux,2004,29/07/2021,10127812004,1012781
5040,28/07/2021,5997,23,4650,390,1347,21/06/2021,"Chateau Margaux Premier Cru Classe, Margaux",Bordeaux,2003,29/07/2021,10127812003,1012781
2795,31/05/2021,3188,9,2680,115,508,04/01/2021,"Chateau Angelus Premier Grand Cru Classe B, Saint-Emilion Grand Cru",Bordeaux,2004,01/06/2021,10060452004,1006045
2795,31/05/2021,3188,9,2680,115,508,04/01/2021,"Chateau Angelus Premier Grand Cru Classe B, Saint-Emilion Grand Cru",Bordeaux,2004,01/06/2021,10060452004,1006045
840,28/07/2021,1059,20,745,95,314,16/11/2020,"Chateau Calon Segur 3eme Cru Classe, Saint-Estephe",Bordeaux,2004,29/07/2021,10074752004,1007475
2098,18/06/2021,2331,5,2190,-92,141,01/05/2021,"Gaja, Barbaresco",Piedmont,2004,19/06/2021,10996052004,1099605
830,17/06/2021,966,5,735,95,231,09/09/2020,"Chateau Calon Segur 3eme Cru Classe, Saint-Estephe",Bordeaux,2012,19/06/2021,10074752012,1007475
870,18/06/2021,935,5,705,165,230,01/02/2021,"Chateau Calon Segur 3eme Cru Classe, Saint-Estephe",Bordeaux,2002,19/06/2021,10074752002,1007475
907,18/06/2021,957,24,805,102,152,20/11/2019,"Chateau Calon Segur 3eme Cru Classe, Saint-Estephe",Bordeaux,2001,19/06/2021,10074752001,1007475
2795,28/05/2021,3183,10,2680,115,503,04/01/2021,"Chateau Angelus Premier Grand Cru Classe B, Saint-Emilion Grand Cru",Bordeaux,2004,29/05/2021,10060452004,1006045
2795,28/05/2021,3183,10,2680,115,503,04/01/2021,"Chateau Angelus Premier Grand Cru Classe B, Saint-Emilion Grand Cru",Bordeaux,2004,29/05/2021,10060452004,1006045
4850,18/06/2021,5651,30,4842,8,809,19/05/2021,"Chateau Margaux Premier Cru Classe, Margaux",Bordeaux,2003,19/06/2021,10127812003,1012781
3740,18/06/2021,3975,54,3520,220,455,07/04/2021,"Chateau Margaux Premier Cru Classe, Margaux",Bordeaux,2013,19/06/2021,10127812013,1012781
2795,27/05/2021,3210,9,2680,115,530,04/01/2021,"Chateau Angelus Premier Grand Cru Classe B, Saint-Emilion Grand Cru",Bordeaux,2004,28/05/2021,10060452004,1006045
3750,17/06/2021,4034,90,3690,60,344,13/04/2021,"Chateau Margaux Premier Cru Classe, Margaux",Bordeaux,2011,19/06/2021,10127812011,1012781
790,18/06/2021,904,22,801,-11,103,31/05/2021,"Chateau Calon Segur 3eme Cru Classe, Saint-Estephe",Bordeaux,2014,19/06/2021,10074752014,1007475
550,24/05/2021,542,3,420,130,122,09/07/2019,"Chateau Batailley 5eme Cru Classe, Pauillac",Bordeaux,2003,02/06/2021,10063222003,1006322
3900,18/06/2021,4607,88,3861,39,746,28/05/2021,"Chateau Margaux Premier Cru Classe, Margaux",Bordeaux,2006,19/06/2021,10127812006,1012781
1570,15/06/2021,1352,4,1200,370,152,06/03/2021,"Tignanello, Toscana",Tuscany,2007,19/06/2021,10953912007,1095391
3560,17/06/2021,4032,32,3525,35,507,18/06/2021,"Chateau Margaux Premier Cru Classe, Margaux",Bordeaux,2007,19/06/2021,10127812007,1012781
990,18/06/2021,1107,20,990,0,117,16/06/2021,"Chateau Calon Segur 3eme Cru Classe, Saint-Estephe",Bordeaux,2010,19/06/2021,10074752010,1007475
6830,17/06/2021,7680,47,7086,-256,594,11/06/2021,"Chateau Margaux Premier Cru Classe, Margaux",Bordeaux,2009,19/06/2021,10127812009,1012781
950,17/06/2021,1019,52,863,87,156,10/05/2021,"Chateau Calon Segur 3eme Cru Classe, Saint-Estephe",Bordeaux,2006,19/06/2021,10074752006,1007475
6400,18/06/2021,7375,43,6776,-376,599,10/06/2021,"Chateau Margaux Premier Cru Classe, Margaux",Bordeaux,2005,19/06/2021,10127812005,1012781
1000,18/06/2021,1143,78,988,12,155,28/05/2021,"Chateau Calon Segur 3eme Cru Classe, Saint-Estephe",Bordeaux,2005,19/06/2021,10074752005,1007475
2795,27/05/2021,3210,9,2680,115,530,04/01/2021,"Chateau Angelus Premier Grand Cru Classe B, Saint-Emilion Grand Cru",Bordeaux,2004,28/05/2021,10060452004,1006045
1000,24/05/2021,1158,42,1030,-30,128,25/05/2021,"Chateau Calon Segur 3eme Cru Classe, Saint-Estephe",Bordeaux,2009,26/05/2021,10074752009,1007475
3750,24/05/2021,4161,43,3560,190,601,20/11/2020,"Chateau Margaux Premier Cru Classe, Margaux",Bordeaux,2012,26/05/2021,10127812012,1012781
2795,26/05/2021,3210,9,2680,115,530,04/01/2021,"Chateau Angelus Premier Grand Cru Classe B, Saint-Emilion Grand Cru",Bordeaux,2004,27/05/2021,10060452004,1006045
8100,24/05/2021,8359,18,7950,150,409,12/03/2021,"Chateau Margaux Premier Cru Classe, Margaux",Bordeaux,2000,26/05/2021,10127812000,1012781
995,25/05/2021,1115,22,1000,-5,115,12/04/2021,"Chateau Calon Segur 3eme Cru Classe, Saint-Estephe",Bordeaux,2010,26/05/2021,10074752010,1007475
1280,25/05/2021,1328,6,1200,80,128,06/03/2021,"Tignanello, Toscana",Tuscany,2007,26/05/2021,10953912007,1095391
3827,25/05/2021,4513,61,4116,-289,397,25/02/2021,"Chateau Margaux Premier Cru Classe, Margaux",Bordeaux,2004,26/05/2021,10127812004,1012781
1100,25/05/2021,1513,7,1010,90,503,18/12/2020,"Tignanello, Toscana",Tuscany,2008,26/05/2021,10953912008,1095391
2232,25/05/2021,2351,5,2190,42,161,01/05/2021,"Gaja, Barbaresco",Piedmont,2004,26/05/2021,10996052004,1099605
2795,26/05/2021,3210,9,2680,115,530,04/01/2021,"Chateau Angelus Premier Grand Cru Classe B, Saint-Emilion Grand Cru",Bordeaux,2004,27/05/2021,10060452004,1006045
3800,25/05/2021,4045,78,3690,110,355,13/04/2021,"Chateau Margaux Premier Cru Classe, Margaux",Bordeaux,2011,26/05/2021,10127812011,1012781
2820,25/05/2021,3210,9,2680,140,530,04/01/2021,"Chateau Angelus Premier Grand Cru Classe B, Saint-Emilion Grand Cru",Bordeaux,2004,26/05/2021,10060452004,1006045
525,24/05/2021,538,1,300,225,238,15/12/2019,"Chateau Batailley 5eme Cru Classe, Pauillac",Bordeaux,2004,25/05/2021,10063222004,1006322
686,18/06/2021,855,10,682,4,173,15/09/2020,"Chateau Calon Segur 3eme Cru Classe, Saint-Estephe",Bordeaux,2013,19/06/2021,10074752013,1007475
2820,25/05/2021,3210,9,2680,140,530,04/01/2021,"Chateau Angelus Premier Grand Cru Classe B, Saint-Emilion Grand Cru",Bordeaux,2004,26/05/2021,10060452004,1006045
2950,24/05/2021,3210,9,2680,270,530,04/01/2021,"Chateau Angelus Premier Grand Cru Classe B, Saint-Emilion Grand Cru",Bordeaux,2004,25/05/2021,10060452004,1006045
1700,17/06/2021,1651,4,1378,322,273,29/07/2020,"Tignanello, Toscana",Tuscany,2001,19/06/2021,10953912001,1095391
880,17/06/2021,967,9,725,155,242,13/04/2021,"Chateau Calon Segur 3eme Cru Classe, Saint-Estephe",Bordeaux,2007,19/06/2021,10074752007,1007475
6450,17/06/2021,7403,58,6190,260,1213,23/05/2021,"Chateau Margaux Premier Cru Classe, Margaux",Bordeaux,2010,19/06/2021,10127812010,1012781
1299,15/06/2021,1445,8,1010,289,435,18/12/2020,"Tignanello, Toscana",Tuscany,2008,19/06/2021,10953912008,1095391
2950,24/05/2021,3210,9,2680,270,530,04/01/2021,"Chateau Angelus Premier Grand Cru Classe B, Saint-Emilion Grand Cru",Bordeaux,2004,25/05/2021,10060452004,1006045
880,25/05/2021,986,13,725,155,261,13/04/2021,"Chateau Calon Segur 3eme Cru Classe, Saint-Estephe",Bordeaux,2007,26/05/2021,10074752007,1007475
3702,19/05/2021,3662,2,1200,2502,2462,16/05/2012,"Gaja, Barbaresco",Piedmont,2001,26/05/2021,10996052001,1099605
2795,21/05/2021,3210,9,2680,115,530,04/01/2021,"Chateau Angelus Premier Grand Cru Classe B, Saint-Emilion Grand Cru",Bordeaux,2004,22/05/2021,10060452004,1006045
750,17/06/2021,933,23,745,5,188,16/11/2020,"Chateau Calon Segur 3eme Cru Classe, Saint-Estephe",Bordeaux,2004,19/06/2021,10074752004,1007475
750,25/05/2021,1016,51,790,-40,226,01/06/2020,"Chateau Calon Segur 3eme Cru Classe, Saint-Estephe",Bordeaux,2011,26/05/2021,10074752011,1007475
6250,25/05/2021,7073,39,6360,-110,713,24/05/2021,"Chateau Margaux Premier Cru Classe, Margaux",Bordeaux,2005,26/05/2021,10127812005,1012781
2795,21/05/2021,3210,9,2680,115,530,04/01/2021,"Chateau Angelus Premier Grand Cru Classe B, Saint-Emilion Grand Cru",Bordeaux,2004,22/05/2021,10060452004,1006045
4400,25/05/2021,4862,22,4400,0,462,29/09/2020,"Chateau Margaux Premier Cru Classe, Margaux",Bordeaux,2001,26/05/2021,10127812001,1012781
900,25/05/2021,1092,30,800,100,292,21/11/2019,"Chateau Calon Segur 3eme Cru Classe, Saint-Estephe",Bordeaux,2003,26/05/2021,10074752003,1007475
1408,17/06/2021,1385,5,1238,170,147,02/11/2020,"Tignanello, Toscana",Tuscany,2006,19/06/2021,10953912006,1095391
3826,18/06/2021,4510,52,4116,-290,394,25/02/2021,"Chateau Margaux Premier Cru Classe, Margaux",Bordeaux,2004,19/06/2021,10127812004,1012781
6750,25/05/2021,7647,42,6525,225,1122,23/05/2021,"Chateau Margaux Premier Cru Classe, Margaux",Bordeaux,2009,26/05/2021,10127812009,1012781
2795,20/05/2021,3210,9,2680,115,530,04/01/2021,"Chateau Angelus Premier Grand Cru Classe B, Saint-Emilion Grand Cru",Bordeaux,2004,21/05/2021,10060452004,1006045
450,24/05/2021,450,1,340,110,110,31/08/2018,"Chateau Batailley 5eme Cru Classe, Pauillac",Bordeaux,2007,25/05/2021,10063222007,1006322
9600,18/06/2021,9798,2,8000,1600,1798,30/01/2020,"Domaine Leflaive, Chevalier-Montrachet Grand Cru",Burgundy,2014,19/06/2021,10734012014,1073401
3900,18/06/2021,4226,75,3700,200,526,07/06/2021,"Chateau Margaux Premier Cru Classe, Margaux",Bordeaux,2008,19/06/2021,10127812008,1012781
10500,25/05/2021,12622,64,9844,656,2778,29/03/2021,"Chateau Margaux Premier Cru Classe, Margaux",Bordeaux,2015,26/05/2021,10127812015,1012781
1000,25/05/2021,1156,96,1000,0,156,25/05/2021,"Chateau Calon Segur 3eme Cru Classe, Saint-Estephe",Bordeaux,2005,26/05/2021,10074752005,1007475
885,25/05/2021,938,18,781,104,157,16/11/2020,"Chateau Calon Segur 3eme Cru Classe, Saint-Estephe",Bordeaux,2008,26/05/2021,10074752008,1007475
2795,20/05/2021,3210,9,2680,115,530,04/01/2021,"Chateau Angelus Premier Grand Cru Classe B, Saint-Emilion Grand Cru",Bordeaux,2004,21/05/2021,10060452004,1006045
3900,17/06/2021,4474,28,3684,216,790,10/06/2020,"Chateau Margaux Premier Cru Classe, Margaux",Bordeaux,2002,19/06/2021,10127812002,1012781
2795,19/05/2021,3210,9,2680,115,530,04/01/2021,"Chateau Angelus Premier Grand Cru Classe B, Saint-Emilion Grand Cru",Bordeaux,2004,20/05/2021,10060452004,1006045
490,24/05/2021,584,28,504,-14,80,06/04/2021,"Chateau Batailley 5eme Cru Classe, Pauillac",Bordeaux,2009,25/05/2021,10063222009,1006322
3740,25/05/2021,3967,45,3520,220,447,07/04/2021,"Chateau Margaux Premier Cru Classe, Margaux",Bordeaux,2013,26/05/2021,10127812013,1012781
6300,25/05/2021,7514,59,6190,110,1324,23/05/2021,"Chateau Margaux Premier Cru Classe, Margaux",Bordeaux,2010,26/05/2021,10127812010,1012781
3800,25/05/2021,4108,42,3480,320,628,10/04/2021,"Chateau Margaux Premier Cru Classe, Margaux",Bordeaux,2014,26/05/2021,10127812014,1012781
1280,25/05/2021,1367,8,1172,108,195,07/04/2021,"Tignanello, Toscana",Tuscany,2010,26/05/2021,10953912010,1095391
490,24/05/2021,584,28,504,-14,80,06/04/2021,"Chateau Batailley 5eme Cru Classe, Pauillac",Bordeaux,2009,25/05/2021,10063222009,1006322
950,25/05/2021,1003,58,863,87,140,10/05/2021,"Chateau Calon Segur 3eme Cru Classe, Saint-Estephe",Bordeaux,2006,26/05/2021,10074752006,1007475
2795,19/05/2021,3210,9,2680,115,530,04/01/2021,"Chateau Angelus Premier Grand Cru Classe B, Saint-Emilion Grand Cru",Bordeaux,2004,20/05/2021,10060452004,1006045
3900,25/05/2021,4517,30,3684,216,833,10/06/2020,"Chateau Margaux Premier Cru Classe, Margaux",Bordeaux,2002,26/05/2021,10127812002,1012781
3720,18/06/2021,4285,141,3480,240,805,17/06/2021,"Chateau Margaux Premier Cru Classe, Margaux",Bordeaux,2014,19/06/2021,10127812014,1012781
1100,17/06/2021,1154,37,1030,70,124,25/05/2021,"Chateau Calon Segur 3eme Cru Classe, Saint-Estephe",Bordeaux,2009,19/06/2021,10074752009,1007475
1024,25/05/2021,1178,11,1072,-48,106,20/01/2021,"Tignanello, Toscana",Tuscany,2009,26/05/2021,10953912009,1095391
490,24/05/2021,594,407,494,-4,100,20/04/2021,"Chateau Batailley 5eme Cru Classe, Pauillac",Bordeaux,2010,03/06/2021,10063222010,1006322
490,24/05/2021,594,408,494,-4,100,20/04/2021,"Chateau Batailley 5eme Cru Classe, Pauillac",Bordeaux,2010,25/05/2021,10063222010,1006322
850,18/05/2021,927,12,705,145,222,01/02/2021,"Chateau Calon Segur 3eme Cru Classe, Saint-Estephe",Bordeaux,2002,26/05/2021,10074752002,1007475
1020,25/05/2021,1048,10,860,160,188,08/03/2021,"Tignanello, Toscana",Tuscany,2011,26/05/2021,10953912011,1095391
2795,18/05/2021,3210,9,2680,115,530,04/01/2021,"Chateau Angelus Premier Grand Cru Classe B, Saint-Emilion Grand Cru",Bordeaux,2004,19/05/2021,10060452004,1006045
10500,18/06/2021,11892,55,9800,700,2092,11/06/2021,"Chateau Margaux Premier Cru Classe, Margaux",Bordeaux,2015,19/06/2021,10127812015,1012781
2795,18/05/2021,3210,9,2680,115,530,04/01/2021,"Chateau Angelus Premier Grand Cru Classe B, Saint-Emilion Grand Cru",Bordeaux,2004,19/05/2021,10060452004,1006045
2795,17/05/2021,3210,9,2680,115,530,04/01/2021,"Chateau Angelus Premier Grand Cru Classe B, Saint-Emilion Grand Cru",Bordeaux,2004,18/05/2021,10060452004,1006045
740,17/06/2021,987,40,790,-50,197,01/06/2020,"Chateau Calon Segur 3eme Cru Classe, Saint-Estephe",Bordeaux,2011,19/06/2021,10074752011,1007475
2795,17/05/2021,3210,9,2680,115,530,04/01/2021,"Chateau Angelus Premier Grand Cru Classe B, Saint-Emilion Grand Cru",Bordeaux,2004,18/05/2021,10060452004,1006045
3750,25/05/2021,4099,30,3592,158,507,06/05/2021,"Chateau Margaux Premier Cru Classe, Margaux",Bordeaux,2007,26/05/2021,10127812007,1012781
4850,20/05/2021,5806,27,4842,8,964,19/05/2021,"Chateau Margaux Premier Cru Classe, Margaux",Bordeaux,2003,26/05/2021,10127812003,1012781
2795,14/05/2021,3210,9,2680,115,530,04/01/2021,"Chateau Angelus Premier Grand Cru Classe B, Saint-Emilion Grand Cru",Bordeaux,2004,15/05/2021,10060452004,1006045
840,17/06/2021,1090,77,860,-20,230,19/04/2021,"Chateau Calon Segur 3eme Cru Classe, Saint-Estephe",Bordeaux,2015,19/06/2021,10074752015,1007475
3920,25/05/2021,4437,92,3800,120,637,12/05/2021,"Chateau Margaux Premier Cru Classe, Margaux",Bordeaux,2008,26/05/2021,10127812008,1012781
490,24/05/2021,594,408,494,-4,100,20/04/2021,"Chateau Batailley 5eme Cru Classe, Pauillac",Bordeaux,2010,25/05/2021,10063222010,1006322
2232,26/05/2021,2351,5,2190,42,161,01/05/2021,"Gaja, Barbaresco",Piedmont,2004,27/05/2021,10996052004,1099605
2795,14/05/2021,3210,9,2680,115,530,04/01/2021,"Chateau Angelus Premier Grand Cru Classe B, Saint-Emilion Grand Cru",Bordeaux,2004,15/05/2021,10060452004,1006045
2795,13/05/2021,3210,9,2680,115,530,04/01/2021,"Chateau Angelus Premier Grand Cru Classe B, Saint-Emilion Grand Cru",Bordeaux,2004,14/05/2021,10060452004,1006045
2795,13/05/2021,3210,9,2680,115,530,04/01/2021,"Chateau Angelus Premier Grand Cru Classe B, Saint-Emilion Grand Cru",Bordeaux,2004,14/05/2021,10060452004,1006045
2500,18/06/2021,3158,4,2220,280,938,14/06/2021,"Gaja, Barbaresco",Piedmont,2001,19/06/2021,10996052001,1099605
8300,02/08/2021,8830,13,8200,100,630,26/07/2021,"Chateau Margaux Premier Cru Classe, Margaux",Bordeaux,2000,03/08/2021,10127812000,1012781
2795,12/05/2021,3210,9,2680,115,530,04/01/2021,"Chateau Angelus Premier Grand Cru Classe B, Saint-Emilion Grand Cru",Bordeaux,2004,13/05/2021,10060452004,1006045
900,02/08/2021,1103,23,800,100,303,21/11/2019,"Chateau Calon Segur 3eme Cru Classe, Saint-Estephe",Bordeaux,2003,03/08/2021,10074752003,1007475
3900,02/08/2021,4432,22,3684,216,748,10/06/2020,"Chateau Margaux Premier Cru Classe, Margaux",Bordeaux,2002,03/08/2021,10127812002,1012781
4450,02/08/2021,4709,15,4400,50,309,29/09/2020,"Chateau Margaux Premier Cru Classe, Margaux",Bordeaux,2001,03/08/2021,10127812001,1012781
3826,02/08/2021,4640,45,4116,-290,524,25/02/2021,"Chateau Margaux Premier Cru Classe, Margaux",Bordeaux,2004,03/08/2021,10127812004,1012781
5100,02/08/2021,5753,25,4650,450,1103,21/06/2021,"Chateau Margaux Premier Cru Classe, Margaux",Bordeaux,2003,03/08/2021,10127812003,1012781
2795,12/05/2021,3210,9,2680,115,530,04/01/2021,"Chateau Angelus Premier Grand Cru Classe B, Saint-Emilion Grand Cru",Bordeaux,2004,13/05/2021,10060452004,1006045
2795,11/05/2021,3210,9,2680,115,530,04/01/2021,"Chateau Angelus Premier Grand Cru Classe B, Saint-Emilion Grand Cru",Bordeaux,2004,12/05/2021,10060452004,1006045
840,02/08/2021,1060,20,745,95,315,16/11/2020,"Chateau Calon Segur 3eme Cru Classe, Saint-Estephe",Bordeaux,2004,03/08/2021,10074752004,1007475
2795,11/05/2021,3210,9,2680,115,530,04/01/2021,"Chateau Angelus Premier Grand Cru Classe B, Saint-Emilion Grand Cru",Bordeaux,2004,12/05/2021,10060452004,1006045
907,02/08/2021,953,23,805,102,148,20/11/2019,"Chateau Calon Segur 3eme Cru Classe, Saint-Estephe",Bordeaux,2001,03/08/2021,10074752001,1007475
490,24/05/2021,594,407,494,-4,100,20/04/2021,"Chateau Batailley 5eme Cru Classe, Pauillac",Bordeaux,2010,03/06/2021,10063222010,1006322
2795,10/05/2021,3224,9,2680,115,544,04/01/2021,"Chateau Angelus Premier Grand Cru Classe B, Saint-Emilion Grand Cru",Bordeaux,2004,11/05/2021,10060452004,1006045
400,24/05/2021,468,6,300,100,168,05/11/2020,"Chateau Batailley 5eme Cru Classe, Pauillac",Bordeaux,2011,25/05/2021,10063222011,1006322
2795,10/05/2021,3224,9,2680,115,544,04/01/2021,"Chateau Angelus Premier Grand Cru Classe B, Saint-Emilion Grand Cru",Bordeaux,2004,11/05/2021,10060452004,1006045
6500,02/08/2021,7573,28,6400,100,1173,22/07/2021,"Chateau Margaux Premier Cru Classe, Margaux",Bordeaux,2005,03/08/2021,10127812005,1012781
990,02/08/2021,1179,63,1029,-39,150,21/07/2021,"Chateau Calon Segur 3eme Cru Classe, Saint-Estephe",Bordeaux,2005,03/08/2021,10074752005,1007475
400,24/05/2021,473,7,300,100,173,05/11/2020,"Chateau Batailley 5eme Cru Classe, Pauillac",Bordeaux,2011,26/05/2021,10063222011,1006322
2795,07/05/2021,3224,9,2680,115,544,04/01/2021,"Chateau Angelus Premier Grand Cru Classe B, Saint-Emilion Grand Cru",Bordeaux,2004,08/05/2021,10060452004,1006045
3900,02/08/2021,4649,99,3822,78,827,20/06/2021,"Chateau Margaux Premier Cru Classe, Margaux",Bordeaux,2006,03/08/2021,10127812006,1012781
400,24/05/2021,473,7,300,100,173,05/11/2020,"Chateau Batailley 5eme Cru Classe, Pauillac",Bordeaux,2011,26/05/2021,10063222011,1006322
3800,02/08/2021,4251,44,3525,275,726,18/06/2021,"Chateau Margaux Premier Cru Classe, Margaux",Bordeaux,2007,03/08/2021,10127812007,1012781
880,02/08/2021,967,9,725,155,242,13/04/2021,"Chateau Calon Segur 3eme Cru Classe, Saint-Estephe",Bordeaux,2007,03/08/2021,10074752007,1007475
2795,07/05/2021,3224,9,2680,115,544,04/01/2021,"Chateau Angelus Premier Grand Cru Classe B, Saint-Emilion Grand Cru",Bordeaux,2004,08/05/2021,10060452004,1006045
8400,02/08/2021,8400,1,5700,2700,2700,10/09/2020,"Domaine Leflaive, Chevalier-Montrachet Grand Cru",Burgundy,2007,03/08/2021,10734012007,1073401
2795,06/05/2021,3244,10,2680,115,564,04/01/2021,"Chateau Angelus Premier Grand Cru Classe B, Saint-Emilion Grand Cru",Bordeaux,2004,07/05/2021,10060452004,1006045
3950,02/08/2021,4407,97,3780,170,627,23/07/2021,"Chateau Margaux Premier Cru Classe, Margaux",Bordeaux,2008,03/08/2021,10127812008,1012781
895,02/08/2021,950,9,781,114,169,16/11/2020,"Chateau Calon Segur 3eme Cru Classe, Saint-Estephe",Bordeaux,2008,03/08/2021,10074752008,1007475
400,24/05/2021,468,6,300,100,168,05/11/2020,"Chateau Batailley 5eme Cru Classe, Pauillac",Bordeaux,2011,25/05/2021,10063222011,1006322
6930,02/08/2021,7680,74,7086,-156,594,11/06/2021,"Chateau Margaux Premier Cru Classe, Margaux",Bordeaux,2009,03/08/2021,10127812009,1012781
920,08/06/2021,1238,15,850,70,388,28/01/2021,"Tignanello, Toscana",Tuscany,2012,19/06/2021,10953912012,1095391
9000,02/08/2021,8799,1,5400,3600,3399,13/08/2020,"Domaine Leflaive, Chevalier-Montrachet Grand Cru",Burgundy,2008,03/08/2021,10734012008,1073401
996,02/08/2021,1258,40,1026,-30,232,24/06/2021,"Chateau Calon Segur 3eme Cru Classe, Saint-Estephe",Bordeaux,2009,03/08/2021,10074752009,1007475
300,24/05/2021,301,110,304,-4,-3,10/01/2021,"Chateau Batailley 5eme Cru Classe, Pauillac",Bordeaux,2013,25/05/2021,10063222013,1006322
2795,06/05/2021,3244,10,2680,115,564,04/01/2021,"Chateau Angelus Premier Grand Cru Classe B, Saint-Emilion Grand Cru",Bordeaux,2004,07/05/2021,10060452004,1006045
6400,18/06/2021,7397,42,6776,-376,621,10/06/2021,"Chateau Margaux Premier Cru Classe, Margaux",Bordeaux,2005,20/06/2021,10127812005,1012781
1310,17/06/2021,1378,5,1172,138,206,07/04/2021,"Tignanello, Toscana",Tuscany,2010,20/06/2021,10953912010,1095391
1800,02/08/2021,1700,1,1300,500,400,30/05/2019,"Gaja, Barbaresco",Piedmont,2007,03/08/2021,10996052007,1099605
2500,19/07/2021,2541,2,2400,100,141,18/07/2021,"Gaja, Barbaresco",Piedmont,2001,03/08/2021,10996052001,1099605
2386,02/08/2021,2471,2,2190,196,281,01/05/2021,"Gaja, Barbaresco",Piedmont,2004,03/08/2021,10996052004,1099605
520,02/08/2021,563,3,460,60,103,05/05/2020,"Tua Rita, Giusto di Notri, Toscana",Tuscany,2008,03/08/2021,11058072008,1105807
660,02/08/2021,727,5,390,270,337,18/08/2017,"Tua Rita, Giusto di Notri, Toscana",Tuscany,2006,03/08/2021,11058072006,1105807
540,02/07/2021,500,1,300,240,200,03/11/2011,"Tua Rita, Giusto di Notri, Toscana",Tuscany,2007,03/08/2021,11058072007,1105807
1584,02/08/2021,1704,3,1378,206,326,29/07/2020,"Tignanello, Toscana",Tuscany,2001,03/08/2021,10953912001,1095391
6400,02/08/2021,7587,65,6188,212,1399,16/07/2021,"Chateau Margaux Premier Cru Classe, Margaux",Bordeaux,2010,03/08/2021,10127812010,1012781
350,24/05/2021,368,91,324,26,44,20/04/2021,"Chateau Batailley 5eme Cru Classe, Pauillac",Bordeaux,2014,31/05/2021,10063222014,1006322
990,02/08/2021,1119,17,993,-3,126,27/07/2021,"Chateau Calon Segur 3eme Cru Classe, Saint-Estephe",Bordeaux,2010,03/08/2021,10074752010,1007475
2795,04/05/2021,3244,10,2680,115,564,04/01/2021,"Chateau Angelus Premier Grand Cru Classe B, Saint-Emilion Grand Cru",Bordeaux,2004,05/05/2021,10060452004,1006045
750,02/08/2021,899,29,790,-40,109,01/06/2020,"Chateau Calon Segur 3eme Cru Classe, Saint-Estephe",Bordeaux,2011,03/08/2021,10074752011,1007475
8400,02/08/2021,8400,1,5960,2440,2440,01/08/2017,"Domaine Leflaive, Chevalier-Montrachet Grand Cru",Burgundy,2010,03/08/2021,10734012010,1073401
1180,02/08/2021,1353,4,1140,40,213,21/07/2021,"Tignanello, Toscana",Tuscany,2009,03/08/2021,10953912009,1095391
1326,02/08/2021,1437,4,1170,156,267,24/06/2021,"Tignanello, Toscana",Tuscany,2010,03/08/2021,10953912010,1095391
3800,28/07/2021,4361,82,3690,110,671,13/04/2021,"Chateau Margaux Premier Cru Classe, Margaux",Bordeaux,2011,03/08/2021,10127812011,1012781
2795,04/05/2021,3244,10,2680,115,564,04/01/2021,"Chateau Angelus Premier Grand Cru Classe B, Saint-Emilion Grand Cru",Bordeaux,2004,05/05/2021,10060452004,1006045
2199,02/08/2021,2229,1,1340,859,889,13/03/2020,"Gaja, Barbaresco",Piedmont,2009,03/08/2021,10996052009,1099605
990,02/08/2021,1117,9,880,110,237,22/06/2021,"Tignanello, Toscana",Tuscany,2011,03/08/2021,10953912011,1095391
2795,03/05/2021,3385,12,2680,115,705,04/01/2021,"Chateau Angelus Premier Grand Cru Classe B, Saint-Emilion Grand Cru",Bordeaux,2004,04/05/2021,10060452004,1006045
350,24/05/2021,370,93,324,26,46,20/04/2021,"Chateau Batailley 5eme Cru Classe, Pauillac",Bordeaux,2014,25/05/2021,10063222014,1006322
820,02/08/2021,925,4,735,85,190,09/09/2020,"Chateau Calon Segur 3eme Cru Classe, Saint-Estephe",Bordeaux,2012,03/08/2021,10074752012,1007475
440,20/07/2021,588,4,342,98,246,21/08/2020,"Tua Rita, Giusto di Notri, Toscana",Tuscany,2011,03/08/2021,11058072011,1105807
3700,02/08/2021,4158,47,3520,180,638,07/04/2021,"Chateau Margaux Premier Cru Classe, Margaux",Bordeaux,2013,03/08/2021,10127812013,1012781
2795,03/05/2021,3385,12,2680,115,705,04/01/2021,"Chateau Angelus Premier Grand Cru Classe B, Saint-Emilion Grand Cru",Bordeaux,2004,04/05/2021,10060452004,1006045
350,24/05/2021,369,92,324,26,45,20/04/2021,"Chateau Batailley 5eme Cru Classe, Pauillac",Bordeaux,2014,29/05/2021,10063222014,1006322
800,02/08/2021,792,19,682,118,110,15/09/2020,"Chateau Calon Segur 3eme Cru Classe, Saint-Estephe",Bordeaux,2013,03/08/2021,10074752013,1007475
960,02/08/2021,1364,11,850,110,514,28/01/2021,"Tignanello, Toscana",Tuscany,2012,03/08/2021,10953912012,1095391
4425,09/08/2021,4894,45,4550,-125,344,15/07/2021,"Chateau Angelus Premier Grand Cru Classe B, Saint-Emilion Grand Cru",Bordeaux,2005,10/08/2021,10060452005,1006045
3800,02/08/2021,4350,126,3600,200,750,02/08/2021,"Chateau Margaux Premier Cru Classe, Margaux",Bordeaux,2014,03/08/2021,10127812014,1012781
790,02/08/2021,868,17,801,-11,67,31/05/2021,"Chateau Calon Segur 3eme Cru Classe, Saint-Estephe",Bordeaux,2014,03/08/2021,10074752014,1007475
477,24/05/2021,522,42,364,113,158,12/05/2021,"Chateau Batailley 5eme Cru Classe, Pauillac",Bordeaux,2016,25/05/2021,10063222016,1006322
1550,02/08/2021,1550,1,1300,250,250,27/04/2021,"Gaja, Barbaresco",Piedmont,2012,03/08/2021,10996052012,1099605
950,02/08/2021,1147,8,960,-10,187,27/07/2021,"Tignanello, Toscana",Tuscany,2013,03/08/2021,10953912013,1095391
1030,02/08/2021,1101,7,854,176,247,15/07/2021,"Tignanello, Toscana",Tuscany,2014,03/08/2021,10953912014,1095391
540,11/06/2021,579,1,544,-4,35,18/09/2020,"Tua Rita, Giusto di Notri, Toscana",Tuscany,2013,03/08/2021,11058072013,1105807
1400,02/08/2021,1427,9,1360,40,67,18/07/2021,"Gaja, Barbaresco",Piedmont,2013,03/08/2021,10996052013,1099605
10800,20/07/2021,10860,2,8000,2800,2860,30/01/2020,"Domaine Leflaive, Chevalier-Montrachet Grand Cru",Burgundy,2014,03/08/2021,10734012014,1073401
1573,28/07/2021,1674,7,1300,273,374,10/07/2021,"Gaja, Barbaresco",Piedmont,2014,03/08/2021,10996052014,1099605
4425,09/08/2021,4894,45,4550,-125,344,15/07/2021,"Chateau Angelus Premier Grand Cru Classe B, Saint-Emilion Grand Cru",Bordeaux,2005,10/08/2021,10060452005,1006045
940,02/08/2021,1073,78,866,74,207,20/07/2021,"Chateau Calon Segur 3eme Cru Classe, Saint-Estephe",Bordeaux,2015,03/08/2021,10074752015,1007475
10620,02/08/2021,11820,48,9800,820,2020,11/06/2021,"Chateau Margaux Premier Cru Classe, Margaux",Bordeaux,2015,03/08/2021,10127812015,1012781
14520,02/08/2021,14520,1,12000,2520,2520,28/05/2020,"Jacques-Frederic Mugnier, Chambolle-Musigny Premier Cru, Les Amoureuses",Burgundy,2014,03/08/2021,10496422014,1049642
1130,28/07/2021,1287,14,1012,118,275,02/07/2021,"Tignanello, Toscana",Tuscany,2015,03/08/2021,10953912015,1095391
487,02/08/2021,537,15,388,99,149,29/09/2020,"Tua Rita, Giusto di Notri, Toscana",Tuscany,2015,03/08/2021,11058072015,1105807
8000,02/08/2021,7964,1,7900,100,64,29/04/2019,"Domaine Leflaive, Chevalier-Montrachet Grand Cru",Burgundy,2015,03/08/2021,10734012015,1073401
15600,14/07/2021,15271,5,13000,2600,2271,29/04/2021,"Jacques-Frederic Mugnier, Chambolle-Musigny Premier Cru, Les Amoureuses",Burgundy,2017,15/07/2021,10496422017,1049642
4425,06/08/2021,4894,45,4550,-125,344,15/07/2021,"Chateau Angelus Premier Grand Cru Classe B, Saint-Emilion Grand Cru",Bordeaux,2005,07/08/2021,10060452005,1006045
1080,14/07/2021,1244,40,1058,22,186,14/07/2021,"Chateau Calon Segur 3eme Cru Classe, Saint-Estephe",Bordeaux,2018,15/07/2021,10074752018,1007475
16200,02/08/2021,16483,0,18750,-2550,-2267,29/08/2018,"Jacques-Frederic Mugnier, Chambolle-Musigny Premier Cru, Les Amoureuses",Burgundy,2015,03/08/2021,10496422015,1049642
5415,30/07/2021,5887,157,5500,-85,387,06/07/2021,"Chateau Margaux Premier Cru Classe, Margaux",Bordeaux,2016,03/08/2021,10127812016,1012781
4425,06/08/2021,4894,45,4550,-125,344,15/07/2021,"Chateau Angelus Premier Grand Cru Classe B, Saint-Emilion Grand Cru",Bordeaux,2005,07/08/2021,10060452005,1006045
1100,02/08/2021,1218,80,1036,64,182,27/05/2021,"Chateau Calon Segur 3eme Cru Classe, Saint-Estephe",Bordeaux,2016,03/08/2021,10074752016,1007475
1280,02/08/2021,1370,52,1220,60,150,14/07/2021,"Tignanello, Toscana",Tuscany,2016,03/08/2021,10953912016,1095391
1440,02/08/2021,1679,31,1510,-70,169,18/07/2021,"Gaja, Barbaresco",Piedmont,2016,03/08/2021,10996052016,1099605
4425,04/08/2021,4894,45,4550,-125,344,15/07/2021,"Chateau Angelus Premier Grand Cru Classe B, Saint-Emilion Grand Cru",Bordeaux,2005,06/08/2021,10060452005,1006045
780,02/08/2021,938,94,740,40,198,21/05/2021,"Chateau Calon Segur 3eme Cru Classe, Saint-Estephe",Bordeaux,2017,03/08/2021,10074752017,1007475
3820,02/08/2021,4613,210,3950,-130,663,30/06/2021,"Chateau Margaux Premier Cru Classe, Margaux",Bordeaux,2017,03/08/2021,10127812017,1012781
1350,02/08/2021,1481,55,1260,90,221,18/02/2021,"Gaja, Barbaresco",Piedmont,2015,03/08/2021,10996052015,1099605
479,30/07/2021,503,170,390,89,113,01/08/2021,"Tua Rita, Giusto di Notri, Toscana",Tuscany,2016,03/08/2021,11058072016,1105807
7800,02/08/2021,8910,2,6974,826,1936,14/03/2021,"Domaine Leflaive, Chevalier-Montrachet Grand Cru",Burgundy,2017,03/08/2021,10734012017,1073401
8098,02/08/2021,9871,3,7290,808,2581,21/08/2020,"Domaine Denis Mortet, Chambertin Grand Cru",Burgundy,2017,03/08/2021,10490202017,1049020
4425,04/08/2021,4892,45,4550,-125,342,15/07/2021,"Chateau Angelus Premier Grand Cru Classe B, Saint-Emilion Grand Cru",Bordeaux,2005,05/08/2021,10060452005,1006045
5600,02/08/2021,5967,61,5254,346,713,26/05/2021,"Chateau Margaux Premier Cru Classe, Margaux",Bordeaux,2018,03/08/2021,10127812018,1012781
857,14/07/2021,1008,120,848,9,160,02/07/2021,"Tignanello, Toscana",Tuscany,2017,15/07/2021,10953912017,1095391
8000,14/07/2021,8308,4,7330,670,978,02/06/2021,"Domaine Leflaive, Chevalier-Montrachet Grand Cru",Burgundy,2018,15/07/2021,10734012018,1073401
950,13/07/2021,1061,125,910,40,151,14/07/2021,"Tignanello, Toscana",Tuscany,2018,15/07/2021,10953912018,1095391
930,29/07/2021,994,97,864,66,130,26/07/2021,"Tignanello, Toscana",Tuscany,2017,03/08/2021,10953912017,1095391
487,02/08/2021,542,30,320,167,222,24/03/2021,"Tua Rita, Giusto di Notri, Toscana",Tuscany,2017,03/08/2021,11058072017,1105807
8568,02/08/2021,8734,3,7330,1238,1404,02/06/2021,"Domaine Leflaive, Chevalier-Montrachet Grand Cru",Burgundy,2018,03/08/2021,10734012018,1073401
408,24/05/2021,414,20,357,51,57,06/05/2021,"Chateau Batailley 5eme Cru Classe, Pauillac",Bordeaux,2018,25/05/2021,10063222018,1006322
920,02/08/2021,1034,40,842,78,192,22/08/2020,"Chateau Calon Segur 3eme Cru Classe, Saint-Estephe",Bordeaux,2019,03/08/2021,10074752019,1007475
5290,02/08/2021,5231,7,4160,1130,1071,19/03/2021,"Chateau Margaux Premier Cru Classe, Margaux",Bordeaux,2019,03/08/2021,10127812019,1012781
1480,26/07/2021,1615,86,1398,82,217,01/07/2021,"Gaja, Barbaresco",Piedmont,2017,03/08/2021,10996052017,1099605
430,20/07/2021,456,99,380,50,76,25/03/2021,"Tua Rita, Giusto di Notri, Toscana",Tuscany,2018,03/08/2021,11058072018,1105807
1624,02/08/2021,1734,18,1663,-39,71,01/08/2021,"Gaja, Barbaresco",Piedmont,2018,03/08/2021,10996052018,1099605
996,06/08/2021,1282,38,1026,-30,256,24/06/2021,"Chateau Calon Segur 3eme Cru Classe, Saint-Estephe",Bordeaux,2009,08/08/2021,10074752009,1007475
4425,04/08/2021,4894,45,4550,-125,344,15/07/2021,"Chateau Angelus Premier Grand Cru Classe B, Saint-Emilion Grand Cru",Bordeaux,2005,06/08/2021,10060452005,1006045
1516,22/06/2021,1565,174,1358,158,207,12/05/2021,"Gaja, Barbaresco",Piedmont,2017,28/06/2021,10996052017,1099605
4425,04/08/2021,4892,45,4550,-125,342,15/07/2021,"Chateau Angelus Premier Grand Cru Classe B, Saint-Emilion Grand Cru",Bordeaux,2005,05/08/2021,10060452005,1006045
857,15/06/2021,947,143,844,13,103,25/06/2021,"Tignanello, Toscana",Tuscany,2017,28/06/2021,10953912017,1095391
3560,25/06/2021,4172,44,3525,35,647,18/06/2021,"Chateau Margaux Premier Cru Classe, Margaux",Bordeaux,2007,28/06/2021,10127812007,1012781
5578,24/06/2021,5831,98,5238,340,593,17/05/2021,"Chateau Margaux Premier Cru Classe, Margaux",Bordeaux,2016,28/06/2021,10127812016,1012781
3900,25/06/2021,4634,95,3822,78,812,20/06/2021,"Chateau Margaux Premier Cru Classe, Margaux",Bordeaux,2006,28/06/2021,10127812006,1012781
4425,02/08/2021,4885,37,4550,-125,335,15/07/2021,"Chateau Angelus Premier Grand Cru Classe B, Saint-Emilion Grand Cru",Bordeaux,2005,03/08/2021,10060452005,1006045
7527,21/06/2021,9864,3,7290,237,2574,21/08/2020,"Domaine Denis Mortet, Chambertin Grand Cru",Burgundy,2017,28/06/2021,10490202017,1049020
1408,27/05/2021,1411,1,996,412,415,14/06/2019,"Tignanello, Toscana",Tuscany,2000,28/06/2021,10953912000,1095391
1500,25/06/2021,1681,48,1408,92,273,09/04/2021,"Gaja, Barbaresco",Piedmont,2016,28/06/2021,10996052016,1099605
1070,25/06/2021,1212,48,950,120,262,03/05/2021,"Chateau Calon Segur 3eme Cru Classe, Saint-Estephe",Bordeaux,2018,28/06/2021,10074752018,1007475
4425,02/08/2021,4892,45,4550,-125,342,15/07/2021,"Chateau Angelus Premier Grand Cru Classe B, Saint-Emilion Grand Cru",Bordeaux,2005,03/08/2021,10060452005,1006045
4425,02/08/2021,4892,45,4550,-125,342,15/07/2021,"Chateau Angelus Premier Grand Cru Classe B, Saint-Emilion Grand Cru",Bordeaux,2005,04/08/2021,10060452005,1006045
468,25/05/2021,582,2,465,3,117,04/05/2020,"Chateau Batailley 5eme Cru Classe, Pauillac",Bordeaux,2001,26/05/2021,10063222001,1006322
3770,23/06/2021,4210,108,3646,124,564,16/06/2021,"Chateau Margaux Premier Cru Classe, Margaux",Bordeaux,2017,28/06/2021,10127812017,1012781
1024,25/06/2021,1251,4,1072,-48,179,20/01/2021,"Tignanello, Toscana",Tuscany,2009,28/06/2021,10953912009,1095391
9600,18/06/2021,9792,1,8000,1600,1792,30/01/2020,"Domaine Leflaive, Chevalier-Montrachet Grand Cru",Burgundy,2014,28/06/2021,10734012014,1073401
487,21/06/2021,533,24,388,99,145,29/09/2020,"Tua Rita, Giusto di Notri, Toscana",Tuscany,2015,28/06/2021,11058072015,1105807
1238,23/06/2021,1268,38,1050,188,218,10/06/2021,"Tignanello, Toscana",Tuscany,2016,28/06/2021,10953912016,1095391
4425,02/08/2021,4885,37,4550,-125,335,15/07/2021,"Chateau Angelus Premier Grand Cru Classe B, Saint-Emilion Grand Cru",Bordeaux,2005,03/08/2021,10060452005,1006045
750,17/06/2021,929,105,740,10,189,21/05/2021,"Chateau Calon Segur 3eme Cru Classe, Saint-Estephe",Bordeaux,2017,28/06/2021,10074752017,1007475
1350,24/06/2021,1474,60,1260,90,214,18/02/2021,"Gaja, Barbaresco",Piedmont,2015,28/06/2021,10996052015,1099605
4425,30/07/2021,4891,36,4550,-125,341,15/07/2021,"Chateau Angelus Premier Grand Cru Classe B, Saint-Emilion Grand Cru",Bordeaux,2005,31/07/2021,10060452005,1006045
15600,23/06/2021,15135,5,13000,2600,2135,29/04/2021,"Jacques-Frederic Mugnier, Chambolle-Musigny Premier Cru, Les Amoureuses",Burgundy,2017,28/06/2021,10496422017,1049642
860,25/06/2021,1037,68,910,-50,127,23/06/2021,"Tignanello, Toscana",Tuscany,2018,28/06/2021,10953912018,1095391
1000,07/06/2021,1163,42,1030,-30,133,25/05/2021,"Chateau Calon Segur 3eme Cru Classe, Saint-Estephe",Bordeaux,2009,08/06/2021,10074752009,1007475
1050,03/06/2021,1146,6,860,190,286,08/03/2021,"Tignanello, Toscana",Tuscany,2013,08/06/2021,10953912013,1095391
950,07/06/2021,1007,57,863,87,144,10/05/2021,"Chateau Calon Segur 3eme Cru Classe, Saint-Estephe",Bordeaux,2006,08/06/2021,10074752006,1007475
1024,07/06/2021,1202,9,1072,-48,130,20/01/2021,"Tignanello, Toscana",Tuscany,2009,08/06/2021,10953912009,1095391
1700,07/06/2021,1658,4,1378,322,280,29/07/2020,"Tignanello, Toscana",Tuscany,2001,08/06/2021,10953912001,1095391
4425,30/07/2021,4891,36,4550,-125,341,15/07/2021,"Chateau Angelus Premier Grand Cru Classe B, Saint-Emilion Grand Cru",Bordeaux,2005,31/07/2021,10060452005,1006045
3740,07/06/2021,3976,53,3520,220,456,07/04/2021,"Chateau Margaux Premier Cru Classe, Margaux",Bordeaux,2013,08/06/2021,10127812013,1012781
1408,07/06/2021,1394,5,1238,170,156,02/11/2020,"Tignanello, Toscana",Tuscany,2006,08/06/2021,10953912006,1095391
10500,07/06/2021,12094,52,9844,656,2250,29/03/2021,"Chateau Margaux Premier Cru Classe, Margaux",Bordeaux,2015,08/06/2021,10127812015,1012781
3900,07/06/2021,4613,95,3861,39,752,28/05/2021,"Chateau Margaux Premier Cru Classe, Margaux",Bordeaux,2006,08/06/2021,10127812006,1012781
6830,07/06/2021,7660,50,6525,305,1135,23/05/2021,"Chateau Margaux Premier Cru Classe, Margaux",Bordeaux,2009,08/06/2021,10127812009,1012781
686,07/06/2021,828,13,682,4,146,15/09/2020,"Chateau Calon Segur 3eme Cru Classe, Saint-Estephe",Bordeaux,2013,08/06/2021,10074752013,1007475
907,07/06/2021,956,23,805,102,151,20/11/2019,"Chateau Calon Segur 3eme Cru Classe, Saint-Estephe",Bordeaux,2001,08/06/2021,10074752001,1007475
990,07/06/2021,1110,21,1000,-10,110,12/04/2021,"Chateau Calon Segur 3eme Cru Classe, Saint-Estephe",Bordeaux,2010,08/06/2021,10074752010,1007475
6250,04/06/2021,7429,49,6360,-110,1069,24/05/2021,"Chateau Margaux Premier Cru Classe, Margaux",Bordeaux,2005,08/06/2021,10127812005,1012781
2500,07/06/2021,3334,3,1200,1300,2134,16/05/2012,"Gaja, Barbaresco",Piedmont,2001,08/06/2021,10996052001,1099605
4850,04/06/2021,5597,33,4842,8,755,19/05/2021,"Chateau Margaux Premier Cru Classe, Margaux",Bordeaux,2003,08/06/2021,10127812003,1012781
412,25/05/2021,437,2,220,192,217,17/06/2015,"Chateau Batailley 5eme Cru Classe, Pauillac",Bordeaux,2002,26/05/2021,10063222002,1006322
589,25/05/2021,672,95,450,139,222,04/05/2021,"Chateau Batailley 5eme Cru Classe, Pauillac",Bordeaux,2005,26/05/2021,10063222005,1006322
750,07/06/2021,1007,50,790,-40,217,01/06/2020,"Chateau Calon Segur 3eme Cru Classe, Saint-Estephe",Bordeaux,2011,08/06/2021,10074752011,1007475
3826,07/06/2021,4526,58,4116,-290,410,25/02/2021,"Chateau Margaux Premier Cru Classe, Margaux",Bordeaux,2004,08/06/2021,10127812004,1012781
1290,07/06/2021,1352,8,1172,118,180,07/04/2021,"Tignanello, Toscana",Tuscany,2010,08/06/2021,10953912010,1095391
589,25/05/2021,672,95,450,139,222,04/05/2021,"Chateau Batailley 5eme Cru Classe, Pauillac",Bordeaux,2005,26/05/2021,10063222005,1006322
4425,28/07/2021,4889,35,4550,-125,339,15/07/2021,"Chateau Angelus Premier Grand Cru Classe B, Saint-Emilion Grand Cru",Bordeaux,2005,29/07/2021,10060452005,1006045
8100,07/06/2021,8471,19,7950,150,521,12/03/2021,"Chateau Margaux Premier Cru Classe, Margaux",Bordeaux,2000,08/06/2021,10127812000,1012781
4425,28/07/2021,4891,36,4550,-125,341,15/07/2021,"Chateau Angelus Premier Grand Cru Classe B, Saint-Emilion Grand Cru",Bordeaux,2005,30/07/2021,10060452005,1006045
3758,07/06/2021,4050,97,3690,68,360,13/04/2021,"Chateau Margaux Premier Cru Classe, Margaux",Bordeaux,2011,08/06/2021,10127812011,1012781
3750,04/06/2021,4201,39,3560,190,641,20/11/2020,"Chateau Margaux Premier Cru Classe, Margaux",Bordeaux,2012,08/06/2021,10127812012,1012781
4425,28/07/2021,4889,35,4550,-125,339,15/07/2021,"Chateau Angelus Premier Grand Cru Classe B, Saint-Emilion Grand Cru",Bordeaux,2005,29/07/2021,10060452005,1006045
790,03/06/2021,1089,79,860,-70,229,19/04/2021,"Chateau Calon Segur 3eme Cru Classe, Saint-Estephe",Bordeaux,2015,08/06/2021,10074752015,1007475
900,07/06/2021,1090,29,800,100,290,21/11/2019,"Chateau Calon Segur 3eme Cru Classe, Saint-Estephe",Bordeaux,2003,08/06/2021,10074752003,1007475
450,25/05/2021,450,1,340,110,110,31/08/2018,"Chateau Batailley 5eme Cru Classe, Pauillac",Bordeaux,2007,26/05/2021,10063222007,1006322
4425,28/07/2021,4891,36,4550,-125,341,15/07/2021,"Chateau Angelus Premier Grand Cru Classe B, Saint-Emilion Grand Cru",Bordeaux,2005,30/07/2021,10060452005,1006045
1000,07/06/2021,1153,98,988,12,165,28/05/2021,"Chateau Calon Segur 3eme Cru Classe, Saint-Estephe",Bordeaux,2005,08/06/2021,10074752005,1007475
6300,07/06/2021,7458,64,6190,110,1268,23/05/2021,"Chateau Margaux Premier Cru Classe, Margaux",Bordeaux,2010,08/06/2021,10127812010,1012781
490,25/05/2021,584,28,450,40,134,25/05/2021,"Chateau Batailley 5eme Cru Classe, Pauillac",Bordeaux,2009,26/05/2021,10063222009,1006322
880,03/06/2021,934,13,781,99,153,16/11/2020,"Chateau Calon Segur 3eme Cru Classe, Saint-Estephe",Bordeaux,2008,08/06/2021,10074752008,1007475
4425,26/07/2021,4889,35,4550,-125,339,15/07/2021,"Chateau Angelus Premier Grand Cru Classe B, Saint-Emilion Grand Cru",Bordeaux,2005,27/07/2021,10060452005,1006045
1028,27/05/2021,1055,8,860,168,195,08/03/2021,"Tignanello, Toscana",Tuscany,2011,08/06/2021,10953912011,1095391
4425,26/07/2021,4889,35,4550,-125,339,15/07/2021,"Chateau Angelus Premier Grand Cru Classe B, Saint-Emilion Grand Cru",Bordeaux,2005,27/07/2021,10060452005,1006045
1050,07/06/2021,1212,23,940,110,272,18/03/2021,"Chateau Calon Segur 3eme Cru Classe, Saint-Estephe",Bordeaux,2000,08/06/2021,10074752000,1007475
4425,23/07/2021,4889,36,4550,-125,339,15/07/2021,"Chateau Angelus Premier Grand Cru Classe B, Saint-Emilion Grand Cru",Bordeaux,2005,24/07/2021,10060452005,1006045
4425,23/07/2021,4889,35,4550,-125,339,15/07/2021,"Chateau Angelus Premier Grand Cru Classe B, Saint-Emilion Grand Cru",Bordeaux,2005,26/07/2021,10060452005,1006045
4425,23/07/2021,4889,36,4550,-125,339,15/07/2021,"Chateau Angelus Premier Grand Cru Classe B, Saint-Emilion Grand Cru",Bordeaux,2005,24/07/2021,10060452005,1006045
880,07/06/2021,986,13,725,155,261,13/04/2021,"Chateau Calon Segur 3eme Cru Classe, Saint-Estephe",Bordeaux,2007,08/06/2021,10074752007,1007475
789,28/05/2021,976,21,745,44,231,16/11/2020,"Chateau Calon Segur 3eme Cru Classe, Saint-Estephe",Bordeaux,2004,29/05/2021,10074752004,1007475
8040,28/05/2021,8474,23,7950,90,524,12/03/2021,"Chateau Margaux Premier Cru Classe, Margaux",Bordeaux,2000,29/05/2021,10127812000,1012781
950,28/05/2021,1003,59,863,87,140,10/05/2021,"Chateau Calon Segur 3eme Cru Classe, Saint-Estephe",Bordeaux,2006,29/05/2021,10074752006,1007475
6750,28/05/2021,7626,45,6525,225,1101,23/05/2021,"Chateau Margaux Premier Cru Classe, Margaux",Bordeaux,2009,29/05/2021,10127812009,1012781
3560,07/06/2021,4098,34,3592,-32,506,06/05/2021,"Chateau Margaux Premier Cru Classe, Margaux",Bordeaux,2007,08/06/2021,10127812007,1012781
2232,28/05/2021,2358,5,2190,42,168,01/05/2021,"Gaja, Barbaresco",Piedmont,2004,29/05/2021,10996052004,1099605
1000,28/05/2021,1158,42,1030,-30,128,25/05/2021,"Chateau Calon Segur 3eme Cru Classe, Saint-Estephe",Bordeaux,2009,29/05/2021,10074752009,1007475
1040,28/07/2021,1377,68,940,100,437,18/03/2021,"Chateau Calon Segur 3eme Cru Classe, Saint-Estephe",Bordeaux,2000,29/07/2021,10074752000,1007475
870,28/07/2021,966,5,705,165,261,01/02/2021,"Chateau Calon Segur 3eme Cru Classe, Saint-Estephe",Bordeaux,2002,29/07/2021,10074752002,1007475
4425,23/07/2021,4889,35,4550,-125,339,15/07/2021,"Chateau Angelus Premier Grand Cru Classe B, Saint-Emilion Grand Cru",Bordeaux,2005,26/07/2021,10060452005,1006045
3720,07/06/2021,4294,147,3480,240,814,10/04/2021,"Chateau Margaux Premier Cru Classe, Margaux",Bordeaux,2014,08/06/2021,10127812014,1012781
4425,21/07/2021,4889,36,4550,-125,339,15/07/2021,"Chateau Angelus Premier Grand Cru Classe B, Saint-Emilion Grand Cru",Bordeaux,2005,22/07/2021,10060452005,1006045
3900,07/06/2021,4431,108,3700,200,731,07/06/2021,"Chateau Margaux Premier Cru Classe, Margaux",Bordeaux,2008,08/06/2021,10127812008,1012781
870,07/06/2021,948,10,705,165,243,01/02/2021,"Chateau Calon Segur 3eme Cru Classe, Saint-Estephe",Bordeaux,2002,08/06/2021,10074752002,1007475
4425,21/07/2021,4889,36,4550,-125,339,15/07/2021,"Chateau Angelus Premier Grand Cru Classe B, Saint-Emilion Grand Cru",Bordeaux,2005,22/07/2021,10060452005,1006045
9600,27/05/2021,9884,2,8000,1600,1884,30/01/2020,"Domaine Leflaive, Chevalier-Montrachet Grand Cru",Burgundy,2014,29/05/2021,10734012014,1073401
3758,28/05/2021,4011,98,3690,68,321,13/04/2021,"Chateau Margaux Premier Cru Classe, Margaux",Bordeaux,2011,29/05/2021,10127812011,1012781
1020,26/05/2021,1050,9,860,160,190,08/03/2021,"Tignanello, Toscana",Tuscany,2011,29/05/2021,10953912011,1095391
4425,19/07/2021,4889,36,4550,-125,339,15/07/2021,"Chateau Angelus Premier Grand Cru Classe B, Saint-Emilion Grand Cru",Bordeaux,2005,20/07/2021,10060452005,1006045
4425,19/07/2021,4889,36,4550,-125,339,15/07/2021,"Chateau Angelus Premier Grand Cru Classe B, Saint-Emilion Grand Cru",Bordeaux,2005,20/07/2021,10060452005,1006045
4425,16/07/2021,4871,36,4550,-125,321,15/07/2021,"Chateau Angelus Premier Grand Cru Classe B, Saint-Emilion Grand Cru",Bordeaux,2005,17/07/2021,10060452005,1006045
900,28/07/2021,1115,23,800,100,315,21/11/2019,"Chateau Calon Segur 3eme Cru Classe, Saint-Estephe",Bordeaux,2003,29/07/2021,10074752003,1007475
4450,28/07/2021,4693,16,4400,50,293,29/09/2020,"Chateau Margaux Premier Cru Classe, Margaux",Bordeaux,2001,29/07/2021,10127812001,1012781
3900,28/07/2021,4417,22,3684,216,733,10/06/2020,"Chateau Margaux Premier Cru Classe, Margaux",Bordeaux,2002,29/07/2021,10127812002,1012781
3840,28/07/2021,4594,48,4116,-276,478,25/02/2021,"Chateau Margaux Premier Cru Classe, Margaux",Bordeaux,2004,29/07/2021,10127812004,1012781
5040,28/07/2021,5997,23,4650,390,1347,21/06/2021,"Chateau Margaux Premier Cru Classe, Margaux",Bordeaux,2003,29/07/2021,10127812003,1012781
4425,16/07/2021,4890,35,4550,-125,340,15/07/2021,"Chateau Angelus Premier Grand Cru Classe B, Saint-Emilion Grand Cru",Bordeaux,2005,19/07/2021,10060452005,1006045
4425,16/07/2021,4871,36,4550,-125,321,15/07/2021,"Chateau Angelus Premier Grand Cru Classe B, Saint-Emilion Grand Cru",Bordeaux,2005,17/07/2021,10060452005,1006045
907,07/06/2021,957,24,805,102,152,20/11/2019,"Chateau Calon Segur 3eme Cru Classe, Saint-Estephe",Bordeaux,2001,09/06/2021,10074752001,1007475
5489,08/06/2021,5489,0,5700,-211,-211,10/09/2020,"Domaine Leflaive, Chevalier-Montrachet Grand Cru",Burgundy,2007,09/06/2021,10734012007,1073401
6830,07/06/2021,7662,50,6525,305,1137,23/05/2021,"Chateau Margaux Premier Cru Classe, Margaux",Bordeaux,2009,09/06/2021,10127812009,1012781
1050,28/05/2021,1137,7,860,190,277,08/03/2021,"Tignanello, Toscana",Tuscany,2013,29/05/2021,10953912013,1095391
490,25/05/2021,584,28,450,40,134,25/05/2021,"Chateau Batailley 5eme Cru Classe, Pauillac",Bordeaux,2009,26/05/2021,10063222009,1006322
4425,16/07/2021,4890,35,4550,-125,340,15/07/2021,"Chateau Angelus Premier Grand Cru Classe B, Saint-Emilion Grand Cru",Bordeaux,2005,19/07/2021,10060452005,1006045
5865,28/05/2021,7455,59,6190,-325,1265,23/05/2021,"Chateau Margaux Premier Cru Classe, Margaux",Bordeaux,2010,29/05/2021,10127812010,1012781
950,18/05/2021,1107,40,830,120,277,18/04/2021,"Tignanello, Toscana",Tuscany,2014,29/05/2021,10953912014,1095391
3900,28/05/2021,4712,77,3861,39,851,28/05/2021,"Chateau Margaux Premier Cru Classe, Margaux",Bordeaux,2006,29/05/2021,10127812006,1012781
4425,14/07/2021,4858,36,4550,-125,308,09/07/2021,"Chateau Angelus Premier Grand Cru Classe B, Saint-Emilion Grand Cru",Bordeaux,2005,15/07/2021,10060452005,1006045
990,28/05/2021,1153,97,988,2,165,28/05/2021,"Chateau Calon Segur 3eme Cru Classe, Saint-Estephe",Bordeaux,2005,29/05/2021,10074752005,1007475
1050,28/05/2021,1213,22,940,110,273,18/03/2021,"Chateau Calon Segur 3eme Cru Classe, Saint-Estephe",Bordeaux,2000,29/05/2021,10074752000,1007475
1290,28/05/2021,1368,8,1172,118,196,07/04/2021,"Tignanello, Toscana",Tuscany,2010,29/05/2021,10953912010,1095391
990,28/05/2021,1114,22,1000,-10,114,12/04/2021,"Chateau Calon Segur 3eme Cru Classe, Saint-Estephe",Bordeaux,2010,29/05/2021,10074752010,1007475
4425,14/07/2021,4858,36,4550,-125,308,09/07/2021,"Chateau Angelus Premier Grand Cru Classe B, Saint-Emilion Grand Cru",Bordeaux,2005,15/07/2021,10060452005,1006045
1700,28/05/2021,1658,4,1378,322,280,29/07/2020,"Tignanello, Toscana",Tuscany,2001,29/05/2021,10953912001,1095391
3720,28/05/2021,4118,48,3480,240,638,10/04/2021,"Chateau Margaux Premier Cru Classe, Margaux",Bordeaux,2014,29/05/2021,10127812014,1012781
4850,27/05/2021,5666,35,4842,8,824,19/05/2021,"Chateau Margaux Premier Cru Classe, Margaux",Bordeaux,2003,29/05/2021,10127812003,1012781
840,28/07/2021,1059,20,745,95,314,16/11/2020,"Chateau Calon Segur 3eme Cru Classe, Saint-Estephe",Bordeaux,2004,29/07/2021,10074752004,1007475
907,28/07/2021,951,22,805,102,146,20/11/2019,"Chateau Calon Segur 3eme Cru Classe, Saint-Estephe",Bordeaux,2001,29/07/2021,10074752001,1007475
885,28/05/2021,936,18,781,104,155,16/11/2020,"Chateau Calon Segur 3eme Cru Classe, Saint-Estephe",Bordeaux,2008,29/05/2021,10074752008,1007475
3900,25/05/2021,4508,29,3684,216,824,10/06/2020,"Chateau Margaux Premier Cru Classe, Margaux",Bordeaux,2002,29/05/2021,10127812002,1012781
907,28/05/2021,927,19,805,102,122,20/11/2019,"Chateau Calon Segur 3eme Cru Classe, Saint-Estephe",Bordeaux,2001,29/05/2021,10074752001,1007475
4425,14/07/2021,4871,36,4550,-125,321,15/07/2021,"Chateau Angelus Premier Grand Cru Classe B, Saint-Emilion Grand Cru",Bordeaux,2005,16/07/2021,10060452005,1006045
3900,28/05/2021,4433,92,3800,100,633,12/05/2021,"Chateau Margaux Premier Cru Classe, Margaux",Bordeaux,2008,29/05/2021,10127812008,1012781
490,25/05/2021,594,408,494,-4,100,20/04/2021,"Chateau Batailley 5eme Cru Classe, Pauillac",Bordeaux,2010,26/05/2021,10063222010,1006322
4425,14/07/2021,4871,36,4550,-125,321,15/07/2021,"Chateau Angelus Premier Grand Cru Classe B, Saint-Emilion Grand Cru",Bordeaux,2005,16/07/2021,10060452005,1006045
490,25/05/2021,594,408,494,-4,100,20/04/2021,"Chateau Batailley 5eme Cru Classe, Pauillac",Bordeaux,2010,26/05/2021,10063222010,1006322
4425,12/07/2021,4858,36,4550,-125,308,09/07/2021,"Chateau Angelus Premier Grand Cru Classe B, Saint-Emilion Grand Cru",Bordeaux,2005,13/07/2021,10060452005,1006045
300,25/05/2021,301,110,304,-4,-3,10/01/2021,"Chateau Batailley 5eme Cru Classe, Pauillac",Bordeaux,2013,26/05/2021,10063222013,1006322
6500,27/07/2021,7512,27,6400,100,1112,22/07/2021,"Chateau Margaux Premier Cru Classe, Margaux",Bordeaux,2005,29/07/2021,10127812005,1012781
4425,12/07/2021,4858,36,4550,-125,308,09/07/2021,"Chateau Angelus Premier Grand Cru Classe B, Saint-Emilion Grand Cru",Bordeaux,2005,13/07/2021,10060452005,1006045
990,26/07/2021,1179,62,1029,-39,150,21/07/2021,"Chateau Calon Segur 3eme Cru Classe, Saint-Estephe",Bordeaux,2005,29/07/2021,10074752005,1007475
10200,28/05/2021,12604,65,9844,356,2760,29/03/2021,"Chateau Margaux Premier Cru Classe, Margaux",Bordeaux,2015,29/05/2021,10127812015,1012781
3750,28/05/2021,4098,36,3592,158,506,06/05/2021,"Chateau Margaux Premier Cru Classe, Margaux",Bordeaux,2007,29/05/2021,10127812007,1012781
3720,26/05/2021,4110,42,3480,240,630,10/04/2021,"Chateau Margaux Premier Cru Classe, Margaux",Bordeaux,2014,27/05/2021,10127812014,1012781
4850,20/05/2021,5700,32,4842,8,858,19/05/2021,"Chateau Margaux Premier Cru Classe, Margaux",Bordeaux,2003,27/05/2021,10127812003,1012781
1050,24/05/2021,1219,19,940,110,279,18/03/2021,"Chateau Calon Segur 3eme Cru Classe, Saint-Estephe",Bordeaux,2000,27/05/2021,10074752000,1007475
6250,26/05/2021,7073,39,6360,-110,713,24/05/2021,"Chateau Margaux Premier Cru Classe, Margaux",Bordeaux,2005,27/05/2021,10127812005,1012781
4350,09/07/2021,4837,34,4550,-200,287,09/07/2021,"Chateau Angelus Premier Grand Cru Classe B, Saint-Emilion Grand Cru",Bordeaux,2005,10/07/2021,10060452005,1006045
3758,26/05/2021,4045,78,3690,68,355,13/04/2021,"Chateau Margaux Premier Cru Classe, Margaux",Bordeaux,2011,27/05/2021,10127812011,1012781
3860,19/05/2021,4713,78,3800,60,913,07/04/2021,"Chateau Margaux Premier Cru Classe, Margaux",Bordeaux,2006,27/05/2021,10127812006,1012781
1100,26/05/2021,1513,7,1010,90,503,18/12/2020,"Tignanello, Toscana",Tuscany,2008,27/05/2021,10953912008,1095391
3740,26/05/2021,3967,45,3520,220,447,07/04/2021,"Chateau Margaux Premier Cru Classe, Margaux",Bordeaux,2013,27/05/2021,10127812013,1012781
3740,28/05/2021,3991,52,3520,220,471,07/04/2021,"Chateau Margaux Premier Cru Classe, Margaux",Bordeaux,2013,29/05/2021,10127812013,1012781
415,25/05/2021,525,44,364,51,161,12/05/2021,"Chateau Batailley 5eme Cru Classe, Pauillac",Bordeaux,2016,31/05/2021,10063222016,1006322
4400,28/05/2021,4852,22,4400,0,452,29/09/2020,"Chateau Margaux Premier Cru Classe, Margaux",Bordeaux,2001,29/05/2021,10127812001,1012781
780,28/05/2021,842,12,682,98,160,15/09/2020,"Chateau Calon Segur 3eme Cru Classe, Saint-Estephe",Bordeaux,2013,29/05/2021,10074752013,1007475
6250,28/05/2021,7278,54,6360,-110,918,24/05/2021,"Chateau Margaux Premier Cru Classe, Margaux",Bordeaux,2005,29/05/2021,10127812005,1012781
3900,25/05/2021,4505,29,3684,216,821,10/06/2020,"Chateau Margaux Premier Cru Classe, Margaux",Bordeaux,2002,27/05/2021,10127812002,1012781
10660,26/05/2021,12622,64,9844,816,2778,29/03/2021,"Chateau Margaux Premier Cru Classe, Margaux",Bordeaux,2015,27/05/2021,10127812015,1012781
4350,09/07/2021,4837,34,4550,-200,287,09/07/2021,"Chateau Angelus Premier Grand Cru Classe B, Saint-Emilion Grand Cru",Bordeaux,2005,10/07/2021,10060452005,1006045
3750,26/05/2021,4115,32,3592,158,523,06/05/2021,"Chateau Margaux Premier Cru Classe, Margaux",Bordeaux,2007,27/05/2021,10127812007,1012781
4350,08/07/2021,4837,34,4220,130,617,01/06/2021,"Chateau Angelus Premier Grand Cru Classe B, Saint-Emilion Grand Cru",Bordeaux,2005,09/07/2021,10060452005,1006045
1299,27/05/2021,1464,9,1010,289,454,18/12/2020,"Tignanello, Toscana",Tuscany,2008,29/05/2021,10953912008,1095391
415,25/05/2021,522,42,364,51,158,12/05/2021,"Chateau Batailley 5eme Cru Classe, Pauillac",Bordeaux,2016,26/05/2021,10063222016,1006322
850,18/05/2021,945,10,705,145,240,01/02/2021,"Chateau Calon Segur 3eme Cru Classe, Saint-Estephe",Bordeaux,2002,29/05/2021,10074752002,1007475
4350,08/07/2021,4837,34,4220,130,617,01/06/2021,"Chateau Angelus Premier Grand Cru Classe B, Saint-Emilion Grand Cru",Bordeaux,2005,09/07/2021,10060452005,1006045
908,26/05/2021,927,19,805,103,122,20/11/2019,"Chateau Calon Segur 3eme Cru Classe, Saint-Estephe",Bordeaux,2001,27/05/2021,10074752001,1007475
1000,26/05/2021,1156,96,1000,0,156,25/05/2021,"Chateau Calon Segur 3eme Cru Classe, Saint-Estephe",Bordeaux,2005,27/05/2021,10074752005,1007475
4350,06/07/2021,4803,29,4220,130,583,01/06/2021,"Chateau Angelus Premier Grand Cru Classe B, Saint-Emilion Grand Cru",Bordeaux,2005,07/07/2021,10060452005,1006045
6750,26/05/2021,7647,42,6525,225,1122,23/05/2021,"Chateau Margaux Premier Cru Classe, Margaux",Bordeaux,2009,27/05/2021,10127812009,1012781
880,26/05/2021,986,13,725,155,261,13/04/2021,"Chateau Calon Segur 3eme Cru Classe, Saint-Estephe",Bordeaux,2007,27/05/2021,10074752007,1007475
6300,26/05/2021,7541,56,6190,110,1351,23/05/2021,"Chateau Margaux Premier Cru Classe, Margaux",Bordeaux,2010,27/05/2021,10127812010,1012781
900,28/05/2021,1240,13,850,50,390,28/01/2021,"Tignanello, Toscana",Tuscany,2012,29/05/2021,10953912012,1095391
880,28/05/2021,986,13,725,155,261,13/04/2021,"Chateau Calon Segur 3eme Cru Classe, Saint-Estephe",Bordeaux,2007,29/05/2021,10074752007,1007475
4350,06/07/2021,4803,29,4220,130,583,01/06/2021,"Chateau Angelus Premier Grand Cru Classe B, Saint-Emilion Grand Cru",Bordeaux,2005,07/07/2021,10060452005,1006045
6250,07/05/2021,7028,45,6116,134,912,07/05/2021,"Chateau Margaux Premier Cru Classe, Margaux",Bordeaux,2005,10/05/2021,10127812005,1012781
1000,07/05/2021,1244,15,1047,-47,197,27/04/2021,"Chateau Calon Segur 3eme Cru Classe, Saint-Estephe",Bordeaux,2009,10/05/2021,10074752009,1007475
1000,04/05/2021,1208,11,860,140,348,08/03/2021,"Tignanello, Toscana",Tuscany,2013,10/05/2021,10953912013,1095391
6250,07/05/2021,7443,53,5922,328,1521,13/04/2021,"Chateau Margaux Premier Cru Classe, Margaux",Bordeaux,2010,10/05/2021,10127812010,1012781
3920,07/05/2021,4494,74,3880,40,614,22/03/2021,"Chateau Margaux Premier Cru Classe, Margaux",Bordeaux,2008,10/05/2021,10127812008,1012781
4350,05/07/2021,4803,29,4220,130,583,01/06/2021,"Chateau Angelus Premier Grand Cru Classe B, Saint-Emilion Grand Cru",Bordeaux,2005,06/07/2021,10060452005,1006045
3910,07/05/2021,4793,77,3800,110,993,07/04/2021,"Chateau Margaux Premier Cru Classe, Margaux",Bordeaux,2006,10/05/2021,10127812006,1012781
4350,05/07/2021,4803,29,4220,130,583,01/06/2021,"Chateau Angelus Premier Grand Cru Classe B, Saint-Emilion Grand Cru",Bordeaux,2005,06/07/2021,10060452005,1006045
875,22/07/2021,932,45,863,12,69,10/05/2021,"Chateau Calon Segur 3eme Cru Classe, Saint-Estephe",Bordeaux,2006,29/07/2021,10074752006,1007475
3900,28/07/2021,4660,97,3822,78,838,20/06/2021,"Chateau Margaux Premier Cru Classe, Margaux",Bordeaux,2006,29/07/2021,10127812006,1012781
4350,02/07/2021,4814,31,4220,130,594,01/06/2021,"Chateau Angelus Premier Grand Cru Classe B, Saint-Emilion Grand Cru",Bordeaux,2005,03/07/2021,10060452005,1006045
4350,02/07/2021,4814,31,4220,130,594,01/06/2021,"Chateau Angelus Premier Grand Cru Classe B, Saint-Emilion Grand Cru",Bordeaux,2005,03/07/2021,10060452005,1006045
415,25/05/2021,529,45,364,51,165,12/05/2021,"Chateau Batailley 5eme Cru Classe, Pauillac",Bordeaux,2016,29/05/2021,10063222016,1006322
4350,30/06/2021,4792,37,4220,130,572,01/06/2021,"Chateau Angelus Premier Grand Cru Classe B, Saint-Emilion Grand Cru",Bordeaux,2005,01/07/2021,10060452005,1006045
950,26/05/2021,1003,58,863,87,140,10/05/2021,"Chateau Calon Segur 3eme Cru Classe, Saint-Estephe",Bordeaux,2006,27/05/2021,10074752006,1007475
4400,07/05/2021,4882,23,4400,0,482,29/09/2020,"Chateau Margaux Premier Cru Classe, Margaux",Bordeaux,2001,10/05/2021,10127812001,1012781
4350,30/06/2021,4792,37,4220,130,572,01/06/2021,"Chateau Angelus Premier Grand Cru Classe B, Saint-Emilion Grand Cru",Bordeaux,2005,01/07/2021,10060452005,1006045
4350,30/06/2021,4788,32,4220,130,568,01/06/2021,"Chateau Angelus Premier Grand Cru Classe B, Saint-Emilion Grand Cru",Bordeaux,2005,02/07/2021,10060452005,1006045
3900,07/05/2021,4500,27,3684,216,816,10/06/2020,"Chateau Margaux Premier Cru Classe, Margaux",Bordeaux,2002,10/05/2021,10127812002,1012781
790,05/05/2021,897,34,794,-4,103,20/04/2021,"Chateau Calon Segur 3eme Cru Classe, Saint-Estephe",Bordeaux,2014,10/05/2021,10074752014,1007475
4350,30/06/2021,4788,32,4220,130,568,01/06/2021,"Chateau Angelus Premier Grand Cru Classe B, Saint-Emilion Grand Cru",Bordeaux,2005,02/07/2021,10060452005,1006045
4350,29/06/2021,4792,37,4220,130,572,01/06/2021,"Chateau Angelus Premier Grand Cru Classe B, Saint-Emilion Grand Cru",Bordeaux,2005,30/06/2021,10060452005,1006045
4350,29/06/2021,4792,37,4220,130,572,01/06/2021,"Chateau Angelus Premier Grand Cru Classe B, Saint-Emilion Grand Cru",Bordeaux,2005,30/06/2021,10060452005,1006045
790,26/05/2021,971,22,745,45,226,16/11/2020,"Chateau Calon Segur 3eme Cru Classe, Saint-Estephe",Bordeaux,2004,27/05/2021,10074752004,1007475
408,25/05/2021,414,20,357,51,57,06/05/2021,"Chateau Batailley 5eme Cru Classe, Pauillac",Bordeaux,2018,26/05/2021,10063222018,1006322
3826,28/05/2021,4513,61,4116,-290,397,25/02/2021,"Chateau Margaux Premier Cru Classe, Margaux",Bordeaux,2004,29/05/2021,10127812004,1012781
16200,28/05/2021,16577,0,18750,-2550,-2173,29/08/2018,"Jacques-Frederic Mugnier, Chambolle-Musigny Premier Cru, Les Amoureuses",Burgundy,2015,31/05/2021,10496422015,1049642
468,26/05/2021,582,2,465,3,117,04/05/2020,"Chateau Batailley 5eme Cru Classe, Pauillac",Bordeaux,2001,27/05/2021,10063222001,1006322
1408,27/05/2021,1394,5,1238,170,156,02/11/2020,"Tignanello, Toscana",Tuscany,2006,30/05/2021,10953912006,1095391
412,26/05/2021,437,2,220,192,217,17/06/2015,"Chateau Batailley 5eme Cru Classe, Pauillac",Bordeaux,2002,27/05/2021,10063222002,1006322
790,27/05/2021,921,31,858,-68,63,29/05/2021,"Chateau Calon Segur 3eme Cru Classe, Saint-Estephe",Bordeaux,2014,30/05/2021,10074752014,1007475
589,26/05/2021,672,95,450,139,222,04/05/2021,"Chateau Batailley 5eme Cru Classe, Pauillac",Bordeaux,2005,27/05/2021,10063222005,1006322
1700,26/05/2021,1666,4,1378,322,288,29/07/2020,"Tignanello, Toscana",Tuscany,2001,27/05/2021,10953912001,1095391
4200,17/06/2021,4792,37,4220,-20,572,01/06/2021,"Chateau Angelus Premier Grand Cru Classe B, Saint-Emilion Grand Cru",Bordeaux,2005,29/06/2021,10060452005,1006045
10500,07/05/2021,12366,62,9844,656,2522,29/03/2021,"Chateau Margaux Premier Cru Classe, Margaux",Bordeaux,2015,10/05/2021,10127812015,1012781
4200,17/06/2021,4793,39,4220,-20,573,01/06/2021,"Chateau Angelus Premier Grand Cru Classe B, Saint-Emilion Grand Cru",Bordeaux,2005,26/06/2021,10060452005,1006045
3800,07/05/2021,4158,36,3560,240,598,20/11/2020,"Chateau Margaux Premier Cru Classe, Margaux",Bordeaux,2012,10/05/2021,10127812012,1012781
4200,17/06/2021,4825,37,4220,-20,605,01/06/2021,"Chateau Angelus Premier Grand Cru Classe B, Saint-Emilion Grand Cru",Bordeaux,2005,28/06/2021,10060452005,1006045
4200,17/06/2021,4825,37,4220,-20,605,01/06/2021,"Chateau Angelus Premier Grand Cru Classe B, Saint-Emilion Grand Cru",Bordeaux,2005,28/06/2021,10060452005,1006045
2232,26/05/2021,2351,5,2190,42,161,01/05/2021,"Gaja, Barbaresco",Piedmont,2004,27/05/2021,10996052004,1099605
4200,17/06/2021,4791,39,4220,-20,571,01/06/2021,"Chateau Angelus Premier Grand Cru Classe B, Saint-Emilion Grand Cru",Bordeaux,2005,25/06/2021,10060452005,1006045
1050,26/05/2021,1137,7,860,190,277,08/03/2021,"Tignanello, Toscana",Tuscany,2013,27/05/2021,10953912013,1095391
3900,26/05/2021,4437,92,3800,100,637,12/05/2021,"Chateau Margaux Premier Cru Classe, Margaux",Bordeaux,2008,27/05/2021,10127812008,1012781
4200,17/06/2021,4792,37,4220,-20,572,01/06/2021,"Chateau Angelus Premier Grand Cru Classe B, Saint-Emilion Grand Cru",Bordeaux,2005,29/06/2021,10060452005,1006045
3750,28/07/2021,4246,44,3525,225,721,18/06/2021,"Chateau Margaux Premier Cru Classe, Margaux",Bordeaux,2007,29/07/2021,10127812007,1012781
880,28/07/2021,967,9,725,155,242,13/04/2021,"Chateau Calon Segur 3eme Cru Classe, Saint-Estephe",Bordeaux,2007,29/07/2021,10074752007,1007475
4200,17/06/2021,4793,39,4220,-20,573,01/06/2021,"Chateau Angelus Premier Grand Cru Classe B, Saint-Emilion Grand Cru",Bordeaux,2005,26/06/2021,10060452005,1006045
3720,07/05/2021,4079,50,3480,240,599,10/04/2021,"Chateau Margaux Premier Cru Classe, Margaux",Bordeaux,2014,10/05/2021,10127812014,1012781
3700,07/05/2021,4001,24,3520,180,481,07/04/2021,"Chateau Margaux Premier Cru Classe, Margaux",Bordeaux,2013,10/05/2021,10127812013,1012781
589,26/05/2021,672,95,450,139,222,04/05/2021,"Chateau Batailley 5eme Cru Classe, Pauillac",Bordeaux,2005,27/05/2021,10063222005,1006322
780,07/05/2021,836,6,682,98,154,15/09/2020,"Chateau Calon Segur 3eme Cru Classe, Saint-Estephe",Bordeaux,2013,10/05/2021,10074752013,1007475
1280,26/05/2021,1367,8,1172,108,195,07/04/2021,"Tignanello, Toscana",Tuscany,2010,27/05/2021,10953912010,1095391
450,26/05/2021,450,1,340,110,110,31/08/2018,"Chateau Batailley 5eme Cru Classe, Pauillac",Bordeaux,2007,27/05/2021,10063222007,1006322
4200,17/06/2021,4791,39,4220,-20,571,01/06/2021,"Chateau Angelus Premier Grand Cru Classe B, Saint-Emilion Grand Cru",Bordeaux,2005,25/06/2021,10060452005,1006045
3950,28/07/2021,4392,99,3780,170,612,23/07/2021,"Chateau Margaux Premier Cru Classe, Margaux",Bordeaux,2008,29/07/2021,10127812008,1012781
895,28/07/2021,953,8,781,114,172,16/11/2020,"Chateau Calon Segur 3eme Cru Classe, Saint-Estephe",Bordeaux,2008,29/07/2021,10074752008,1007475
6930,28/07/2021,7720,73,7086,-156,634,11/06/2021,"Chateau Margaux Premier Cru Classe, Margaux",Bordeaux,2009,29/07/2021,10127812009,1012781
490,26/05/2021,584,28,450,40,134,25/05/2021,"Chateau Batailley 5eme Cru Classe, Pauillac",Bordeaux,2009,27/05/2021,10063222009,1006322
850,07/05/2021,1110,88,860,-10,250,19/04/2021,"Chateau Calon Segur 3eme Cru Classe, Saint-Estephe",Bordeaux,2015,10/05/2021,10074752015,1007475
4050,14/06/2021,4790,39,4220,-170,570,01/06/2021,"Chateau Angelus Premier Grand Cru Classe B, Saint-Emilion Grand Cru",Bordeaux,2005,23/06/2021,10060452005,1006045
4050,14/06/2021,4724,37,4220,-170,504,01/06/2021,"Chateau Angelus Premier Grand Cru Classe B, Saint-Emilion Grand Cru",Bordeaux,2005,15/06/2021,10060452005,1006045
990,26/05/2021,1114,22,1000,-10,114,12/04/2021,"Chateau Calon Segur 3eme Cru Classe, Saint-Estephe",Bordeaux,2010,27/05/2021,10074752010,1007475
996,28/07/2021,1206,53,1026,-30,180,24/06/2021,"Chateau Calon Segur 3eme Cru Classe, Saint-Estephe",Bordeaux,2009,29/07/2021,10074752009,1007475
490,26/05/2021,584,28,450,40,134,25/05/2021,"Chateau Batailley 5eme Cru Classe, Pauillac",Bordeaux,2009,27/05/2021,10063222009,1006322
8040,26/05/2021,8366,18,7950,90,416,12/03/2021,"Chateau Margaux Premier Cru Classe, Margaux",Bordeaux,2000,27/05/2021,10127812000,1012781
4400,26/05/2021,4829,18,4400,0,429,29/09/2020,"Chateau Margaux Premier Cru Classe, Margaux",Bordeaux,2001,27/05/2021,10127812001,1012781
1000,26/05/2021,1158,42,1030,-30,128,25/05/2021,"Chateau Calon Segur 3eme Cru Classe, Saint-Estephe",Bordeaux,2009,27/05/2021,10074752009,1007475
3827,26/05/2021,4507,62,4116,-289,391,25/02/2021,"Chateau Margaux Premier Cru Classe, Margaux",Bordeaux,2004,27/05/2021,10127812004,1012781
2386,28/07/2021,2397,3,2190,196,207,01/05/2021,"Gaja, Barbaresco",Piedmont,2004,29/07/2021,10996052004,1099605
1700,28/07/2021,1732,2,1378,322,354,29/07/2020,"Tignanello, Toscana",Tuscany,2001,29/07/2021,10953912001,1095391
1408,27/07/2021,1389,2,1238,170,151,02/11/2020,"Tignanello, Toscana",Tuscany,2006,29/07/2021,10953912006,1095391
6400,28/07/2021,7537,63,6188,212,1349,16/07/2021,"Chateau Margaux Premier Cru Classe, Margaux",Bordeaux,2010,29/07/2021,10127812010,1012781
990,28/07/2021,1117,17,993,-3,124,27/07/2021,"Chateau Calon Segur 3eme Cru Classe, Saint-Estephe",Bordeaux,2010,29/07/2021,10074752010,1007475
490,26/05/2021,594,408,494,-4,100,20/04/2021,"Chateau Batailley 5eme Cru Classe, Pauillac",Bordeaux,2010,27/05/2021,10063222010,1006322
880,27/05/2021,986,13,725,155,261,13/04/2021,"Chateau Calon Segur 3eme Cru Classe, Saint-Estephe",Bordeaux,2007,28/05/2021,10074752007,1007475
1200,27/05/2021,1256,39,1124,76,132,19/05/2021,"Tignanello, Toscana",Tuscany,2016,28/05/2021,10953912016,1095391
1700,18/05/2021,1815,3,1300,400,515,30/05/2019,"Gaja, Barbaresco",Piedmont,2007,28/05/2021,10996052007,1099605
6250,27/05/2021,7070,40,6360,-110,710,24/05/2021,"Chateau Margaux Premier Cru Classe, Margaux",Bordeaux,2005,28/05/2021,10127812005,1012781
750,28/07/2021,892,29,790,-40,102,01/06/2020,"Chateau Calon Segur 3eme Cru Classe, Saint-Estephe",Bordeaux,2011,29/07/2021,10074752011,1007475
1180,28/07/2021,1353,4,1140,40,213,21/07/2021,"Tignanello, Toscana",Tuscany,2009,29/07/2021,10953912009,1095391
1326,28/07/2021,1602,3,1170,156,432,24/06/2021,"Tignanello, Toscana",Tuscany,2010,29/07/2021,10953912010,1095391
3758,28/07/2021,4370,80,3690,68,680,13/04/2021,"Chateau Margaux Premier Cru Classe, Margaux",Bordeaux,2011,29/07/2021,10127812011,1012781
4050,14/06/2021,4737,36,4220,-170,517,01/06/2021,"Chateau Angelus Premier Grand Cru Classe B, Saint-Emilion Grand Cru",Bordeaux,2005,18/06/2021,10060452005,1006045
490,26/05/2021,594,408,494,-4,100,20/04/2021,"Chateau Batailley 5eme Cru Classe, Pauillac",Bordeaux,2010,27/05/2021,10063222010,1006322
6300,17/05/2021,7623,45,5922,378,1701,13/04/2021,"Chateau Margaux Premier Cru Classe, Margaux",Bordeaux,2010,18/05/2021,10127812010,1012781
900,17/05/2021,1057,23,800,100,257,21/11/2019,"Chateau Calon Segur 3eme Cru Classe, Saint-Estephe",Bordeaux,2003,18/05/2021,10074752003,1007475
3850,17/05/2021,4165,41,3560,290,605,20/11/2020,"Chateau Margaux Premier Cru Classe, Margaux",Bordeaux,2012,18/05/2021,10127812012,1012781
995,17/05/2021,1116,19,1000,-5,116,12/04/2021,"Chateau Calon Segur 3eme Cru Classe, Saint-Estephe",Bordeaux,2010,18/05/2021,10074752010,1007475
1050,28/07/2021,1117,9,880,170,237,22/06/2021,"Tignanello, Toscana",Tuscany,2011,29/07/2021,10953912011,1095391
4050,14/06/2021,4725,36,4220,-170,505,01/06/2021,"Chateau Angelus Premier Grand Cru Classe B, Saint-Emilion Grand Cru",Bordeaux,2005,19/06/2021,10060452005,1006045
300,26/05/2021,301,110,304,-4,-3,10/01/2021,"Chateau Batailley 5eme Cru Classe, Pauillac",Bordeaux,2013,27/05/2021,10063222013,1006322
820,28/07/2021,920,4,735,85,185,09/09/2020,"Chateau Calon Segur 3eme Cru Classe, Saint-Estephe",Bordeaux,2012,29/07/2021,10074752012,1007475
3750,26/07/2021,4295,57,3650,100,645,27/07/2021,"Chateau Margaux Premier Cru Classe, Margaux",Bordeaux,2012,29/07/2021,10127812012,1012781
3860,10/05/2021,4837,74,3800,60,1037,07/04/2021,"Chateau Margaux Premier Cru Classe, Margaux",Bordeaux,2006,18/05/2021,10127812006,1012781
3900,17/05/2021,4543,31,3684,216,859,10/06/2020,"Chateau Margaux Premier Cru Classe, Margaux",Bordeaux,2002,18/05/2021,10127812002,1012781
750,17/05/2021,1013,35,790,-40,223,01/06/2020,"Chateau Calon Segur 3eme Cru Classe, Saint-Estephe",Bordeaux,2011,18/05/2021,10074752011,1007475
3950,17/05/2021,4467,84,3800,150,667,12/05/2021,"Chateau Margaux Premier Cru Classe, Margaux",Bordeaux,2008,18/05/2021,10127812008,1012781
408,26/05/2021,414,20,357,51,57,06/05/2021,"Chateau Batailley 5eme Cru Classe, Pauillac",Bordeaux,2018,27/05/2021,10063222018,1006322
3740,17/05/2021,3968,47,3520,220,448,07/04/2021,"Chateau Margaux Premier Cru Classe, Margaux",Bordeaux,2013,18/05/2021,10127812013,1012781
3700,28/07/2021,4164,47,3520,180,644,07/04/2021,"Chateau Margaux Premier Cru Classe, Margaux",Bordeaux,2013,29/07/2021,10127812013,1012781
4050,14/06/2021,4725,35,4220,-170,505,01/06/2021,"Chateau Angelus Premier Grand Cru Classe B, Saint-Emilion Grand Cru",Bordeaux,2005,20/06/2021,10060452005,1006045
900,17/05/2021,1063,22,850,50,213,28/01/2021,"Tignanello, Toscana",Tuscany,2012,18/05/2021,10953912012,1095391
3800,17/05/2021,4076,44,3480,320,596,10/04/2021,"Chateau Margaux Premier Cru Classe, Margaux",Bordeaux,2014,18/05/2021,10127812014,1012781
4850,13/05/2021,5732,27,4800,50,932,11/03/2021,"Chateau Margaux Premier Cru Classe, Margaux",Bordeaux,2003,18/05/2021,10127812003,1012781
1010,14/05/2021,1040,13,860,150,180,08/03/2021,"Tignanello, Toscana",Tuscany,2011,18/05/2021,10953912011,1095391
960,28/07/2021,1325,12,850,110,475,28/01/2021,"Tignanello, Toscana",Tuscany,2012,29/07/2021,10953912012,1095391
4050,14/06/2021,4790,39,4220,-170,570,01/06/2021,"Chateau Angelus Premier Grand Cru Classe B, Saint-Emilion Grand Cru",Bordeaux,2005,23/06/2021,10060452005,1006045
3800,28/07/2021,4356,131,3480,320,876,17/06/2021,"Chateau Margaux Premier Cru Classe, Margaux",Bordeaux,2014,29/07/2021,10127812014,1012781
760,28/07/2021,874,18,801,-41,73,31/05/2021,"Chateau Calon Segur 3eme Cru Classe, Saint-Estephe",Bordeaux,2014,29/07/2021,10074752014,1007475
6650,14/05/2021,7991,69,6500,150,1491,12/05/2021,"Chateau Margaux Premier Cru Classe, Margaux",Bordeaux,2009,18/05/2021,10127812009,1012781
6250,14/05/2021,6962,37,6116,134,846,07/05/2021,"Chateau Margaux Premier Cru Classe, Margaux",Bordeaux,2005,18/05/2021,10127812005,1012781
950,28/07/2021,1128,9,960,-10,168,27/07/2021,"Tignanello, Toscana",Tuscany,2013,29/07/2021,10953912013,1095391
1030,28/07/2021,1000,4,854,176,146,15/07/2021,"Tignanello, Toscana",Tuscany,2014,29/07/2021,10953912014,1095391
10800,20/07/2021,10326,1,8000,2800,2326,30/01/2020,"Domaine Leflaive, Chevalier-Montrachet Grand Cru",Burgundy,2014,29/07/2021,10734012014,1073401
1000,17/05/2021,1170,78,975,25,195,12/04/2021,"Chateau Calon Segur 3eme Cru Classe, Saint-Estephe",Bordeaux,2005,18/05/2021,10074752005,1007475
8400,30/07/2021,8400,1,5700,2700,2700,10/09/2020,"Domaine Leflaive, Chevalier-Montrachet Grand Cru",Burgundy,2007,31/07/2021,10734012007,1073401
4050,14/06/2021,4724,37,4220,-170,504,01/06/2021,"Chateau Angelus Premier Grand Cru Classe B, Saint-Emilion Grand Cru",Bordeaux,2005,15/06/2021,10060452005,1006045
3950,30/07/2021,4402,98,3780,170,622,23/07/2021,"Chateau Margaux Premier Cru Classe, Margaux",Bordeaux,2008,31/07/2021,10127812008,1012781
895,30/07/2021,950,9,781,114,169,16/11/2020,"Chateau Calon Segur 3eme Cru Classe, Saint-Estephe",Bordeaux,2008,31/07/2021,10074752008,1007475
468,27/05/2021,582,2,465,3,117,04/05/2020,"Chateau Batailley 5eme Cru Classe, Pauillac",Bordeaux,2001,28/05/2021,10063222001,1006322
940,28/07/2021,1067,84,866,74,201,20/07/2021,"Chateau Calon Segur 3eme Cru Classe, Saint-Estephe",Bordeaux,2015,29/07/2021,10074752015,1007475
10620,28/07/2021,11832,49,9800,820,2032,11/06/2021,"Chateau Margaux Premier Cru Classe, Margaux",Bordeaux,2015,29/07/2021,10127812015,1012781
709,13/05/2021,815,9,682,27,133,15/09/2020,"Chateau Calon Segur 3eme Cru Classe, Saint-Estephe",Bordeaux,2013,18/05/2021,10074752013,1007475
4050,14/06/2021,4737,36,4220,-170,517,01/06/2021,"Chateau Angelus Premier Grand Cru Classe B, Saint-Emilion Grand Cru",Bordeaux,2005,18/06/2021,10060452005,1006045
4050,14/06/2021,4725,36,4220,-170,505,01/06/2021,"Chateau Angelus Premier Grand Cru Classe B, Saint-Emilion Grand Cru",Bordeaux,2005,19/06/2021,10060452005,1006045
3750,17/05/2021,4084,28,3592,158,492,06/05/2021,"Chateau Margaux Premier Cru Classe, Margaux",Bordeaux,2007,18/05/2021,10127812007,1012781
412,27/05/2021,437,2,220,192,217,17/06/2015,"Chateau Batailley 5eme Cru Classe, Pauillac",Bordeaux,2002,28/05/2021,10063222002,1006322
1100,17/05/2021,1536,7,1010,90,526,18/12/2020,"Tignanello, Toscana",Tuscany,2008,18/05/2021,10953912008,1095391
4050,14/06/2021,4725,35,4220,-170,505,01/06/2021,"Chateau Angelus Premier Grand Cru Classe B, Saint-Emilion Grand Cru",Bordeaux,2005,20/06/2021,10060452005,1006045
589,27/05/2021,672,95,450,139,222,04/05/2021,"Chateau Batailley 5eme Cru Classe, Pauillac",Bordeaux,2005,28/05/2021,10063222005,1006322
4050,04/06/2021,4725,37,4220,-170,505,01/06/2021,"Chateau Angelus Premier Grand Cru Classe B, Saint-Emilion Grand Cru",Bordeaux,2005,11/06/2021,10060452005,1006045
908,17/05/2021,1072,33,805,103,267,20/11/2019,"Chateau Calon Segur 3eme Cru Classe, Saint-Estephe",Bordeaux,2001,18/05/2021,10074752001,1007475
768,14/05/2021,901,11,705,63,196,01/02/2021,"Chateau Calon Segur 3eme Cru Classe, Saint-Estephe",Bordeaux,2002,18/05/2021,10074752002,1007475
6930,30/07/2021,7681,74,7086,-156,595,11/06/2021,"Chateau Margaux Premier Cru Classe, Margaux",Bordeaux,2009,31/07/2021,10127812009,1012781
9000,30/07/2021,8799,1,5400,3600,3399,13/08/2020,"Domaine Leflaive, Chevalier-Montrachet Grand Cru",Burgundy,2008,31/07/2021,10734012008,1073401
996,30/07/2021,1205,53,1026,-30,179,24/06/2021,"Chateau Calon Segur 3eme Cru Classe, Saint-Estephe",Bordeaux,2009,31/07/2021,10074752009,1007475
589,27/05/2021,672,95,450,139,222,04/05/2021,"Chateau Batailley 5eme Cru Classe, Pauillac",Bordeaux,2005,28/05/2021,10063222005,1006322
4050,04/06/2021,4728,49,4220,-170,508,01/06/2021,"Chateau Angelus Premier Grand Cru Classe B, Saint-Emilion Grand Cru",Bordeaux,2005,05/06/2021,10060452005,1006045
4050,04/06/2021,4728,49,4220,-170,508,01/06/2021,"Chateau Angelus Premier Grand Cru Classe B, Saint-Emilion Grand Cru",Bordeaux,2005,05/06/2021,10060452005,1006045
850,17/05/2021,1098,97,860,-10,238,19/04/2021,"Chateau Calon Segur 3eme Cru Classe, Saint-Estephe",Bordeaux,2015,18/05/2021,10074752015,1007475
8040,17/05/2021,8232,20,7950,90,282,12/03/2021,"Chateau Margaux Premier Cru Classe, Margaux",Bordeaux,2000,18/05/2021,10127812000,1012781
10500,17/05/2021,12510,69,9844,656,2666,29/03/2021,"Chateau Margaux Premier Cru Classe, Margaux",Bordeaux,2015,18/05/2021,10127812015,1012781
1024,17/05/2021,1125,10,1072,-48,53,20/01/2021,"Tignanello, Toscana",Tuscany,2009,18/05/2021,10953912009,1095391
450,27/05/2021,450,1,340,110,110,31/08/2018,"Chateau Batailley 5eme Cru Classe, Pauillac",Bordeaux,2007,28/05/2021,10063222007,1006322
4050,04/06/2021,4725,37,4220,-170,505,01/06/2021,"Chateau Angelus Premier Grand Cru Classe B, Saint-Emilion Grand Cru",Bordeaux,2005,11/06/2021,10060452005,1006045
3758,17/05/2021,4399,119,3690,68,709,13/04/2021,"Chateau Margaux Premier Cru Classe, Margaux",Bordeaux,2011,18/05/2021,10127812011,1012781
4400,17/05/2021,4883,27,4400,0,483,29/09/2020,"Chateau Margaux Premier Cru Classe, Margaux",Bordeaux,2001,18/05/2021,10127812001,1012781
2260,17/05/2021,2305,4,2190,70,115,01/05/2021,"Gaja, Barbaresco",Piedmont,2004,18/05/2021,10996052004,1099605
4050,24/05/2021,4882,49,4050,0,832,26/05/2021,"Chateau Angelus Premier Grand Cru Classe B, Saint-Emilion Grand Cru",Bordeaux,2005,27/05/2021,10060452005,1006045
3827,17/05/2021,4520,69,4116,-289,404,25/02/2021,"Chateau Margaux Premier Cru Classe, Margaux",Bordeaux,2004,18/05/2021,10127812004,1012781
4050,24/05/2021,4858,49,4050,0,808,26/05/2021,"Chateau Angelus Premier Grand Cru Classe B, Saint-Emilion Grand Cru",Bordeaux,2005,28/05/2021,10060452005,1006045
870,29/07/2021,955,6,705,165,250,01/02/2021,"Chateau Calon Segur 3eme Cru Classe, Saint-Estephe",Bordeaux,2002,30/07/2021,10074752002,1007475
8200,29/07/2021,8980,17,8200,0,780,26/07/2021,"Chateau Margaux Premier Cru Classe, Margaux",Bordeaux,2000,30/07/2021,10127812000,1012781
900,28/07/2021,1105,24,800,100,305,21/11/2019,"Chateau Calon Segur 3eme Cru Classe, Saint-Estephe",Bordeaux,2003,30/07/2021,10074752003,1007475
4450,29/07/2021,4693,16,4400,50,293,29/09/2020,"Chateau Margaux Premier Cru Classe, Margaux",Bordeaux,2001,30/07/2021,10127812001,1012781
3900,28/07/2021,4407,23,3684,216,723,10/06/2020,"Chateau Margaux Premier Cru Classe, Margaux",Bordeaux,2002,30/07/2021,10127812002,1012781
3826,29/07/2021,4593,48,4116,-290,477,25/02/2021,"Chateau Margaux Premier Cru Classe, Margaux",Bordeaux,2004,30/07/2021,10127812004,1012781
5040,29/07/2021,5919,25,4650,390,1269,21/06/2021,"Chateau Margaux Premier Cru Classe, Margaux",Bordeaux,2003,30/07/2021,10127812003,1012781
4050,24/05/2021,4911,47,4050,0,861,26/04/2021,"Chateau Angelus Premier Grand Cru Classe B, Saint-Emilion Grand Cru",Bordeaux,2005,25/05/2021,10060452005,1006045
4050,24/05/2021,4889,56,4050,0,839,26/05/2021,"Chateau Angelus Premier Grand Cru Classe B, Saint-Emilion Grand Cru",Bordeaux,2005,01/06/2021,10060452005,1006045
840,29/07/2021,1060,20,745,95,315,16/11/2020,"Chateau Calon Segur 3eme Cru Classe, Saint-Estephe",Bordeaux,2004,30/07/2021,10074752004,1007475
4050,24/05/2021,4883,56,4220,-170,663,01/06/2021,"Chateau Angelus Premier Grand Cru Classe B, Saint-Emilion Grand Cru",Bordeaux,2005,02/06/2021,10060452005,1006045
6500,29/07/2021,7558,28,6400,100,1158,22/07/2021,"Chateau Margaux Premier Cru Classe, Margaux",Bordeaux,2005,30/07/2021,10127812005,1012781
4050,24/05/2021,4882,49,4050,0,832,26/04/2021,"Chateau Angelus Premier Grand Cru Classe B, Saint-Emilion Grand Cru",Bordeaux,2005,26/05/2021,10060452005,1006045
990,29/07/2021,1179,62,1029,-39,150,21/07/2021,"Chateau Calon Segur 3eme Cru Classe, Saint-Estephe",Bordeaux,2005,30/07/2021,10074752005,1007475
3900,29/07/2021,4649,99,3822,78,827,20/06/2021,"Chateau Margaux Premier Cru Classe, Margaux",Bordeaux,2006,30/07/2021,10127812006,1012781
3800,29/07/2021,4246,44,3525,275,721,18/06/2021,"Chateau Margaux Premier Cru Classe, Margaux",Bordeaux,2007,30/07/2021,10127812007,1012781
880,29/07/2021,967,9,725,155,242,13/04/2021,"Chateau Calon Segur 3eme Cru Classe, Saint-Estephe",Bordeaux,2007,30/07/2021,10074752007,1007475
4050,24/05/2021,4882,49,4050,0,832,26/05/2021,"Chateau Angelus Premier Grand Cru Classe B, Saint-Emilion Grand Cru",Bordeaux,2005,27/05/2021,10060452005,1006045
4050,24/05/2021,4889,56,4050,0,839,26/05/2021,"Chateau Angelus Premier Grand Cru Classe B, Saint-Emilion Grand Cru",Bordeaux,2005,01/06/2021,10060452005,1006045
3950,29/07/2021,4399,97,3780,170,619,23/07/2021,"Chateau Margaux Premier Cru Classe, Margaux",Bordeaux,2008,30/07/2021,10127812008,1012781
895,29/07/2021,950,9,781,114,169,16/11/2020,"Chateau Calon Segur 3eme Cru Classe, Saint-Estephe",Bordeaux,2008,30/07/2021,10074752008,1007475
6930,29/07/2021,7708,74,7086,-156,622,11/06/2021,"Chateau Margaux Premier Cru Classe, Margaux",Bordeaux,2009,30/07/2021,10127812009,1012781
996,28/07/2021,1205,53,1026,-30,179,24/06/2021,"Chateau Calon Segur 3eme Cru Classe, Saint-Estephe",Bordeaux,2009,30/07/2021,10074752009,1007475
490,27/05/2021,584,28,450,40,134,25/05/2021,"Chateau Batailley 5eme Cru Classe, Pauillac",Bordeaux,2009,28/05/2021,10063222009,1006322
4050,24/05/2021,4882,49,4050,0,832,26/04/2021,"Chateau Angelus Premier Grand Cru Classe B, Saint-Emilion Grand Cru",Bordeaux,2005,26/05/2021,10060452005,1006045
2386,29/07/2021,2397,3,2190,196,207,01/05/2021,"Gaja, Barbaresco",Piedmont,2004,30/07/2021,10996052004,1099605
6400,29/07/2021,7576,68,6188,212,1388,16/07/2021,"Chateau Margaux Premier Cru Classe, Margaux",Bordeaux,2010,30/07/2021,10127812010,1012781
990,29/07/2021,1119,17,993,-3,126,27/07/2021,"Chateau Calon Segur 3eme Cru Classe, Saint-Estephe",Bordeaux,2010,30/07/2021,10074752010,1007475
4050,24/05/2021,4911,47,4050,0,861,26/04/2021,"Chateau Angelus Premier Grand Cru Classe B, Saint-Emilion Grand Cru",Bordeaux,2005,25/05/2021,10060452005,1006045
750,28/07/2021,897,30,790,-40,107,01/06/2020,"Chateau Calon Segur 3eme Cru Classe, Saint-Estephe",Bordeaux,2011,30/07/2021,10074752011,1007475
1326,28/07/2021,1452,3,1170,156,282,24/06/2021,"Tignanello, Toscana",Tuscany,2010,30/07/2021,10953912010,1095391
3800,28/07/2021,4370,80,3690,110,680,13/04/2021,"Chateau Margaux Premier Cru Classe, Margaux",Bordeaux,2011,30/07/2021,10127812011,1012781
4050,24/05/2021,4858,49,4050,0,808,26/05/2021,"Chateau Angelus Premier Grand Cru Classe B, Saint-Emilion Grand Cru",Bordeaux,2005,28/05/2021,10060452005,1006045
490,27/05/2021,584,28,450,40,134,25/05/2021,"Chateau Batailley 5eme Cru Classe, Pauillac",Bordeaux,2009,28/05/2021,10063222009,1006322
4050,24/05/2021,4883,56,4220,-170,663,01/06/2021,"Chateau Angelus Premier Grand Cru Classe B, Saint-Emilion Grand Cru",Bordeaux,2005,02/06/2021,10060452005,1006045
490,27/05/2021,594,407,494,-4,100,20/04/2021,"Chateau Batailley 5eme Cru Classe, Pauillac",Bordeaux,2010,28/05/2021,10063222010,1006322
820,29/07/2021,925,4,735,85,190,09/09/2020,"Chateau Calon Segur 3eme Cru Classe, Saint-Estephe",Bordeaux,2012,30/07/2021,10074752012,1007475
3750,26/07/2021,4299,57,3650,100,649,27/07/2021,"Chateau Margaux Premier Cru Classe, Margaux",Bordeaux,2012,30/07/2021,10127812012,1012781
1516,14/07/2021,1578,21,1586,-70,-8,12/07/2021,"Gaja, Barbaresco",Piedmont,2018,15/07/2021,10996052018,1099605
3700,29/07/2021,4159,48,3520,180,639,07/04/2021,"Chateau Margaux Premier Cru Classe, Margaux",Bordeaux,2013,30/07/2021,10127812013,1012781
4050,13/05/2021,5046,48,4050,0,996,26/04/2021,"Chateau Angelus Premier Grand Cru Classe B, Saint-Emilion Grand Cru",Bordeaux,2005,18/05/2021,10060452005,1006045
800,29/07/2021,792,19,682,118,110,15/09/2020,"Chateau Calon Segur 3eme Cru Classe, Saint-Estephe",Bordeaux,2013,30/07/2021,10074752013,1007475
960,28/07/2021,1346,11,850,110,496,28/01/2021,"Tignanello, Toscana",Tuscany,2012,30/07/2021,10953912012,1095391
4050,13/05/2021,5054,48,4050,0,1004,26/04/2021,"Chateau Angelus Premier Grand Cru Classe B, Saint-Emilion Grand Cru",Bordeaux,2005,19/05/2021,10060452005,1006045
3800,29/07/2021,4359,131,3480,320,879,17/06/2021,"Chateau Margaux Premier Cru Classe, Margaux",Bordeaux,2014,30/07/2021,10127812014,1012781
790,29/07/2021,877,18,801,-11,76,31/05/2021,"Chateau Calon Segur 3eme Cru Classe, Saint-Estephe",Bordeaux,2014,30/07/2021,10074752014,1007475
4400,17/06/2021,4729,26,4400,0,329,29/09/2020,"Chateau Margaux Premier Cru Classe, Margaux",Bordeaux,2001,20/06/2021,10127812001,1012781
8100,17/06/2021,8466,17,7950,150,516,12/03/2021,"Chateau Margaux Premier Cru Classe, Margaux",Bordeaux,2000,20/06/2021,10127812000,1012781
3900,18/06/2021,4616,87,3861,39,755,28/05/2021,"Chateau Margaux Premier Cru Classe, Margaux",Bordeaux,2006,20/06/2021,10127812006,1012781
6450,17/06/2021,7424,56,6190,260,1234,23/05/2021,"Chateau Margaux Premier Cru Classe, Margaux",Bordeaux,2010,20/06/2021,10127812010,1012781
907,28/07/2021,951,22,805,102,146,20/11/2019,"Chateau Calon Segur 3eme Cru Classe, Saint-Estephe",Bordeaux,2001,29/07/2021,10074752001,1007475
490,27/05/2021,594,407,494,-4,100,20/04/2021,"Chateau Batailley 5eme Cru Classe, Pauillac",Bordeaux,2010,28/05/2021,10063222010,1006322
4050,13/05/2021,5067,47,4050,0,1017,26/04/2021,"Chateau Angelus Premier Grand Cru Classe B, Saint-Emilion Grand Cru",Bordeaux,2005,14/05/2021,10060452005,1006045
360,27/05/2021,439,7,300,60,139,05/11/2020,"Chateau Batailley 5eme Cru Classe, Pauillac",Bordeaux,2011,30/05/2021,10063222011,1006322
4050,13/05/2021,4911,47,4050,0,861,26/04/2021,"Chateau Angelus Premier Grand Cru Classe B, Saint-Emilion Grand Cru",Bordeaux,2005,22/05/2021,10060452005,1006045
6500,27/07/2021,7512,27,6400,100,1112,22/07/2021,"Chateau Margaux Premier Cru Classe, Margaux",Bordeaux,2005,29/07/2021,10127812005,1012781
990,26/07/2021,1179,62,1029,-39,150,21/07/2021,"Chateau Calon Segur 3eme Cru Classe, Saint-Estephe",Bordeaux,2005,29/07/2021,10074752005,1007475
360,27/05/2021,439,7,300,60,139,05/11/2020,"Chateau Batailley 5eme Cru Classe, Pauillac",Bordeaux,2011,30/05/2021,10063222011,1006322
360,27/05/2021,466,8,300,60,166,05/11/2020,"Chateau Batailley 5eme Cru Classe, Pauillac",Bordeaux,2011,28/05/2021,10063222011,1006322
3900,17/06/2021,4475,27,3684,216,791,10/06/2020,"Chateau Margaux Premier Cru Classe, Margaux",Bordeaux,2002,20/06/2021,10127812002,1012781
2098,18/06/2021,2345,5,2190,-92,155,01/05/2021,"Gaja, Barbaresco",Piedmont,2004,20/06/2021,10996052004,1099605
3750,17/06/2021,4030,84,3690,60,340,13/04/2021,"Chateau Margaux Premier Cru Classe, Margaux",Bordeaux,2011,20/06/2021,10127812011,1012781
1100,17/06/2021,1153,33,1030,70,123,25/05/2021,"Chateau Calon Segur 3eme Cru Classe, Saint-Estephe",Bordeaux,2009,20/06/2021,10074752009,1007475
1310,17/06/2021,1378,5,1172,138,206,07/04/2021,"Tignanello, Toscana",Tuscany,2010,20/06/2021,10953912010,1095391
4050,13/05/2021,4898,48,4050,0,848,26/04/2021,"Chateau Angelus Premier Grand Cru Classe B, Saint-Emilion Grand Cru",Bordeaux,2005,21/05/2021,10060452005,1006045
1570,15/06/2021,1321,3,1200,370,121,06/03/2021,"Tignanello, Toscana",Tuscany,2007,20/06/2021,10953912007,1095391
1000,18/06/2021,1143,77,988,12,155,28/05/2021,"Chateau Calon Segur 3eme Cru Classe, Saint-Estephe",Bordeaux,2005,20/06/2021,10074752005,1007475
3750,14/06/2021,4207,39,3560,190,647,20/11/2020,"Chateau Margaux Premier Cru Classe, Margaux",Bordeaux,2012,20/06/2021,10127812012,1012781
4850,18/06/2021,5664,28,4842,8,822,19/05/2021,"Chateau Margaux Premier Cru Classe, Margaux",Bordeaux,2003,20/06/2021,10127812003,1012781
950,29/07/2021,1144,8,960,-10,184,27/07/2021,"Tignanello, Toscana",Tuscany,2013,30/07/2021,10953912013,1095391
1030,28/07/2021,1055,4,854,176,201,15/07/2021,"Tignanello, Toscana",Tuscany,2014,30/07/2021,10953912014,1095391
360,27/05/2021,466,8,300,60,166,05/11/2020,"Chateau Batailley 5eme Cru Classe, Pauillac",Bordeaux,2011,28/05/2021,10063222011,1006322
900,17/06/2021,1054,22,800,100,254,21/11/2019,"Chateau Calon Segur 3eme Cru Classe, Saint-Estephe",Bordeaux,2003,20/06/2021,10074752003,1007475
4050,13/05/2021,4898,48,4050,0,848,26/04/2021,"Chateau Angelus Premier Grand Cru Classe B, Saint-Emilion Grand Cru",Bordeaux,2005,21/05/2021,10060452005,1006045
880,17/06/2021,963,9,781,99,182,16/11/2020,"Chateau Calon Segur 3eme Cru Classe, Saint-Estephe",Bordeaux,2008,20/06/2021,10074752008,1007475
990,18/06/2021,1102,17,990,0,112,16/06/2021,"Chateau Calon Segur 3eme Cru Classe, Saint-Estephe",Bordeaux,2010,20/06/2021,10074752010,1007475
6400,18/06/2021,7397,42,6776,-376,621,10/06/2021,"Chateau Margaux Premier Cru Classe, Margaux",Bordeaux,2005,20/06/2021,10127812005,1012781
3826,18/06/2021,4515,51,4116,-290,399,25/02/2021,"Chateau Margaux Premier Cru Classe, Margaux",Bordeaux,2004,20/06/2021,10127812004,1012781
4050,13/05/2021,5046,48,4050,0,996,26/04/2021,"Chateau Angelus Premier Grand Cru Classe B, Saint-Emilion Grand Cru",Bordeaux,2005,18/05/2021,10060452005,1006045
4050,13/05/2021,4901,49,4050,0,851,26/04/2021,"Chateau Angelus Premier Grand Cru Classe B, Saint-Emilion Grand Cru",Bordeaux,2005,20/05/2021,10060452005,1006045
875,22/07/2021,932,45,863,12,69,10/05/2021,"Chateau Calon Segur 3eme Cru Classe, Saint-Estephe",Bordeaux,2006,29/07/2021,10074752006,1007475
3900,28/07/2021,4660,97,3822,78,838,20/06/2021,"Chateau Margaux Premier Cru Classe, Margaux",Bordeaux,2006,29/07/2021,10127812006,1012781
300,27/05/2021,301,110,304,-4,-3,10/01/2021,"Chateau Batailley 5eme Cru Classe, Pauillac",Bordeaux,2013,28/05/2021,10063222013,1006322
940,29/07/2021,1068,83,866,74,202,20/07/2021,"Chateau Calon Segur 3eme Cru Classe, Saint-Estephe",Bordeaux,2015,30/07/2021,10074752015,1007475
10620,29/07/2021,11800,48,9800,820,2000,11/06/2021,"Chateau Margaux Premier Cru Classe, Margaux",Bordeaux,2015,30/07/2021,10127812015,1012781
408,27/05/2021,414,20,357,51,57,06/05/2021,"Chateau Batailley 5eme Cru Classe, Pauillac",Bordeaux,2018,28/05/2021,10063222018,1006322
3560,17/06/2021,4024,30,3525,35,499,18/06/2021,"Chateau Margaux Premier Cru Classe, Margaux",Bordeaux,2007,20/06/2021,10127812007,1012781
3750,28/07/2021,4246,44,3525,225,721,18/06/2021,"Chateau Margaux Premier Cru Classe, Margaux",Bordeaux,2007,29/07/2021,10127812007,1012781
880,28/07/2021,967,9,725,155,242,13/04/2021,"Chateau Calon Segur 3eme Cru Classe, Saint-Estephe",Bordeaux,2007,29/07/2021,10074752007,1007475
4050,13/05/2021,5054,48,4050,0,1004,26/04/2021,"Chateau Angelus Premier Grand Cru Classe B, Saint-Emilion Grand Cru",Bordeaux,2005,19/05/2021,10060452005,1006045
8400,28/07/2021,8400,1,5700,2700,2700,10/09/2020,"Domaine Leflaive, Chevalier-Montrachet Grand Cru",Burgundy,2007,29/07/2021,10734012007,1073401
4050,13/05/2021,5067,47,4050,0,1017,26/04/2021,"Chateau Angelus Premier Grand Cru Classe B, Saint-Emilion Grand Cru",Bordeaux,2005,14/05/2021,10060452005,1006045
3950,28/07/2021,4392,99,3780,170,612,23/07/2021,"Chateau Margaux Premier Cru Classe, Margaux",Bordeaux,2008,29/07/2021,10127812008,1012781
2500,18/06/2021,2636,2,2220,280,416,14/06/2021,"Gaja, Barbaresco",Piedmont,2001,20/06/2021,10996052001,1099605
1024,17/06/2021,1207,5,1072,-48,135,20/01/2021,"Tignanello, Toscana",Tuscany,2009,20/06/2021,10953912009,1095391
5490,17/06/2021,5830,98,5254,236,576,26/05/2021,"Chateau Margaux Premier Cru Classe, Margaux",Bordeaux,2018,21/06/2021,10127812018,1012781
1800,18/06/2021,1814,1,1300,500,514,30/05/2019,"Gaja, Barbaresco",Piedmont,2007,21/06/2021,10996052007,1099605
3900,17/06/2021,4475,26,3684,216,791,10/06/2020,"Chateau Margaux Premier Cru Classe, Margaux",Bordeaux,2002,21/06/2021,10127812002,1012781
750,17/06/2021,924,109,740,10,184,21/05/2021,"Chateau Calon Segur 3eme Cru Classe, Saint-Estephe",Bordeaux,2017,21/06/2021,10074752017,1007475
5380,18/06/2021,5052,7,4160,1220,892,19/03/2021,"Chateau Margaux Premier Cru Classe, Margaux",Bordeaux,2019,21/06/2021,10127812019,1012781
6830,17/06/2021,7675,46,7086,-256,589,11/06/2021,"Chateau Margaux Premier Cru Classe, Margaux",Bordeaux,2009,21/06/2021,10127812009,1012781
3560,17/06/2021,4007,29,3525,35,482,18/06/2021,"Chateau Margaux Premier Cru Classe, Margaux",Bordeaux,2007,21/06/2021,10127812007,1012781
4050,13/05/2021,4901,49,4050,0,851,26/04/2021,"Chateau Angelus Premier Grand Cru Classe B, Saint-Emilion Grand Cru",Bordeaux,2005,20/05/2021,10060452005,1006045
895,28/07/2021,953,8,781,114,172,16/11/2020,"Chateau Calon Segur 3eme Cru Classe, Saint-Estephe",Bordeaux,2008,29/07/2021,10074752008,1007475
468,28/05/2021,478,1,465,3,13,04/05/2020,"Chateau Batailley 5eme Cru Classe, Pauillac",Bordeaux,2001,30/05/2021,10063222001,1006322
6930,28/07/2021,7720,73,7086,-156,634,11/06/2021,"Chateau Margaux Premier Cru Classe, Margaux",Bordeaux,2009,29/07/2021,10127812009,1012781
9000,28/07/2021,8799,1,5400,3600,3399,13/08/2020,"Domaine Leflaive, Chevalier-Montrachet Grand Cru",Burgundy,2008,29/07/2021,10734012008,1073401
996,28/07/2021,1206,53,1026,-30,180,24/06/2021,"Chateau Calon Segur 3eme Cru Classe, Saint-Estephe",Bordeaux,2009,29/07/2021,10074752009,1007475
468,28/05/2021,582,2,465,3,117,04/05/2020,"Chateau Batailley 5eme Cru Classe, Pauillac",Bordeaux,2001,29/05/2021,10063222001,1006322
1850,21/07/2021,1831,1,1180,670,651,10/03/2017,"Gaja, Barbaresco",Piedmont,2005,29/07/2021,10996052005,1099605
1800,28/07/2021,1700,1,1300,500,400,30/05/2019,"Gaja, Barbaresco",Piedmont,2007,29/07/2021,10996052007,1099605
2386,28/07/2021,2397,3,2190,196,207,01/05/2021,"Gaja, Barbaresco",Piedmont,2004,29/07/2021,10996052004,1099605
520,28/07/2021,563,3,460,60,103,05/05/2020,"Tua Rita, Giusto di Notri, Toscana",Tuscany,2008,29/07/2021,11058072008,1105807
660,28/07/2021,727,5,390,270,337,18/08/2017,"Tua Rita, Giusto di Notri, Toscana",Tuscany,2006,29/07/2021,11058072006,1105807
1700,28/07/2021,1732,2,1378,322,354,29/07/2020,"Tignanello, Toscana",Tuscany,2001,29/07/2021,10953912001,1095391
1408,27/07/2021,1389,2,1238,170,151,02/11/2020,"Tignanello, Toscana",Tuscany,2006,29/07/2021,10953912006,1095391
6400,28/07/2021,7537,63,6188,212,1349,16/07/2021,"Chateau Margaux Premier Cru Classe, Margaux",Bordeaux,2010,29/07/2021,10127812010,1012781
870,30/07/2021,963,7,705,165,258,01/02/2021,"Chateau Calon Segur 3eme Cru Classe, Saint-Estephe",Bordeaux,2002,31/07/2021,10074752002,1007475
8200,27/07/2021,8983,17,8200,0,783,26/07/2021,"Chateau Margaux Premier Cru Classe, Margaux",Bordeaux,2000,31/07/2021,10127812000,1012781
900,30/07/2021,1105,24,800,100,305,21/11/2019,"Chateau Calon Segur 3eme Cru Classe, Saint-Estephe",Bordeaux,2003,31/07/2021,10074752003,1007475
3900,30/07/2021,4434,21,3684,216,750,10/06/2020,"Chateau Margaux Premier Cru Classe, Margaux",Bordeaux,2002,31/07/2021,10127812002,1012781
3826,30/07/2021,4621,46,4116,-290,505,25/02/2021,"Chateau Margaux Premier Cru Classe, Margaux",Bordeaux,2004,31/07/2021,10127812004,1012781
4450,30/07/2021,4693,16,4400,50,293,29/09/2020,"Chateau Margaux Premier Cru Classe, Margaux",Bordeaux,2001,31/07/2021,10127812001,1012781
1800,30/07/2021,1700,1,1300,500,400,30/05/2019,"Gaja, Barbaresco",Piedmont,2007,31/07/2021,10996052007,1099605
2386,30/07/2021,2397,3,2190,196,207,01/05/2021,"Gaja, Barbaresco",Piedmont,2004,31/07/2021,10996052004,1099605
520,30/07/2021,563,3,460,60,103,05/05/2020,"Tua Rita, Giusto di Notri, Toscana",Tuscany,2008,31/07/2021,11058072008,1105807
660,30/07/2021,727,5,390,270,337,18/08/2017,"Tua Rita, Giusto di Notri, Toscana",Tuscany,2006,31/07/2021,11058072006,1105807
1299,06/07/2021,1580,4,1150,149,430,27/07/2021,"Tignanello, Toscana",Tuscany,2008,31/07/2021,10953912008,1095391
1584,30/07/2021,1704,3,1378,206,326,29/07/2020,"Tignanello, Toscana",Tuscany,2001,31/07/2021,10953912001,1095391
1680,30/07/2021,1693,2,1420,260,273,29/06/2021,"Tignanello, Toscana",Tuscany,2004,31/07/2021,10953912004,1095391
6400,30/07/2021,7570,67,6188,212,1382,16/07/2021,"Chateau Margaux Premier Cru Classe, Margaux",Bordeaux,2010,31/07/2021,10127812010,1012781
412,28/05/2021,437,2,220,192,217,17/06/2015,"Chateau Batailley 5eme Cru Classe, Pauillac",Bordeaux,2002,29/05/2021,10063222002,1006322
990,28/07/2021,1117,17,993,-3,124,27/07/2021,"Chateau Calon Segur 3eme Cru Classe, Saint-Estephe",Bordeaux,2010,29/07/2021,10074752010,1007475
589,28/05/2021,674,94,450,139,224,04/05/2021,"Chateau Batailley 5eme Cru Classe, Pauillac",Bordeaux,2005,29/05/2021,10063222005,1006322
990,30/07/2021,1119,17,993,-3,126,27/07/2021,"Chateau Calon Segur 3eme Cru Classe, Saint-Estephe",Bordeaux,2010,31/07/2021,10074752010,1007475
4050,13/05/2021,4911,47,4050,0,861,26/04/2021,"Chateau Angelus Premier Grand Cru Classe B, Saint-Emilion Grand Cru",Bordeaux,2005,22/05/2021,10060452005,1006045
750,30/07/2021,899,29,790,-40,109,01/06/2020,"Chateau Calon Segur 3eme Cru Classe, Saint-Estephe",Bordeaux,2011,31/07/2021,10074752011,1007475
8400,30/07/2021,8400,1,5960,2440,2440,01/08/2017,"Domaine Leflaive, Chevalier-Montrachet Grand Cru",Burgundy,2010,31/07/2021,10734012010,1073401
1180,30/07/2021,1353,4,1140,40,213,21/07/2021,"Tignanello, Toscana",Tuscany,2009,31/07/2021,10953912009,1095391
1326,30/07/2021,1452,3,1170,156,282,24/06/2021,"Tignanello, Toscana",Tuscany,2010,31/07/2021,10953912010,1095391
3800,28/07/2021,4365,81,3690,110,675,13/04/2021,"Chateau Margaux Premier Cru Classe, Margaux",Bordeaux,2011,31/07/2021,10127812011,1012781
4050,03/05/2021,5251,46,4050,0,1201,26/04/2021,"Chateau Angelus Premier Grand Cru Classe B, Saint-Emilion Grand Cru",Bordeaux,2005,10/05/2021,10060452005,1006045
589,28/05/2021,674,94,450,139,224,04/05/2021,"Chateau Batailley 5eme Cru Classe, Pauillac",Bordeaux,2005,29/05/2021,10063222005,1006322
2199,30/07/2021,2229,1,1340,859,889,13/03/2020,"Gaja, Barbaresco",Piedmont,2009,31/07/2021,10996052009,1099605
1050,30/07/2021,1113,9,880,170,233,22/06/2021,"Tignanello, Toscana",Tuscany,2011,31/07/2021,10953912011,1095391
750,28/07/2021,892,29,790,-40,102,01/06/2020,"Chateau Calon Segur 3eme Cru Classe, Saint-Estephe",Bordeaux,2011,29/07/2021,10074752011,1007475
8400,28/07/2021,8400,1,5960,2440,2440,01/08/2017,"Domaine Leflaive, Chevalier-Montrachet Grand Cru",Burgundy,2010,29/07/2021,10734012010,1073401
1180,28/07/2021,1353,4,1140,40,213,21/07/2021,"Tignanello, Toscana",Tuscany,2009,29/07/2021,10953912009,1095391
1326,28/07/2021,1602,3,1170,156,432,24/06/2021,"Tignanello, Toscana",Tuscany,2010,29/07/2021,10953912010,1095391
4050,03/05/2021,4824,34,4050,0,774,26/04/2021,"Chateau Angelus Premier Grand Cru Classe B, Saint-Emilion Grand Cru",Bordeaux,2005,04/05/2021,10060452005,1006045
450,28/05/2021,450,1,340,110,110,31/08/2018,"Chateau Batailley 5eme Cru Classe, Pauillac",Bordeaux,2007,29/05/2021,10063222007,1006322
820,30/07/2021,925,4,735,85,190,09/09/2020,"Chateau Calon Segur 3eme Cru Classe, Saint-Estephe",Bordeaux,2012,31/07/2021,10074752012,1007475
3750,26/07/2021,4318,55,3650,100,668,27/07/2021,"Chateau Margaux Premier Cru Classe, Margaux",Bordeaux,2012,31/07/2021,10127812012,1012781
13200,30/07/2021,12867,1,12850,350,17,30/11/2020,"Jacques-Frederic Mugnier, Chambolle-Musigny Premier Cru, Les Amoureuses",Burgundy,2011,31/07/2021,10496422011,1049642
3700,30/07/2021,4159,48,3520,180,639,07/04/2021,"Chateau Margaux Premier Cru Classe, Margaux",Bordeaux,2013,31/07/2021,10127812013,1012781
4050,03/05/2021,5251,47,4050,0,1201,26/04/2021,"Chateau Angelus Premier Grand Cru Classe B, Saint-Emilion Grand Cru",Bordeaux,2005,07/05/2021,10060452005,1006045
490,28/05/2021,570,26,450,40,120,25/05/2021,"Chateau Batailley 5eme Cru Classe, Pauillac",Bordeaux,2009,30/05/2021,10063222009,1006322
800,30/07/2021,792,19,682,118,110,15/09/2020,"Chateau Calon Segur 3eme Cru Classe, Saint-Estephe",Bordeaux,2013,31/07/2021,10074752013,1007475
3758,28/07/2021,4370,80,3690,68,680,13/04/2021,"Chateau Margaux Premier Cru Classe, Margaux",Bordeaux,2011,29/07/2021,10127812011,1012781
4050,03/05/2021,5067,47,4050,0,1017,26/04/2021,"Chateau Angelus Premier Grand Cru Classe B, Saint-Emilion Grand Cru",Bordeaux,2005,12/05/2021,10060452005,1006045
490,28/05/2021,587,27,450,40,137,25/05/2021,"Chateau Batailley 5eme Cru Classe, Pauillac",Bordeaux,2009,29/05/2021,10063222009,1006322
2199,28/07/2021,2229,1,1340,859,889,13/03/2020,"Gaja, Barbaresco",Piedmont,2009,29/07/2021,10996052009,1099605
1050,28/07/2021,1117,9,880,170,237,22/06/2021,"Tignanello, Toscana",Tuscany,2011,29/07/2021,10953912011,1095391
960,30/07/2021,1346,11,850,110,496,28/01/2021,"Tignanello, Toscana",Tuscany,2012,31/07/2021,10953912012,1095391
4050,03/05/2021,5251,46,4050,0,1201,26/04/2021,"Chateau Angelus Premier Grand Cru Classe B, Saint-Emilion Grand Cru",Bordeaux,2005,10/05/2021,10060452005,1006045
3800,30/07/2021,4359,126,3480,320,879,17/06/2021,"Chateau Margaux Premier Cru Classe, Margaux",Bordeaux,2014,31/07/2021,10127812014,1012781
790,30/07/2021,877,18,801,-11,76,31/05/2021,"Chateau Calon Segur 3eme Cru Classe, Saint-Estephe",Bordeaux,2014,31/07/2021,10074752014,1007475
490,28/05/2021,570,26,450,40,120,25/05/2021,"Chateau Batailley 5eme Cru Classe, Pauillac",Bordeaux,2009,30/05/2021,10063222009,1006322
1550,30/07/2021,1550,1,1300,250,250,27/04/2021,"Gaja, Barbaresco",Piedmont,2012,31/07/2021,10996052012,1099605
950,30/07/2021,1147,8,960,-10,187,27/07/2021,"Tignanello, Toscana",Tuscany,2013,31/07/2021,10953912013,1095391
1030,30/07/2021,1101,7,854,176,247,15/07/2021,"Tignanello, Toscana",Tuscany,2014,31/07/2021,10953912014,1095391
1400,30/07/2021,1533,13,1360,40,173,18/07/2021,"Gaja, Barbaresco",Piedmont,2013,31/07/2021,10996052013,1099605
10800,20/07/2021,10694,1,8000,2800,2694,30/01/2020,"Domaine Leflaive, Chevalier-Montrachet Grand Cru",Burgundy,2014,31/07/2021,10734012014,1073401
1573,28/07/2021,1542,11,1300,273,242,10/07/2021,"Gaja, Barbaresco",Piedmont,2014,31/07/2021,10996052014,1099605
4050,03/05/2021,5068,47,4050,0,1018,26/04/2021,"Chateau Angelus Premier Grand Cru Classe B, Saint-Emilion Grand Cru",Bordeaux,2005,11/05/2021,10060452005,1006045
4050,03/05/2021,5067,47,4050,0,1017,26/04/2021,"Chateau Angelus Premier Grand Cru Classe B, Saint-Emilion Grand Cru",Bordeaux,2005,12/05/2021,10060452005,1006045
490,28/05/2021,587,27,450,40,137,25/05/2021,"Chateau Batailley 5eme Cru Classe, Pauillac",Bordeaux,2009,29/05/2021,10063222009,1006322
820,28/07/2021,920,4,735,85,185,09/09/2020,"Chateau Calon Segur 3eme Cru Classe, Saint-Estephe",Bordeaux,2012,29/07/2021,10074752012,1007475
3750,26/07/2021,4295,57,3650,100,645,27/07/2021,"Chateau Margaux Premier Cru Classe, Margaux",Bordeaux,2012,29/07/2021,10127812012,1012781
13200,28/07/2021,12867,1,12850,350,17,30/11/2020,"Jacques-Frederic Mugnier, Chambolle-Musigny Premier Cru, Les Amoureuses",Burgundy,2011,29/07/2021,10496422011,1049642
940,30/07/2021,1068,82,866,74,202,20/07/2021,"Chateau Calon Segur 3eme Cru Classe, Saint-Estephe",Bordeaux,2015,31/07/2021,10074752015,1007475
10620,30/07/2021,11810,47,9800,820,2010,11/06/2021,"Chateau Margaux Premier Cru Classe, Margaux",Bordeaux,2015,31/07/2021,10127812015,1012781
490,28/05/2021,594,407,494,-4,100,20/04/2021,"Chateau Batailley 5eme Cru Classe, Pauillac",Bordeaux,2010,29/05/2021,10063222010,1006322
14520,30/07/2021,14520,1,12000,2520,2520,28/05/2020,"Jacques-Frederic Mugnier, Chambolle-Musigny Premier Cru, Les Amoureuses",Burgundy,2014,31/07/2021,10496422014,1049642
1130,28/07/2021,1223,17,1012,118,211,02/07/2021,"Tignanello, Toscana",Tuscany,2015,31/07/2021,10953912015,1095391
487,19/07/2021,537,15,388,99,149,29/09/2020,"Tua Rita, Giusto di Notri, Toscana",Tuscany,2015,31/07/2021,11058072015,1105807
8000,30/07/2021,7964,1,7900,100,64,29/04/2019,"Domaine Leflaive, Chevalier-Montrachet Grand Cru",Burgundy,2015,31/07/2021,10734012015,1073401
16200,30/07/2021,16327,0,18750,-2550,-2423,29/08/2018,"Jacques-Frederic Mugnier, Chambolle-Musigny Premier Cru, Les Amoureuses",Burgundy,2015,31/07/2021,10496422015,1049642
5415,30/07/2021,5885,159,5500,-85,385,06/07/2021,"Chateau Margaux Premier Cru Classe, Margaux",Bordeaux,2016,31/07/2021,10127812016,1012781
4050,03/05/2021,5267,46,4050,0,1217,26/04/2021,"Chateau Angelus Premier Grand Cru Classe B, Saint-Emilion Grand Cru",Bordeaux,2005,05/05/2021,10060452005,1006045
1100,30/07/2021,1217,82,1036,64,181,27/05/2021,"Chateau Calon Segur 3eme Cru Classe, Saint-Estephe",Bordeaux,2016,31/07/2021,10074752016,1007475
490,28/05/2021,593,406,494,-4,99,20/04/2021,"Chateau Batailley 5eme Cru Classe, Pauillac",Bordeaux,2010,30/05/2021,10063222010,1006322
1280,30/07/2021,1367,54,1220,60,147,14/07/2021,"Tignanello, Toscana",Tuscany,2016,31/07/2021,10953912016,1095391
1440,30/07/2021,1671,33,1510,-70,161,18/07/2021,"Gaja, Barbaresco",Piedmont,2016,31/07/2021,10996052016,1099605
4050,03/05/2021,4824,34,4050,0,774,26/04/2021,"Chateau Angelus Premier Grand Cru Classe B, Saint-Emilion Grand Cru",Bordeaux,2005,04/05/2021,10060452005,1006045
780,30/07/2021,937,95,740,40,197,21/05/2021,"Chateau Calon Segur 3eme Cru Classe, Saint-Estephe",Bordeaux,2017,31/07/2021,10074752017,1007475
3820,30/07/2021,4618,210,3950,-130,668,30/06/2021,"Chateau Margaux Premier Cru Classe, Margaux",Bordeaux,2017,31/07/2021,10127812017,1012781
1350,30/07/2021,1481,55,1260,90,221,18/02/2021,"Gaja, Barbaresco",Piedmont,2015,31/07/2021,10996052015,1099605
479,30/07/2021,504,171,420,59,84,28/05/2021,"Tua Rita, Giusto di Notri, Toscana",Tuscany,2016,31/07/2021,11058072016,1105807
8000,19/07/2021,9056,2,6974,1026,2082,14/03/2021,"Domaine Leflaive, Chevalier-Montrachet Grand Cru",Burgundy,2017,31/07/2021,10734012017,1073401
3700,28/07/2021,4164,47,3520,180,644,07/04/2021,"Chateau Margaux Premier Cru Classe, Margaux",Bordeaux,2013,29/07/2021,10127812013,1012781
4050,03/05/2021,5251,47,4050,0,1201,26/04/2021,"Chateau Angelus Premier Grand Cru Classe B, Saint-Emilion Grand Cru",Bordeaux,2005,07/05/2021,10060452005,1006045
490,28/05/2021,593,406,494,-4,99,20/04/2021,"Chateau Batailley 5eme Cru Classe, Pauillac",Bordeaux,2010,30/05/2021,10063222010,1006322
1500,20/07/2021,1454,6,1352,148,102,23/09/2020,"Gaja, Barbaresco",Piedmont,2011,29/07/2021,10996052011,1099605
8098,29/07/2021,9787,3,7290,808,2497,21/08/2020,"Domaine Denis Mortet, Chambertin Grand Cru",Burgundy,2017,31/07/2021,10490202017,1049020
4050,03/05/2021,5267,46,4050,0,1217,26/04/2021,"Chateau Angelus Premier Grand Cru Classe B, Saint-Emilion Grand Cru",Bordeaux,2005,05/05/2021,10060452005,1006045
5600,30/07/2021,5880,97,5254,346,626,26/05/2021,"Chateau Margaux Premier Cru Classe, Margaux",Bordeaux,2018,31/07/2021,10127812018,1012781
490,28/05/2021,594,407,494,-4,100,20/04/2021,"Chateau Batailley 5eme Cru Classe, Pauillac",Bordeaux,2010,29/05/2021,10063222010,1006322
930,29/07/2021,993,97,864,66,129,26/07/2021,"Tignanello, Toscana",Tuscany,2017,31/07/2021,10953912017,1095391
8568,30/07/2021,8654,4,7330,1238,1324,02/06/2021,"Domaine Leflaive, Chevalier-Montrachet Grand Cru",Burgundy,2018,31/07/2021,10734012018,1073401
300,28/05/2021,301,110,304,-4,-3,10/01/2021,"Chateau Batailley 5eme Cru Classe, Pauillac",Bordeaux,2013,29/05/2021,10063222013,1006322
920,30/07/2021,1034,40,842,78,192,22/08/2020,"Chateau Calon Segur 3eme Cru Classe, Saint-Estephe",Bordeaux,2019,31/07/2021,10074752019,1007475
5290,30/07/2021,5241,7,4160,1130,1081,19/03/2021,"Chateau Margaux Premier Cru Classe, Margaux",Bordeaux,2019,31/07/2021,10127812019,1012781
1480,26/07/2021,1616,86,1398,82,218,01/07/2021,"Gaja, Barbaresco",Piedmont,2017,31/07/2021,10996052017,1099605
1624,30/07/2021,1734,18,1598,26,136,26/07/2021,"Gaja, Barbaresco",Piedmont,2018,31/07/2021,10996052018,1099605
960,28/07/2021,1325,12,850,110,475,28/01/2021,"Tignanello, Toscana",Tuscany,2012,29/07/2021,10953912012,1095391
4050,03/05/2021,5068,47,4050,0,1018,26/04/2021,"Chateau Angelus Premier Grand Cru Classe B, Saint-Emilion Grand Cru",Bordeaux,2005,11/05/2021,10060452005,1006045
3800,28/07/2021,4356,131,3480,320,876,17/06/2021,"Chateau Margaux Premier Cru Classe, Margaux",Bordeaux,2014,29/07/2021,10127812014,1012781
760,28/07/2021,874,18,801,-41,73,31/05/2021,"Chateau Calon Segur 3eme Cru Classe, Saint-Estephe",Bordeaux,2014,29/07/2021,10074752014,1007475
530,28/05/2021,531,34,312,218,219,12/03/2021,"Chateau Batailley 5eme Cru Classe, Pauillac",Bordeaux,2015,02/06/2021,10063222015,1006322
1550,28/07/2021,1550,1,1300,250,250,27/04/2021,"Gaja, Barbaresco",Piedmont,2012,29/07/2021,10996052012,1099605
950,28/07/2021,1128,9,960,-10,168,27/07/2021,"Tignanello, Toscana",Tuscany,2013,29/07/2021,10953912013,1095391
2900,10/08/2021,3066,13,2650,250,416,28/05/2021,"Chateau Angelus Premier Grand Cru Classe B, Saint-Emilion Grand Cru",Bordeaux,2006,11/08/2021,10060452006,1006045
4850,11/06/2021,5623,31,4842,8,781,19/05/2021,"Chateau Margaux Premier Cru Classe, Margaux",Bordeaux,2003,13/06/2021,10127812003,1012781
1000,08/06/2021,1153,98,988,12,165,28/05/2021,"Chateau Calon Segur 3eme Cru Classe, Saint-Estephe",Bordeaux,2005,09/06/2021,10074752005,1007475
6300,08/06/2021,7458,64,6190,110,1268,23/05/2021,"Chateau Margaux Premier Cru Classe, Margaux",Bordeaux,2010,09/06/2021,10127812010,1012781
880,03/06/2021,949,14,781,99,168,16/11/2020,"Chateau Calon Segur 3eme Cru Classe, Saint-Estephe",Bordeaux,2008,09/06/2021,10074752008,1007475
828,09/06/2021,938,163,800,28,138,05/06/2021,"Tignanello, Toscana",Tuscany,2017,14/06/2021,10953912017,1095391
1000,07/06/2021,1169,44,1030,-30,139,25/05/2021,"Chateau Calon Segur 3eme Cru Classe, Saint-Estephe",Bordeaux,2009,09/06/2021,10074752009,1007475
2900,10/08/2021,3066,13,2650,250,416,28/05/2021,"Chateau Angelus Premier Grand Cru Classe B, Saint-Emilion Grand Cru",Bordeaux,2006,11/08/2021,10060452006,1006045
8040,31/05/2021,8487,22,7950,90,537,12/03/2021,"Chateau Margaux Premier Cru Classe, Margaux",Bordeaux,2000,01/06/2021,10127812000,1012781
750,31/05/2021,1016,51,790,-40,226,01/06/2020,"Chateau Calon Segur 3eme Cru Classe, Saint-Estephe",Bordeaux,2011,01/06/2021,10074752011,1007475
880,08/06/2021,986,13,725,155,261,13/04/2021,"Chateau Calon Segur 3eme Cru Classe, Saint-Estephe",Bordeaux,2007,09/06/2021,10074752007,1007475
10500,07/06/2021,11988,53,9844,656,2144,29/03/2021,"Chateau Margaux Premier Cru Classe, Margaux",Bordeaux,2015,09/06/2021,10127812015,1012781
880,31/05/2021,986,13,725,155,261,13/04/2021,"Chateau Calon Segur 3eme Cru Classe, Saint-Estephe",Bordeaux,2007,01/06/2021,10074752007,1007475
900,28/05/2021,1239,13,850,50,389,28/01/2021,"Tignanello, Toscana",Tuscany,2012,01/06/2021,10953912012,1095391
2950,09/08/2021,3080,12,2650,300,430,28/05/2021,"Chateau Angelus Premier Grand Cru Classe B, Saint-Emilion Grand Cru",Bordeaux,2006,10/08/2021,10060452006,1006045
789,31/05/2021,976,21,745,44,231,16/11/2020,"Chateau Calon Segur 3eme Cru Classe, Saint-Estephe",Bordeaux,2004,01/06/2021,10074752004,1007475
2950,09/08/2021,3080,12,2650,300,430,28/05/2021,"Chateau Angelus Premier Grand Cru Classe B, Saint-Emilion Grand Cru",Bordeaux,2006,10/08/2021,10060452006,1006045
1000,31/05/2021,1160,41,1030,-30,130,25/05/2021,"Chateau Calon Segur 3eme Cru Classe, Saint-Estephe",Bordeaux,2009,01/06/2021,10074752009,1007475
3720,08/06/2021,4294,147,3480,240,814,10/04/2021,"Chateau Margaux Premier Cru Classe, Margaux",Bordeaux,2014,09/06/2021,10127812014,1012781
907,07/06/2021,957,24,805,102,152,20/11/2019,"Chateau Calon Segur 3eme Cru Classe, Saint-Estephe",Bordeaux,2001,09/06/2021,10074752001,1007475
2500,08/06/2021,3334,3,1200,1300,2134,16/05/2012,"Gaja, Barbaresco",Piedmont,2001,09/06/2021,10996052001,1099605
990,08/06/2021,1110,21,1000,-10,110,12/04/2021,"Chateau Calon Segur 3eme Cru Classe, Saint-Estephe",Bordeaux,2010,09/06/2021,10074752010,1007475
2950,06/08/2021,3080,12,2650,300,430,28/05/2021,"Chateau Angelus Premier Grand Cru Classe B, Saint-Emilion Grand Cru",Bordeaux,2006,07/08/2021,10060452006,1006045
2232,31/05/2021,2358,5,2190,42,168,01/05/2021,"Gaja, Barbaresco",Piedmont,2004,01/06/2021,10996052004,1099605
9600,27/05/2021,9847,2,8000,1600,1847,30/01/2020,"Domaine Leflaive, Chevalier-Montrachet Grand Cru",Burgundy,2014,01/06/2021,10734012014,1073401
6291,31/05/2021,7447,58,6190,101,1257,23/05/2021,"Chateau Margaux Premier Cru Classe, Margaux",Bordeaux,2010,01/06/2021,10127812010,1012781
1029,31/05/2021,1161,6,860,169,301,08/03/2021,"Tignanello, Toscana",Tuscany,2013,01/06/2021,10953912013,1095391
1030,28/07/2021,1000,4,854,176,146,15/07/2021,"Tignanello, Toscana",Tuscany,2014,29/07/2021,10953912014,1095391
1400,28/07/2021,1534,13,1360,40,174,18/07/2021,"Gaja, Barbaresco",Piedmont,2013,29/07/2021,10996052013,1099605
10800,20/07/2021,10326,1,8000,2800,2326,30/01/2020,"Domaine Leflaive, Chevalier-Montrachet Grand Cru",Burgundy,2014,29/07/2021,10734012014,1073401
1573,28/07/2021,1544,11,1300,273,244,10/07/2021,"Gaja, Barbaresco",Piedmont,2014,29/07/2021,10996052014,1099605
2950,06/08/2021,3080,12,2650,300,430,28/05/2021,"Chateau Angelus Premier Grand Cru Classe B, Saint-Emilion Grand Cru",Bordeaux,2006,07/08/2021,10060452006,1006045
2950,04/08/2021,3082,12,2650,300,432,28/05/2021,"Chateau Angelus Premier Grand Cru Classe B, Saint-Emilion Grand Cru",Bordeaux,2006,06/08/2021,10060452006,1006045
900,04/06/2021,1233,14,850,50,383,28/01/2021,"Tignanello, Toscana",Tuscany,2012,09/06/2021,10953912012,1095391
1024,31/05/2021,1198,10,1072,-48,126,20/01/2021,"Tignanello, Toscana",Tuscany,2009,01/06/2021,10953912009,1095391
2950,04/08/2021,3082,12,2650,300,432,28/05/2021,"Chateau Angelus Premier Grand Cru Classe B, Saint-Emilion Grand Cru",Bordeaux,2006,06/08/2021,10060452006,1006045
870,08/06/2021,948,10,705,165,243,01/02/2021,"Chateau Calon Segur 3eme Cru Classe, Saint-Estephe",Bordeaux,2002,09/06/2021,10074752002,1007475
907,31/05/2021,927,19,805,102,122,20/11/2019,"Chateau Calon Segur 3eme Cru Classe, Saint-Estephe",Bordeaux,2001,01/06/2021,10074752001,1007475
950,08/06/2021,1007,57,863,87,144,10/05/2021,"Chateau Calon Segur 3eme Cru Classe, Saint-Estephe",Bordeaux,2006,09/06/2021,10074752006,1007475
990,31/05/2021,1114,22,1000,-10,114,12/04/2021,"Chateau Calon Segur 3eme Cru Classe, Saint-Estephe",Bordeaux,2010,01/06/2021,10074752010,1007475
2880,22/07/2021,3082,12,2650,230,432,28/05/2021,"Chateau Angelus Premier Grand Cru Classe B, Saint-Emilion Grand Cru",Bordeaux,2006,03/08/2021,10060452006,1006045
940,28/07/2021,1067,84,866,74,201,20/07/2021,"Chateau Calon Segur 3eme Cru Classe, Saint-Estephe",Bordeaux,2015,29/07/2021,10074752015,1007475
10620,28/07/2021,11832,49,9800,820,2032,11/06/2021,"Chateau Margaux Premier Cru Classe, Margaux",Bordeaux,2015,29/07/2021,10127812015,1012781
790,27/05/2021,921,31,801,-11,120,31/05/2021,"Chateau Calon Segur 3eme Cru Classe, Saint-Estephe",Bordeaux,2014,01/06/2021,10074752014,1007475
3900,31/05/2021,4425,90,3800,100,625,12/05/2021,"Chateau Margaux Premier Cru Classe, Margaux",Bordeaux,2008,01/06/2021,10127812008,1012781
6250,31/05/2021,7278,54,6360,-110,918,24/05/2021,"Chateau Margaux Premier Cru Classe, Margaux",Bordeaux,2005,01/06/2021,10127812005,1012781
3720,31/05/2021,4215,86,3480,240,735,10/04/2021,"Chateau Margaux Premier Cru Classe, Margaux",Bordeaux,2014,01/06/2021,10127812014,1012781
3900,31/05/2021,4508,29,3684,216,824,10/06/2020,"Chateau Margaux Premier Cru Classe, Margaux",Bordeaux,2002,01/06/2021,10127812002,1012781
3740,08/06/2021,3976,53,3520,220,456,07/04/2021,"Chateau Margaux Premier Cru Classe, Margaux",Bordeaux,2013,09/06/2021,10127812013,1012781
1408,27/05/2021,1354,2,996,412,358,14/06/2019,"Tignanello, Toscana",Tuscany,2000,09/06/2021,10953912000,1095391
1245,08/06/2021,1545,3,882,363,663,26/04/2019,"Tignanello, Toscana",Tuscany,2003,09/06/2021,10953912003,1095391
2880,22/07/2021,3142,17,2650,230,492,28/05/2021,"Chateau Angelus Premier Grand Cru Classe B, Saint-Emilion Grand Cru",Bordeaux,2006,29/07/2021,10060452006,1006045
3750,24/05/2021,4135,37,3560,190,575,20/11/2020,"Chateau Margaux Premier Cru Classe, Margaux",Bordeaux,2012,01/06/2021,10127812012,1012781
1028,08/06/2021,1055,8,860,168,195,08/03/2021,"Tignanello, Toscana",Tuscany,2011,09/06/2021,10953912011,1095391
2880,22/07/2021,3142,17,2650,230,492,28/05/2021,"Chateau Angelus Premier Grand Cru Classe B, Saint-Emilion Grand Cru",Bordeaux,2006,29/07/2021,10060452006,1006045
408,28/05/2021,415,20,357,51,58,06/05/2021,"Chateau Batailley 5eme Cru Classe, Pauillac",Bordeaux,2018,29/05/2021,10063222018,1006322
6750,31/05/2021,7629,42,6525,225,1104,23/05/2021,"Chateau Margaux Premier Cru Classe, Margaux",Bordeaux,2009,01/06/2021,10127812009,1012781
780,31/05/2021,842,12,682,98,160,15/09/2020,"Chateau Calon Segur 3eme Cru Classe, Saint-Estephe",Bordeaux,2013,01/06/2021,10074752013,1007475
950,31/05/2021,1003,59,863,87,140,10/05/2021,"Chateau Calon Segur 3eme Cru Classe, Saint-Estephe",Bordeaux,2006,01/06/2021,10074752006,1007475
3758,31/05/2021,4049,98,3690,68,359,13/04/2021,"Chateau Margaux Premier Cru Classe, Margaux",Bordeaux,2011,01/06/2021,10127812011,1012781
2880,22/07/2021,3084,12,2650,230,434,28/05/2021,"Chateau Angelus Premier Grand Cru Classe B, Saint-Emilion Grand Cru",Bordeaux,2006,31/07/2021,10060452006,1006045
990,31/05/2021,1153,97,988,2,165,28/05/2021,"Chateau Calon Segur 3eme Cru Classe, Saint-Estephe",Bordeaux,2005,01/06/2021,10074752005,1007475
1264,31/05/2021,1363,8,1172,92,191,07/04/2021,"Tignanello, Toscana",Tuscany,2010,01/06/2021,10953912010,1095391
10446,31/05/2021,12579,63,9844,602,2735,29/03/2021,"Chateau Margaux Premier Cru Classe, Margaux",Bordeaux,2015,01/06/2021,10127812015,1012781
2880,22/07/2021,3154,16,2650,230,504,28/05/2021,"Chateau Angelus Premier Grand Cru Classe B, Saint-Emilion Grand Cru",Bordeaux,2006,23/07/2021,10060452006,1006045
2880,22/07/2021,3154,16,2650,230,504,28/05/2021,"Chateau Angelus Premier Grand Cru Classe B, Saint-Emilion Grand Cru",Bordeaux,2006,23/07/2021,10060452006,1006045
3724,31/05/2021,4097,36,3592,132,505,06/05/2021,"Chateau Margaux Premier Cru Classe, Margaux",Bordeaux,2007,01/06/2021,10127812007,1012781
1700,31/05/2021,1658,4,1378,322,280,29/07/2020,"Tignanello, Toscana",Tuscany,2001,01/06/2021,10953912001,1095391
900,31/05/2021,1092,30,800,100,292,21/11/2019,"Chateau Calon Segur 3eme Cru Classe, Saint-Estephe",Bordeaux,2003,01/06/2021,10074752003,1007475
1040,14/07/2021,1336,39,940,100,396,18/03/2021,"Chateau Calon Segur 3eme Cru Classe, Saint-Estephe",Bordeaux,2000,17/07/2021,10074752000,1007475
870,16/07/2021,966,5,705,165,261,01/02/2021,"Chateau Calon Segur 3eme Cru Classe, Saint-Estephe",Bordeaux,2002,17/07/2021,10074752002,1007475
950,16/07/2021,1131,23,800,150,331,21/11/2019,"Chateau Calon Segur 3eme Cru Classe, Saint-Estephe",Bordeaux,2003,17/07/2021,10074752003,1007475
885,31/05/2021,936,18,781,104,155,16/11/2020,"Chateau Calon Segur 3eme Cru Classe, Saint-Estephe",Bordeaux,2008,01/06/2021,10074752008,1007475
1678,08/06/2021,1648,4,1180,498,468,25/06/2020,"Tignanello, Toscana",Tuscany,2004,09/06/2021,10953912004,1095391
2880,22/07/2021,3082,12,2650,230,432,28/05/2021,"Chateau Angelus Premier Grand Cru Classe B, Saint-Emilion Grand Cru",Bordeaux,2006,03/08/2021,10060452006,1006045
3826,31/05/2021,4532,59,4116,-290,416,25/02/2021,"Chateau Margaux Premier Cru Classe, Margaux",Bordeaux,2004,01/06/2021,10127812004,1012781
408,28/05/2021,412,18,357,51,55,06/05/2021,"Chateau Batailley 5eme Cru Classe, Pauillac",Bordeaux,2018,31/05/2021,10063222018,1006322
950,18/05/2021,1110,40,830,120,280,18/04/2021,"Tignanello, Toscana",Tuscany,2014,01/06/2021,10953912014,1095391
4400,31/05/2021,4852,22,4400,0,452,29/09/2020,"Chateau Margaux Premier Cru Classe, Margaux",Bordeaux,2001,01/06/2021,10127812001,1012781
1299,08/06/2021,1502,7,1010,289,492,18/12/2020,"Tignanello, Toscana",Tuscany,2008,09/06/2021,10953912008,1095391
3740,31/05/2021,3991,52,3520,220,471,07/04/2021,"Chateau Margaux Premier Cru Classe, Margaux",Bordeaux,2013,01/06/2021,10127812013,1012781
3900,31/05/2021,4703,77,3861,39,842,28/05/2021,"Chateau Margaux Premier Cru Classe, Margaux",Bordeaux,2006,01/06/2021,10127812006,1012781
1009,31/05/2021,1048,9,860,149,188,08/03/2021,"Tignanello, Toscana",Tuscany,2011,01/06/2021,10953912011,1095391
3758,08/06/2021,4050,97,3690,68,360,13/04/2021,"Chateau Margaux Premier Cru Classe, Margaux",Bordeaux,2011,09/06/2021,10127812011,1012781
1408,08/06/2021,1394,5,1238,170,156,02/11/2020,"Tignanello, Toscana",Tuscany,2006,09/06/2021,10953912006,1095391
6830,07/06/2021,7662,50,6525,305,1137,23/05/2021,"Chateau Margaux Premier Cru Classe, Margaux",Bordeaux,2009,09/06/2021,10127812009,1012781
2880,22/07/2021,3084,12,2650,230,434,28/05/2021,"Chateau Angelus Premier Grand Cru Classe B, Saint-Emilion Grand Cru",Bordeaux,2006,31/07/2021,10060452006,1006045
4450,16/07/2021,4772,24,4400,50,372,29/09/2020,"Chateau Margaux Premier Cru Classe, Margaux",Bordeaux,2001,17/07/2021,10127812001,1012781
3939,16/07/2021,4430,22,3684,255,746,10/06/2020,"Chateau Margaux Premier Cru Classe, Margaux",Bordeaux,2002,17/07/2021,10127812002,1012781
3826,16/07/2021,4576,46,4116,-290,460,25/02/2021,"Chateau Margaux Premier Cru Classe, Margaux",Bordeaux,2004,17/07/2021,10127812004,1012781
4850,16/07/2021,6067,24,4650,200,1417,21/06/2021,"Chateau Margaux Premier Cru Classe, Margaux",Bordeaux,2003,17/07/2021,10127812003,1012781
2950,21/07/2021,3173,15,2650,300,523,28/05/2021,"Chateau Angelus Premier Grand Cru Classe B, Saint-Emilion Grand Cru",Bordeaux,2006,22/07/2021,10060452006,1006045
2950,21/07/2021,3173,15,2650,300,523,28/05/2021,"Chateau Angelus Premier Grand Cru Classe B, Saint-Emilion Grand Cru",Bordeaux,2006,22/07/2021,10060452006,1006045
840,16/07/2021,977,16,745,95,232,16/11/2020,"Chateau Calon Segur 3eme Cru Classe, Saint-Estephe",Bordeaux,2004,17/07/2021,10074752004,1007475
686,08/06/2021,828,13,682,4,146,15/09/2020,"Chateau Calon Segur 3eme Cru Classe, Saint-Estephe",Bordeaux,2013,09/06/2021,10074752013,1007475
2950,19/07/2021,3173,15,2650,300,523,28/05/2021,"Chateau Angelus Premier Grand Cru Classe B, Saint-Emilion Grand Cru",Bordeaux,2006,20/07/2021,10060452006,1006045
3900,08/06/2021,4613,95,3861,39,752,28/05/2021,"Chateau Margaux Premier Cru Classe, Margaux",Bordeaux,2006,09/06/2021,10127812006,1012781
907,16/07/2021,926,18,805,102,121,20/11/2019,"Chateau Calon Segur 3eme Cru Classe, Saint-Estephe",Bordeaux,2001,17/07/2021,10074752001,1007475
1408,08/06/2021,1368,1,1150,258,218,21/04/2019,"Tignanello, Toscana",Tuscany,2005,09/06/2021,10953912005,1095391
3800,10/05/2021,4383,125,3690,110,693,13/04/2021,"Chateau Margaux Premier Cru Classe, Margaux",Bordeaux,2011,11/05/2021,10127812011,1012781
3860,10/05/2021,4795,77,3800,60,995,07/04/2021,"Chateau Margaux Premier Cru Classe, Margaux",Bordeaux,2006,11/05/2021,10127812006,1012781
2950,19/07/2021,3173,15,2650,300,523,28/05/2021,"Chateau Angelus Premier Grand Cru Classe B, Saint-Emilion Grand Cru",Bordeaux,2006,20/07/2021,10060452006,1006045
2950,16/07/2021,3170,14,2650,300,520,28/05/2021,"Chateau Angelus Premier Grand Cru Classe B, Saint-Emilion Grand Cru",Bordeaux,2006,17/07/2021,10060452006,1006045
3826,08/06/2021,4526,58,4116,-290,410,25/02/2021,"Chateau Margaux Premier Cru Classe, Margaux",Bordeaux,2004,09/06/2021,10127812004,1012781
2950,16/07/2021,3170,14,2650,300,520,28/05/2021,"Chateau Angelus Premier Grand Cru Classe B, Saint-Emilion Grand Cru",Bordeaux,2006,17/07/2021,10060452006,1006045
1028,31/05/2021,914,4,470,558,444,29/03/2018,"Chateau Batailley 5eme Cru Classe, Pauillac",Bordeaux,2000,23/06/2021,10063222000,1006322
2232,08/06/2021,2369,5,2190,42,179,01/05/2021,"Gaja, Barbaresco",Piedmont,2004,09/06/2021,10996052004,1099605
3900,08/06/2021,4431,108,3700,200,731,07/06/2021,"Chateau Margaux Premier Cru Classe, Margaux",Bordeaux,2008,09/06/2021,10127812008,1012781
1028,31/05/2021,771,3,470,558,301,29/03/2018,"Chateau Batailley 5eme Cru Classe, Pauillac",Bordeaux,2000,17/06/2021,10063222000,1006322
2950,14/07/2021,3170,14,2650,300,520,28/05/2021,"Chateau Angelus Premier Grand Cru Classe B, Saint-Emilion Grand Cru",Bordeaux,2006,15/07/2021,10060452006,1006045
1024,10/05/2021,1125,10,1072,-48,53,20/01/2021,"Tignanello, Toscana",Tuscany,2009,11/05/2021,10953912009,1095391
995,10/05/2021,1122,18,1000,-5,122,12/04/2021,"Chateau Calon Segur 3eme Cru Classe, Saint-Estephe",Bordeaux,2010,11/05/2021,10074752010,1007475
950,10/05/2021,1017,49,863,87,154,10/05/2021,"Chateau Calon Segur 3eme Cru Classe, Saint-Estephe",Bordeaux,2006,11/05/2021,10074752006,1007475
1028,31/05/2021,795,3,470,558,325,29/03/2018,"Chateau Batailley 5eme Cru Classe, Pauillac",Bordeaux,2000,20/06/2021,10063222000,1006322
1029,05/05/2021,1181,70,975,54,206,12/04/2021,"Chateau Calon Segur 3eme Cru Classe, Saint-Estephe",Bordeaux,2005,11/05/2021,10074752005,1007475
880,10/05/2021,958,9,725,155,233,13/04/2021,"Chateau Calon Segur 3eme Cru Classe, Saint-Estephe",Bordeaux,2007,11/05/2021,10074752007,1007475
3700,06/05/2021,4094,29,3592,108,502,06/05/2021,"Chateau Margaux Premier Cru Classe, Margaux",Bordeaux,2007,11/05/2021,10127812007,1012781
9600,10/05/2021,9718,3,8000,1600,1718,30/01/2020,"Domaine Leflaive, Chevalier-Montrachet Grand Cru",Burgundy,2014,11/05/2021,10734012014,1073401
6600,10/05/2021,7979,73,6412,188,1567,25/03/2021,"Chateau Margaux Premier Cru Classe, Margaux",Bordeaux,2009,11/05/2021,10127812009,1012781
1028,31/05/2021,914,4,470,558,444,29/03/2018,"Chateau Batailley 5eme Cru Classe, Pauillac",Bordeaux,2000,23/06/2021,10063222000,1006322
6500,16/07/2021,7413,27,6776,-276,637,10/06/2021,"Chateau Margaux Premier Cru Classe, Margaux",Bordeaux,2005,17/07/2021,10127812005,1012781
2950,14/07/2021,3170,14,2650,300,520,28/05/2021,"Chateau Angelus Premier Grand Cru Classe B, Saint-Emilion Grand Cru",Bordeaux,2006,15/07/2021,10060452006,1006045
3026,09/07/2021,3208,12,2650,376,558,28/05/2021,"Chateau Angelus Premier Grand Cru Classe B, Saint-Emilion Grand Cru",Bordeaux,2006,14/07/2021,10060452006,1006045
2950,09/07/2021,3208,12,2650,300,558,28/05/2021,"Chateau Angelus Premier Grand Cru Classe B, Saint-Emilion Grand Cru",Bordeaux,2006,10/07/2021,10060452006,1006045
6100,10/05/2021,7453,55,5922,178,1531,13/04/2021,"Chateau Margaux Premier Cru Classe, Margaux",Bordeaux,2010,11/05/2021,10127812010,1012781
3827,10/05/2021,4581,59,4116,-289,465,25/02/2021,"Chateau Margaux Premier Cru Classe, Margaux",Bordeaux,2004,11/05/2021,10127812004,1012781
830,10/05/2021,928,17,781,49,147,16/11/2020,"Chateau Calon Segur 3eme Cru Classe, Saint-Estephe",Bordeaux,2008,11/05/2021,10074752008,1007475
2950,09/07/2021,3208,12,2650,300,558,28/05/2021,"Chateau Angelus Premier Grand Cru Classe B, Saint-Emilion Grand Cru",Bordeaux,2006,10/07/2021,10060452006,1006045
4800,10/05/2021,5743,26,4800,0,943,11/03/2021,"Chateau Margaux Premier Cru Classe, Margaux",Bordeaux,2003,11/05/2021,10127812003,1012781
3740,10/05/2021,4003,24,3520,220,483,07/04/2021,"Chateau Margaux Premier Cru Classe, Margaux",Bordeaux,2013,11/05/2021,10127812013,1012781
3850,10/05/2021,4162,37,3560,290,602,20/11/2020,"Chateau Margaux Premier Cru Classe, Margaux",Bordeaux,2012,11/05/2021,10127812012,1012781
780,10/05/2021,836,6,682,98,154,15/09/2020,"Chateau Calon Segur 3eme Cru Classe, Saint-Estephe",Bordeaux,2013,11/05/2021,10074752013,1007475
908,10/05/2021,1072,33,805,103,267,20/11/2019,"Chateau Calon Segur 3eme Cru Classe, Saint-Estephe",Bordeaux,2001,11/05/2021,10074752001,1007475
3026,09/07/2021,3208,12,2650,376,558,28/05/2021,"Chateau Angelus Premier Grand Cru Classe B, Saint-Emilion Grand Cru",Bordeaux,2006,14/07/2021,10060452006,1006045
3170,07/07/2021,3247,11,2650,520,597,28/05/2021,"Chateau Angelus Premier Grand Cru Classe B, Saint-Emilion Grand Cru",Bordeaux,2006,08/07/2021,10060452006,1006045
750,10/05/2021,1007,36,790,-40,217,01/06/2020,"Chateau Calon Segur 3eme Cru Classe, Saint-Estephe",Bordeaux,2011,11/05/2021,10074752011,1007475
3170,07/07/2021,3247,11,2650,520,597,28/05/2021,"Chateau Angelus Premier Grand Cru Classe B, Saint-Emilion Grand Cru",Bordeaux,2006,08/07/2021,10060452006,1006045
895,16/07/2021,921,39,863,32,58,10/05/2021,"Chateau Calon Segur 3eme Cru Classe, Saint-Estephe",Bordeaux,2006,17/07/2021,10074752006,1007475
3900,16/07/2021,4698,82,3822,78,876,20/06/2021,"Chateau Margaux Premier Cru Classe, Margaux",Bordeaux,2006,17/07/2021,10127812006,1012781
1000,10/05/2021,1057,9,860,140,197,08/03/2021,"Tignanello, Toscana",Tuscany,2011,11/05/2021,10953912011,1095391
2940,02/07/2021,3227,10,2650,290,577,28/05/2021,"Chateau Angelus Premier Grand Cru Classe B, Saint-Emilion Grand Cru",Bordeaux,2006,03/07/2021,10060452006,1006045
3720,10/05/2021,4078,51,3480,240,598,10/04/2021,"Chateau Margaux Premier Cru Classe, Margaux",Bordeaux,2014,11/05/2021,10127812014,1012781
3750,16/07/2021,4255,82,3525,225,730,18/06/2021,"Chateau Margaux Premier Cru Classe, Margaux",Bordeaux,2007,17/07/2021,10127812007,1012781
880,16/07/2021,980,7,725,155,255,13/04/2021,"Chateau Calon Segur 3eme Cru Classe, Saint-Estephe",Bordeaux,2007,17/07/2021,10074752007,1007475
2940,02/07/2021,3227,10,2650,290,577,28/05/2021,"Chateau Angelus Premier Grand Cru Classe B, Saint-Emilion Grand Cru",Bordeaux,2006,03/07/2021,10060452006,1006045
2940,28/06/2021,3100,3,2650,290,450,28/05/2021,"Chateau Angelus Premier Grand Cru Classe B, Saint-Emilion Grand Cru",Bordeaux,2006,29/06/2021,10060452006,1006045
3900,16/07/2021,4350,71,3870,30,480,10/07/2021,"Chateau Margaux Premier Cru Classe, Margaux",Bordeaux,2008,17/07/2021,10127812008,1012781
2940,28/06/2021,3100,3,2650,290,450,28/05/2021,"Chateau Angelus Premier Grand Cru Classe B, Saint-Emilion Grand Cru",Bordeaux,2006,29/06/2021,10060452006,1006045
1000,10/05/2021,1244,15,1047,-47,197,27/04/2021,"Chateau Calon Segur 3eme Cru Classe, Saint-Estephe",Bordeaux,2009,11/05/2021,10074752009,1007475
1028,31/05/2021,771,3,470,558,301,29/03/2018,"Chateau Batailley 5eme Cru Classe, Pauillac",Bordeaux,2000,17/06/2021,10063222000,1006322
895,16/07/2021,978,10,781,114,197,16/11/2020,"Chateau Calon Segur 3eme Cru Classe, Saint-Estephe",Bordeaux,2008,17/07/2021,10074752008,1007475
6880,16/07/2021,7747,48,7086,-206,661,11/06/2021,"Chateau Margaux Premier Cru Classe, Margaux",Bordeaux,2009,17/07/2021,10127812009,1012781
1000,16/07/2021,1231,51,1026,-26,205,24/06/2021,"Chateau Calon Segur 3eme Cru Classe, Saint-Estephe",Bordeaux,2009,17/07/2021,10074752009,1007475
1028,31/05/2021,795,3,470,558,325,29/03/2018,"Chateau Batailley 5eme Cru Classe, Pauillac",Bordeaux,2000,20/06/2021,10063222000,1006322
2940,28/06/2021,3207,8,2650,290,557,28/05/2021,"Chateau Angelus Premier Grand Cru Classe B, Saint-Emilion Grand Cru",Bordeaux,2006,30/06/2021,10060452006,1006045
3720,28/05/2021,4085,42,3480,240,605,10/04/2021,"Chateau Margaux Premier Cru Classe, Margaux",Bordeaux,2014,31/05/2021,10127812014,1012781
1700,10/05/2021,1674,3,1378,322,296,29/07/2020,"Tignanello, Toscana",Tuscany,2001,11/05/2021,10953912001,1095391
790,27/05/2021,918,30,858,-68,60,29/05/2021,"Chateau Calon Segur 3eme Cru Classe, Saint-Estephe",Bordeaux,2014,31/05/2021,10074752014,1007475
1024,25/05/2021,1199,10,1072,-48,127,20/01/2021,"Tignanello, Toscana",Tuscany,2009,31/05/2021,10953912009,1095391
10200,28/05/2021,12549,63,9844,356,2705,29/03/2021,"Chateau Margaux Premier Cru Classe, Margaux",Bordeaux,2015,31/05/2021,10127812015,1012781
3900,10/05/2021,4520,27,3684,216,836,10/06/2020,"Chateau Margaux Premier Cru Classe, Margaux",Bordeaux,2002,11/05/2021,10127812002,1012781
900,10/05/2021,1058,20,800,100,258,21/11/2019,"Chateau Calon Segur 3eme Cru Classe, Saint-Estephe",Bordeaux,2003,11/05/2021,10074752003,1007475
1290,10/05/2021,1227,12,1172,118,55,07/04/2021,"Tignanello, Toscana",Tuscany,2010,11/05/2021,10953912010,1095391
8040,10/05/2021,8232,20,7950,90,282,12/03/2021,"Chateau Margaux Premier Cru Classe, Margaux",Bordeaux,2000,11/05/2021,10127812000,1012781
2940,28/06/2021,3207,8,2650,290,557,28/05/2021,"Chateau Angelus Premier Grand Cru Classe B, Saint-Emilion Grand Cru",Bordeaux,2006,30/06/2021,10060452006,1006045
1050,28/05/2021,1147,7,860,190,287,08/03/2021,"Tignanello, Toscana",Tuscany,2013,31/05/2021,10953912013,1095391
6250,31/05/2021,7278,54,6360,-110,918,24/05/2021,"Chateau Margaux Premier Cru Classe, Margaux",Bordeaux,2005,01/06/2021,10127812005,1012781
10500,10/05/2021,12456,64,9844,656,2612,29/03/2021,"Chateau Margaux Premier Cru Classe, Margaux",Bordeaux,2015,11/05/2021,10127812015,1012781
2500,16/07/2021,2671,3,2220,280,451,14/06/2021,"Gaja, Barbaresco",Piedmont,2001,17/07/2021,10996052001,1099605
2386,16/07/2021,2397,3,2190,196,207,01/05/2021,"Gaja, Barbaresco",Piedmont,2004,17/07/2021,10996052004,1099605
1300,08/07/2021,1378,2,1200,100,178,06/03/2021,"Tignanello, Toscana",Tuscany,2007,17/07/2021,10953912007,1095391
6400,16/07/2021,7551,54,6188,212,1363,16/07/2021,"Chateau Margaux Premier Cru Classe, Margaux",Bordeaux,2010,17/07/2021,10127812010,1012781
468,31/05/2021,582,2,465,3,117,04/05/2020,"Chateau Batailley 5eme Cru Classe, Pauillac",Bordeaux,2001,01/06/2021,10063222001,1006322
990,16/07/2021,1137,16,990,0,147,16/06/2021,"Chateau Calon Segur 3eme Cru Classe, Saint-Estephe",Bordeaux,2010,17/07/2021,10074752010,1007475
3303,22/06/2021,3227,10,2650,653,577,28/05/2021,"Chateau Angelus Premier Grand Cru Classe B, Saint-Emilion Grand Cru",Bordeaux,2006,06/07/2021,10060452006,1006045
800,16/07/2021,991,36,790,10,201,01/06/2020,"Chateau Calon Segur 3eme Cru Classe, Saint-Estephe",Bordeaux,2011,17/07/2021,10074752011,1007475
1180,16/07/2021,1378,3,1072,108,306,20/01/2021,"Tignanello, Toscana",Tuscany,2009,17/07/2021,10953912009,1095391
1260,16/07/2021,1525,4,1170,90,355,24/06/2021,"Tignanello, Toscana",Tuscany,2010,17/07/2021,10953912010,1095391
3758,16/07/2021,4348,73,3690,68,658,13/04/2021,"Chateau Margaux Premier Cru Classe, Margaux",Bordeaux,2011,17/07/2021,10127812011,1012781
412,31/05/2021,437,2,220,192,217,17/06/2015,"Chateau Batailley 5eme Cru Classe, Pauillac",Bordeaux,2002,01/06/2021,10063222002,1006322
1050,16/07/2021,1134,8,880,170,254,22/06/2021,"Tignanello, Toscana",Tuscany,2011,17/07/2021,10953912011,1095391
3303,22/06/2021,3227,10,2650,653,577,28/05/2021,"Chateau Angelus Premier Grand Cru Classe B, Saint-Emilion Grand Cru",Bordeaux,2006,06/07/2021,10060452006,1006045
3920,10/05/2021,4498,76,3880,40,618,22/03/2021,"Chateau Margaux Premier Cru Classe, Margaux",Bordeaux,2008,11/05/2021,10127812008,1012781
850,10/05/2021,1110,90,860,-10,250,19/04/2021,"Chateau Calon Segur 3eme Cru Classe, Saint-Estephe",Bordeaux,2015,11/05/2021,10074752015,1007475
3303,22/06/2021,3136,2,2650,653,486,28/05/2021,"Chateau Angelus Premier Grand Cru Classe B, Saint-Emilion Grand Cru",Bordeaux,2006,23/06/2021,10060452006,1006045
589,31/05/2021,674,94,450,139,224,04/05/2021,"Chateau Batailley 5eme Cru Classe, Pauillac",Bordeaux,2005,01/06/2021,10063222005,1006322
820,16/07/2021,924,5,735,85,189,09/09/2020,"Chateau Calon Segur 3eme Cru Classe, Saint-Estephe",Bordeaux,2012,17/07/2021,10074752012,1007475
3750,15/07/2021,4278,41,3560,190,718,20/11/2020,"Chateau Margaux Premier Cru Classe, Margaux",Bordeaux,2012,17/07/2021,10127812012,1012781
3740,16/07/2021,4095,25,3520,220,575,07/04/2021,"Chateau Margaux Premier Cru Classe, Margaux",Bordeaux,2013,17/07/2021,10127812013,1012781
686,16/07/2021,810,6,682,4,128,15/09/2020,"Chateau Calon Segur 3eme Cru Classe, Saint-Estephe",Bordeaux,2013,17/07/2021,10074752013,1007475
870,13/07/2021,966,5,705,165,261,01/02/2021,"Chateau Calon Segur 3eme Cru Classe, Saint-Estephe",Bordeaux,2002,14/07/2021,10074752002,1007475
945,13/07/2021,1156,20,800,145,356,21/11/2019,"Chateau Calon Segur 3eme Cru Classe, Saint-Estephe",Bordeaux,2003,14/07/2021,10074752003,1007475
4450,13/07/2021,4805,24,4400,50,405,29/09/2020,"Chateau Margaux Premier Cru Classe, Margaux",Bordeaux,2001,14/07/2021,10127812001,1012781
3939,13/07/2021,4425,22,3684,255,741,10/06/2020,"Chateau Margaux Premier Cru Classe, Margaux",Bordeaux,2002,14/07/2021,10127812002,1012781
3826,13/07/2021,4575,49,4116,-290,459,25/02/2021,"Chateau Margaux Premier Cru Classe, Margaux",Bordeaux,2004,14/07/2021,10127812004,1012781
3303,22/06/2021,3180,2,2650,653,530,28/05/2021,"Chateau Angelus Premier Grand Cru Classe B, Saint-Emilion Grand Cru",Bordeaux,2006,26/06/2021,10060452006,1006045
840,13/07/2021,977,16,745,95,232,16/11/2020,"Chateau Calon Segur 3eme Cru Classe, Saint-Estephe",Bordeaux,2004,14/07/2021,10074752004,1007475
3303,22/06/2021,3136,2,2650,653,486,28/05/2021,"Chateau Angelus Premier Grand Cru Classe B, Saint-Emilion Grand Cru",Bordeaux,2006,23/06/2021,10060452006,1006045
3303,22/06/2021,3180,2,2650,653,530,28/05/2021,"Chateau Angelus Premier Grand Cru Classe B, Saint-Emilion Grand Cru",Bordeaux,2006,26/06/2021,10060452006,1006045
589,31/05/2021,674,94,450,139,224,04/05/2021,"Chateau Batailley 5eme Cru Classe, Pauillac",Bordeaux,2005,01/06/2021,10063222005,1006322
4400,10/05/2021,4903,27,4400,0,503,29/09/2020,"Chateau Margaux Premier Cru Classe, Margaux",Bordeaux,2001,11/05/2021,10127812001,1012781
2260,10/05/2021,2305,4,2190,70,115,01/05/2021,"Gaja, Barbaresco",Piedmont,2004,11/05/2021,10996052004,1099605
790,05/05/2021,916,39,794,-4,122,20/04/2021,"Chateau Calon Segur 3eme Cru Classe, Saint-Estephe",Bordeaux,2014,11/05/2021,10074752014,1007475
465,31/05/2021,526,5,400,65,126,11/05/2021,"Chateau Batailley 5eme Cru Classe, Pauillac",Bordeaux,2006,02/06/2021,10063222006,1006322
900,10/05/2021,1177,14,850,50,327,28/01/2021,"Tignanello, Toscana",Tuscany,2012,11/05/2021,10953912012,1095391
3303,22/06/2021,3207,8,2650,653,557,28/05/2021,"Chateau Angelus Premier Grand Cru Classe B, Saint-Emilion Grand Cru",Bordeaux,2006,01/07/2021,10060452006,1006045
465,31/05/2021,526,5,400,65,126,11/05/2021,"Chateau Batailley 5eme Cru Classe, Pauillac",Bordeaux,2006,02/06/2021,10063222006,1006322
3303,22/06/2021,3207,8,2650,653,557,28/05/2021,"Chateau Angelus Premier Grand Cru Classe B, Saint-Emilion Grand Cru",Bordeaux,2006,01/07/2021,10060452006,1006045
2800,18/05/2021,3280,10,2700,100,580,14/05/2021,"Chateau Angelus Premier Grand Cru Classe B, Saint-Emilion Grand Cru",Bordeaux,2006,19/05/2021,10060452006,1006045
2872,11/05/2021,2872,2,2554,318,318,22/05/2020,"Gaja, Barbaresco",Piedmont,2006,12/05/2021,10996052006,1099605
450,31/05/2021,450,1,340,110,110,31/08/2018,"Chateau Batailley 5eme Cru Classe, Pauillac",Bordeaux,2007,01/06/2021,10063222007,1006322
1040,04/05/2021,1192,62,950,90,242,03/05/2021,"Chateau Calon Segur 3eme Cru Classe, Saint-Estephe",Bordeaux,2018,12/05/2021,10074752018,1007475
2800,18/05/2021,3271,11,2700,100,571,14/05/2021,"Chateau Angelus Premier Grand Cru Classe B, Saint-Emilion Grand Cru",Bordeaux,2006,22/05/2021,10060452006,1006045
2800,18/05/2021,3299,5,2650,150,649,28/05/2021,"Chateau Angelus Premier Grand Cru Classe B, Saint-Emilion Grand Cru",Bordeaux,2006,01/06/2021,10060452006,1006045
895,13/07/2021,921,39,863,32,58,10/05/2021,"Chateau Calon Segur 3eme Cru Classe, Saint-Estephe",Bordeaux,2006,14/07/2021,10074752006,1007475
3900,13/07/2021,4698,82,3822,78,876,20/06/2021,"Chateau Margaux Premier Cru Classe, Margaux",Bordeaux,2006,14/07/2021,10127812006,1012781
3750,13/07/2021,4243,84,3525,225,718,18/06/2021,"Chateau Margaux Premier Cru Classe, Margaux",Bordeaux,2007,14/07/2021,10127812007,1012781
880,13/07/2021,980,7,725,155,255,13/04/2021,"Chateau Calon Segur 3eme Cru Classe, Saint-Estephe",Bordeaux,2007,14/07/2021,10074752007,1007475
2800,18/05/2021,3285,10,2650,150,635,28/05/2021,"Chateau Angelus Premier Grand Cru Classe B, Saint-Emilion Grand Cru",Bordeaux,2006,29/05/2021,10060452006,1006045
3950,13/07/2021,4350,67,3870,80,480,10/07/2021,"Chateau Margaux Premier Cru Classe, Margaux",Bordeaux,2008,14/07/2021,10127812008,1012781
895,13/07/2021,978,10,781,114,197,16/11/2020,"Chateau Calon Segur 3eme Cru Classe, Saint-Estephe",Bordeaux,2008,14/07/2021,10074752008,1007475
6880,12/07/2021,7754,48,7086,-206,668,11/06/2021,"Chateau Margaux Premier Cru Classe, Margaux",Bordeaux,2009,14/07/2021,10127812009,1012781
1408,17/06/2021,1376,4,1238,170,138,02/11/2020,"Tignanello, Toscana",Tuscany,2006,21/06/2021,10953912006,1095391
920,08/06/2021,1246,14,850,70,396,28/01/2021,"Tignanello, Toscana",Tuscany,2012,21/06/2021,10953912012,1095391
1310,17/06/2021,1398,5,1172,138,226,07/04/2021,"Tignanello, Toscana",Tuscany,2010,21/06/2021,10953912010,1095391
2800,18/05/2021,3010,1,2650,150,360,28/05/2021,"Chateau Angelus Premier Grand Cru Classe B, Saint-Emilion Grand Cru",Bordeaux,2006,22/06/2021,10060452006,1006045
1700,17/06/2021,1636,3,1378,322,258,29/07/2020,"Tignanello, Toscana",Tuscany,2001,21/06/2021,10953912001,1095391
3900,18/06/2021,4618,86,3822,78,796,20/06/2021,"Chateau Margaux Premier Cru Classe, Margaux",Bordeaux,2006,21/06/2021,10127812006,1012781
2800,18/05/2021,3299,10,2700,100,599,14/05/2021,"Chateau Angelus Premier Grand Cru Classe B, Saint-Emilion Grand Cru",Bordeaux,2006,25/05/2021,10060452006,1006045
3900,17/06/2021,4475,26,3684,216,791,10/06/2020,"Chateau Margaux Premier Cru Classe, Margaux",Bordeaux,2002,21/06/2021,10127812002,1012781
3560,17/06/2021,4007,29,3525,35,482,18/06/2021,"Chateau Margaux Premier Cru Classe, Margaux",Bordeaux,2007,21/06/2021,10127812007,1012781
450,31/05/2021,431,9,332,118,99,06/10/2020,"Chateau Batailley 5eme Cru Classe, Pauillac",Bordeaux,2008,02/06/2021,10063222008,1006322
3740,18/06/2021,3975,52,3520,220,455,07/04/2021,"Chateau Margaux Premier Cru Classe, Margaux",Bordeaux,2013,21/06/2021,10127812013,1012781
1408,06/07/2021,1608,3,1150,258,458,21/04/2019,"Tignanello, Toscana",Tuscany,2005,14/07/2021,10953912005,1095391
2500,13/07/2021,2632,3,2220,280,412,14/06/2021,"Gaja, Barbaresco",Piedmont,2001,14/07/2021,10996052001,1099605
2098,13/07/2021,2366,3,2190,-92,176,01/05/2021,"Gaja, Barbaresco",Piedmont,2004,14/07/2021,10996052004,1099605
1592,08/07/2021,1756,6,1378,214,378,29/07/2020,"Tignanello, Toscana",Tuscany,2001,14/07/2021,10953912001,1095391
1299,06/07/2021,1566,7,1010,289,556,18/12/2020,"Tignanello, Toscana",Tuscany,2008,14/07/2021,10953912008,1095391
1408,13/07/2021,1754,2,882,526,872,26/04/2019,"Tignanello, Toscana",Tuscany,2003,14/07/2021,10953912003,1095391
1248,08/07/2021,1308,4,1238,10,70,02/11/2020,"Tignanello, Toscana",Tuscany,2006,14/07/2021,10953912006,1095391
1733,13/07/2021,1707,4,1420,313,287,29/06/2021,"Tignanello, Toscana",Tuscany,2004,14/07/2021,10953912004,1095391
1408,06/07/2021,1427,1,996,412,431,14/06/2019,"Tignanello, Toscana",Tuscany,2000,14/07/2021,10953912000,1095391
6400,13/07/2021,7538,48,6190,210,1348,08/07/2021,"Chateau Margaux Premier Cru Classe, Margaux",Bordeaux,2010,14/07/2021,10127812010,1012781
490,31/05/2021,570,26,450,40,120,25/05/2021,"Chateau Batailley 5eme Cru Classe, Pauillac",Bordeaux,2009,01/06/2021,10063222009,1006322
990,13/07/2021,1137,16,990,0,147,16/06/2021,"Chateau Calon Segur 3eme Cru Classe, Saint-Estephe",Bordeaux,2010,14/07/2021,10074752010,1007475
3750,17/06/2021,4029,83,3690,60,339,13/04/2021,"Chateau Margaux Premier Cru Classe, Margaux",Bordeaux,2011,21/06/2021,10127812011,1012781
10500,18/06/2021,11907,53,9800,700,2107,11/06/2021,"Chateau Margaux Premier Cru Classe, Margaux",Bordeaux,2015,21/06/2021,10127812015,1012781
490,31/05/2021,570,26,450,40,120,25/05/2021,"Chateau Batailley 5eme Cru Classe, Pauillac",Bordeaux,2009,01/06/2021,10063222009,1006322
2800,18/05/2021,3291,5,2650,150,641,28/05/2021,"Chateau Angelus Premier Grand Cru Classe B, Saint-Emilion Grand Cru",Bordeaux,2006,02/06/2021,10060452006,1006045
907,18/06/2021,953,23,805,102,148,20/11/2019,"Chateau Calon Segur 3eme Cru Classe, Saint-Estephe",Bordeaux,2001,21/06/2021,10074752001,1007475
1000,18/06/2021,1144,76,988,12,156,28/05/2021,"Chateau Calon Segur 3eme Cru Classe, Saint-Estephe",Bordeaux,2005,21/06/2021,10074752005,1007475
8100,21/06/2021,8544,18,8100,0,444,21/06/2021,"Chateau Margaux Premier Cru Classe, Margaux",Bordeaux,2000,23/06/2021,10127812000,1012781
3900,18/06/2021,4221,71,3700,200,521,07/06/2021,"Chateau Margaux Premier Cru Classe, Margaux",Bordeaux,2008,21/06/2021,10127812008,1012781
2098,18/06/2021,2300,4,2190,-92,110,01/05/2021,"Gaja, Barbaresco",Piedmont,2004,21/06/2021,10996052004,1099605
3826,18/06/2021,4516,51,4116,-290,400,25/02/2021,"Chateau Margaux Premier Cru Classe, Margaux",Bordeaux,2004,21/06/2021,10127812004,1012781
4850,18/06/2021,5672,27,4842,8,830,19/05/2021,"Chateau Margaux Premier Cru Classe, Margaux",Bordeaux,2003,21/06/2021,10127812003,1012781
1024,17/06/2021,1222,5,1072,-48,150,20/01/2021,"Tignanello, Toscana",Tuscany,2009,21/06/2021,10953912009,1095391
686,18/06/2021,838,8,682,4,156,15/09/2020,"Chateau Calon Segur 3eme Cru Classe, Saint-Estephe",Bordeaux,2013,21/06/2021,10074752013,1007475
3900,22/06/2021,4269,76,3700,200,569,07/06/2021,"Chateau Margaux Premier Cru Classe, Margaux",Bordeaux,2008,23/06/2021,10127812008,1012781
1408,22/06/2021,1389,4,1238,170,151,02/11/2020,"Tignanello, Toscana",Tuscany,2006,23/06/2021,10953912006,1095391
3720,22/06/2021,4311,146,3480,240,831,17/06/2021,"Chateau Margaux Premier Cru Classe, Margaux",Bordeaux,2014,23/06/2021,10127812014,1012781
2800,18/05/2021,2985,3,2650,150,335,28/05/2021,"Chateau Angelus Premier Grand Cru Classe B, Saint-Emilion Grand Cru",Bordeaux,2006,18/06/2021,10060452006,1006045
2800,18/05/2021,3285,10,2700,100,585,14/05/2021,"Chateau Angelus Premier Grand Cru Classe B, Saint-Emilion Grand Cru",Bordeaux,2006,26/05/2021,10060452006,1006045
1299,22/06/2021,1459,7,1010,289,449,18/12/2020,"Tignanello, Toscana",Tuscany,2008,23/06/2021,10953912008,1095391
3720,18/06/2021,4290,138,3480,240,810,17/06/2021,"Chateau Margaux Premier Cru Classe, Margaux",Bordeaux,2014,21/06/2021,10127812014,1012781
2800,18/05/2021,3071,2,2650,150,421,28/05/2021,"Chateau Angelus Premier Grand Cru Classe B, Saint-Emilion Grand Cru",Bordeaux,2006,19/06/2021,10060452006,1006045
840,17/06/2021,1091,76,860,-20,231,19/04/2021,"Chateau Calon Segur 3eme Cru Classe, Saint-Estephe",Bordeaux,2015,21/06/2021,10074752015,1007475
788,13/07/2021,990,36,790,-2,200,01/06/2020,"Chateau Calon Segur 3eme Cru Classe, Saint-Estephe",Bordeaux,2011,14/07/2021,10074752011,1007475
2800,18/05/2021,3285,10,2650,150,635,28/05/2021,"Chateau Angelus Premier Grand Cru Classe B, Saint-Emilion Grand Cru",Bordeaux,2006,29/05/2021,10060452006,1006045
6830,21/06/2021,7698,51,7086,-256,612,11/06/2021,"Chateau Margaux Premier Cru Classe, Margaux",Bordeaux,2009,23/06/2021,10127812009,1012781
880,22/06/2021,967,9,725,155,242,13/04/2021,"Chateau Calon Segur 3eme Cru Classe, Saint-Estephe",Bordeaux,2007,23/06/2021,10074752007,1007475
950,22/06/2021,1019,52,863,87,156,10/05/2021,"Chateau Calon Segur 3eme Cru Classe, Saint-Estephe",Bordeaux,2006,23/06/2021,10074752006,1007475
960,21/06/2021,1246,14,850,110,396,28/01/2021,"Tignanello, Toscana",Tuscany,2012,23/06/2021,10953912012,1095391
3826,22/06/2021,4518,54,4116,-290,402,25/02/2021,"Chateau Margaux Premier Cru Classe, Margaux",Bordeaux,2004,23/06/2021,10127812004,1012781
1024,12/07/2021,1378,3,1072,-48,306,20/01/2021,"Tignanello, Toscana",Tuscany,2009,14/07/2021,10953912009,1095391
2800,18/05/2021,3299,5,2650,150,649,28/05/2021,"Chateau Angelus Premier Grand Cru Classe B, Saint-Emilion Grand Cru",Bordeaux,2006,01/06/2021,10060452006,1006045
2800,18/05/2021,3057,3,2650,150,407,28/05/2021,"Chateau Angelus Premier Grand Cru Classe B, Saint-Emilion Grand Cru",Bordeaux,2006,05/06/2021,10060452006,1006045
490,31/05/2021,594,407,494,-4,100,20/04/2021,"Chateau Batailley 5eme Cru Classe, Pauillac",Bordeaux,2010,01/06/2021,10063222010,1006322
1000,17/06/2021,1053,8,880,120,173,22/06/2021,"Tignanello, Toscana",Tuscany,2011,23/06/2021,10953912011,1095391
3740,22/06/2021,4030,62,3520,220,510,07/04/2021,"Chateau Margaux Premier Cru Classe, Margaux",Bordeaux,2013,23/06/2021,10127812013,1012781
6400,22/06/2021,7417,41,6776,-376,641,10/06/2021,"Chateau Margaux Premier Cru Classe, Margaux",Bordeaux,2005,23/06/2021,10127812005,1012781
6400,22/06/2021,7483,53,6190,210,1293,23/05/2021,"Chateau Margaux Premier Cru Classe, Margaux",Bordeaux,2010,23/06/2021,10127812010,1012781
2800,18/05/2021,3010,1,2650,150,360,28/05/2021,"Chateau Angelus Premier Grand Cru Classe B, Saint-Emilion Grand Cru",Bordeaux,2006,22/06/2021,10060452006,1006045
2800,18/05/2021,3280,10,2700,100,580,14/05/2021,"Chateau Angelus Premier Grand Cru Classe B, Saint-Emilion Grand Cru",Bordeaux,2006,19/05/2021,10060452006,1006045
990,22/06/2021,1108,16,990,0,118,16/06/2021,"Chateau Calon Segur 3eme Cru Classe, Saint-Estephe",Bordeaux,2010,23/06/2021,10074752010,1007475
1050,12/07/2021,1117,9,880,170,237,22/06/2021,"Tignanello, Toscana",Tuscany,2011,14/07/2021,10953912011,1095391
2098,22/06/2021,2300,4,2190,-92,110,01/05/2021,"Gaja, Barbaresco",Piedmont,2004,23/06/2021,10996052004,1099605
1570,22/06/2021,1344,3,1200,370,144,06/03/2021,"Tignanello, Toscana",Tuscany,2007,23/06/2021,10953912007,1095391
2800,18/05/2021,3271,11,2700,100,571,14/05/2021,"Chateau Angelus Premier Grand Cru Classe B, Saint-Emilion Grand Cru",Bordeaux,2006,22/05/2021,10060452006,1006045
686,22/06/2021,838,8,682,4,156,15/09/2020,"Chateau Calon Segur 3eme Cru Classe, Saint-Estephe",Bordeaux,2013,23/06/2021,10074752013,1007475
940,17/06/2021,1106,42,830,110,276,22/06/2021,"Tignanello, Toscana",Tuscany,2014,23/06/2021,10953912014,1095391
3750,14/06/2021,4211,40,3560,190,651,20/11/2020,"Chateau Margaux Premier Cru Classe, Margaux",Bordeaux,2012,23/06/2021,10127812012,1012781
2800,18/05/2021,3285,10,2700,100,585,14/05/2021,"Chateau Angelus Premier Grand Cru Classe B, Saint-Emilion Grand Cru",Bordeaux,2006,26/05/2021,10060452006,1006045
1408,22/06/2021,1436,1,1150,258,286,21/04/2019,"Tignanello, Toscana",Tuscany,2005,23/06/2021,10953912005,1095391
1100,12/05/2021,1536,7,1010,90,526,18/12/2020,"Tignanello, Toscana",Tuscany,2008,13/05/2021,10953912008,1095391
6250,12/05/2021,7040,47,6116,134,924,07/05/2021,"Chateau Margaux Premier Cru Classe, Margaux",Bordeaux,2005,13/05/2021,10127812005,1012781
2800,18/05/2021,3299,10,2700,100,599,14/05/2021,"Chateau Angelus Premier Grand Cru Classe B, Saint-Emilion Grand Cru",Bordeaux,2006,25/05/2021,10060452006,1006045
850,12/05/2021,1098,97,860,-10,238,19/04/2021,"Chateau Calon Segur 3eme Cru Classe, Saint-Estephe",Bordeaux,2015,13/05/2021,10074752015,1007475
1000,12/05/2021,1167,79,975,25,192,12/04/2021,"Chateau Calon Segur 3eme Cru Classe, Saint-Estephe",Bordeaux,2005,13/05/2021,10074752005,1007475
2800,18/05/2021,3291,5,2650,150,641,28/05/2021,"Chateau Angelus Premier Grand Cru Classe B, Saint-Emilion Grand Cru",Bordeaux,2006,02/06/2021,10060452006,1006045
2800,18/05/2021,3057,3,2650,150,407,28/05/2021,"Chateau Angelus Premier Grand Cru Classe B, Saint-Emilion Grand Cru",Bordeaux,2006,05/06/2021,10060452006,1006045
2800,18/05/2021,2985,3,2650,150,335,28/05/2021,"Chateau Angelus Premier Grand Cru Classe B, Saint-Emilion Grand Cru",Bordeaux,2006,18/06/2021,10060452006,1006045
3850,12/05/2021,4163,43,3560,290,603,20/11/2020,"Chateau Margaux Premier Cru Classe, Margaux",Bordeaux,2012,13/05/2021,10127812012,1012781
1130,28/07/2021,1168,14,1012,118,156,02/07/2021,"Tignanello, Toscana",Tuscany,2015,29/07/2021,10953912015,1095391
3900,22/06/2021,4629,95,3822,78,807,20/06/2021,"Chateau Margaux Premier Cru Classe, Margaux",Bordeaux,2006,23/06/2021,10127812006,1012781
490,31/05/2021,594,407,494,-4,100,20/04/2021,"Chateau Batailley 5eme Cru Classe, Pauillac",Bordeaux,2010,01/06/2021,10063222010,1006322
1000,22/06/2021,1245,49,1030,-30,215,25/05/2021,"Chateau Calon Segur 3eme Cru Classe, Saint-Estephe",Bordeaux,2009,23/06/2021,10074752009,1007475
780,12/05/2021,836,6,682,98,154,15/09/2020,"Chateau Calon Segur 3eme Cru Classe, Saint-Estephe",Bordeaux,2013,13/05/2021,10074752013,1007475
3860,10/05/2021,4789,78,3800,60,989,07/04/2021,"Chateau Margaux Premier Cru Classe, Margaux",Bordeaux,2006,13/05/2021,10127812006,1012781
6300,12/05/2021,7459,56,5922,378,1537,13/04/2021,"Chateau Margaux Premier Cru Classe, Margaux",Bordeaux,2010,13/05/2021,10127812010,1012781
2800,18/05/2021,3071,2,2650,150,421,28/05/2021,"Chateau Angelus Premier Grand Cru Classe B, Saint-Emilion Grand Cru",Bordeaux,2006,19/06/2021,10060452006,1006045
2690,10/08/2021,2830,5,2500,190,330,12/04/2021,"Chateau Angelus Premier Grand Cru Classe B, Saint-Emilion Grand Cru",Bordeaux,2007,11/08/2021,10060452007,1006045
300,31/05/2021,301,104,304,-4,-3,10/01/2021,"Chateau Batailley 5eme Cru Classe, Pauillac",Bordeaux,2013,01/06/2021,10063222013,1006322
2690,10/08/2021,2830,5,2500,190,330,12/04/2021,"Chateau Angelus Premier Grand Cru Classe B, Saint-Emilion Grand Cru",Bordeaux,2007,11/08/2021,10060452007,1006045
820,13/07/2021,937,6,735,85,202,09/09/2020,"Chateau Calon Segur 3eme Cru Classe, Saint-Estephe",Bordeaux,2012,14/07/2021,10074752012,1007475
2690,09/08/2021,2830,5,2500,190,330,12/04/2021,"Chateau Angelus Premier Grand Cru Classe B, Saint-Emilion Grand Cru",Bordeaux,2007,10/08/2021,10060452007,1006045
995,12/05/2021,1122,18,1000,-5,122,12/04/2021,"Chateau Calon Segur 3eme Cru Classe, Saint-Estephe",Bordeaux,2010,13/05/2021,10074752010,1007475
830,12/05/2021,928,17,781,49,147,16/11/2020,"Chateau Calon Segur 3eme Cru Classe, Saint-Estephe",Bordeaux,2008,13/05/2021,10074752008,1007475
3740,12/05/2021,3962,48,3520,220,442,07/04/2021,"Chateau Margaux Premier Cru Classe, Margaux",Bordeaux,2013,13/05/2021,10127812013,1012781
1010,12/05/2021,1057,9,860,150,197,08/03/2021,"Tignanello, Toscana",Tuscany,2011,13/05/2021,10953912011,1095391
3800,12/05/2021,4374,128,3690,110,684,13/04/2021,"Chateau Margaux Premier Cru Classe, Margaux",Bordeaux,2011,13/05/2021,10127812011,1012781
476,31/05/2021,529,45,364,112,165,12/05/2021,"Chateau Batailley 5eme Cru Classe, Pauillac",Bordeaux,2016,01/06/2021,10063222016,1006322
2690,09/08/2021,2830,5,2500,190,330,12/04/2021,"Chateau Angelus Premier Grand Cru Classe B, Saint-Emilion Grand Cru",Bordeaux,2007,10/08/2021,10060452007,1006045
2690,06/08/2021,2830,5,2500,190,330,12/04/2021,"Chateau Angelus Premier Grand Cru Classe B, Saint-Emilion Grand Cru",Bordeaux,2007,07/08/2021,10060452007,1006045
1280,12/05/2021,1227,12,1172,108,55,07/04/2021,"Tignanello, Toscana",Tuscany,2010,13/05/2021,10953912010,1095391
6830,11/06/2021,7684,49,7086,-256,598,11/06/2021,"Chateau Margaux Premier Cru Classe, Margaux",Bordeaux,2009,12/06/2021,10127812009,1012781
2690,06/08/2021,2830,5,2500,190,330,12/04/2021,"Chateau Angelus Premier Grand Cru Classe B, Saint-Emilion Grand Cru",Bordeaux,2007,07/08/2021,10060452007,1006045
408,31/05/2021,418,19,357,51,61,06/05/2021,"Chateau Batailley 5eme Cru Classe, Pauillac",Bordeaux,2018,01/06/2021,10063222018,1006322
8040,12/05/2021,8232,20,7950,90,282,12/03/2021,"Chateau Margaux Premier Cru Classe, Margaux",Bordeaux,2000,13/05/2021,10127812000,1012781
3827,12/05/2021,4512,71,4116,-289,396,25/02/2021,"Chateau Margaux Premier Cru Classe, Margaux",Bordeaux,2004,13/05/2021,10127812004,1012781
1000,10/06/2021,1053,8,860,140,193,08/03/2021,"Tignanello, Toscana",Tuscany,2011,11/06/2021,10953912011,1095391
3758,11/06/2021,4050,97,3690,68,360,13/04/2021,"Chateau Margaux Premier Cru Classe, Margaux",Bordeaux,2011,12/06/2021,10127812011,1012781
10100,11/06/2021,11971,53,9800,300,2171,11/06/2021,"Chateau Margaux Premier Cru Classe, Margaux",Bordeaux,2015,12/06/2021,10127812015,1012781
950,11/06/2021,1020,53,863,87,157,10/05/2021,"Chateau Calon Segur 3eme Cru Classe, Saint-Estephe",Bordeaux,2006,12/06/2021,10074752006,1007475
2500,22/06/2021,2636,2,2220,280,416,14/06/2021,"Gaja, Barbaresco",Piedmont,2001,23/06/2021,10996052001,1099605
1299,08/06/2021,1493,7,1010,289,483,18/12/2020,"Tignanello, Toscana",Tuscany,2008,11/06/2021,10953912008,1095391
4400,12/05/2021,4922,27,4400,0,522,29/09/2020,"Chateau Margaux Premier Cru Classe, Margaux",Bordeaux,2001,13/05/2021,10127812001,1012781
3920,12/05/2021,4457,90,3800,120,657,12/05/2021,"Chateau Margaux Premier Cru Classe, Margaux",Bordeaux,2008,13/05/2021,10127812008,1012781
3800,12/05/2021,4078,54,3480,320,598,10/04/2021,"Chateau Margaux Premier Cru Classe, Margaux",Bordeaux,2014,13/05/2021,10127812014,1012781
4800,12/05/2021,5717,28,4800,0,917,11/03/2021,"Chateau Margaux Premier Cru Classe, Margaux",Bordeaux,2003,13/05/2021,10127812003,1012781
6750,12/05/2021,7938,81,6500,250,1438,12/05/2021,"Chateau Margaux Premier Cru Classe, Margaux",Bordeaux,2009,13/05/2021,10127812009,1012781
1300,05/05/2021,1324,3,1200,100,124,06/03/2021,"Tignanello, Toscana",Tuscany,2007,13/05/2021,10953912007,1095391
2690,05/08/2021,2830,5,2500,190,330,12/04/2021,"Chateau Angelus Premier Grand Cru Classe B, Saint-Emilion Grand Cru",Bordeaux,2007,06/08/2021,10060452007,1006045
10500,12/05/2021,12395,75,9844,656,2551,29/03/2021,"Chateau Margaux Premier Cru Classe, Margaux",Bordeaux,2015,13/05/2021,10127812015,1012781
900,12/05/2021,1177,14,850,50,327,28/01/2021,"Tignanello, Toscana",Tuscany,2012,13/05/2021,10953912012,1095391
1700,12/05/2021,1674,3,1378,322,296,29/07/2020,"Tignanello, Toscana",Tuscany,2001,13/05/2021,10953912001,1095391
6250,04/06/2021,7437,49,6776,-526,661,10/06/2021,"Chateau Margaux Premier Cru Classe, Margaux",Bordeaux,2005,11/06/2021,10127812005,1012781
2690,05/08/2021,2830,5,2500,190,330,12/04/2021,"Chateau Angelus Premier Grand Cru Classe B, Saint-Emilion Grand Cru",Bordeaux,2007,06/08/2021,10060452007,1006045
2690,04/08/2021,2830,5,2500,190,330,12/04/2021,"Chateau Angelus Premier Grand Cru Classe B, Saint-Emilion Grand Cru",Bordeaux,2007,05/08/2021,10060452007,1006045
2500,10/06/2021,3334,3,1200,1300,2134,16/05/2012,"Gaja, Barbaresco",Piedmont,2001,11/06/2021,10996052001,1099605
1000,12/05/2021,1229,16,1047,-47,182,27/04/2021,"Chateau Calon Segur 3eme Cru Classe, Saint-Estephe",Bordeaux,2009,13/05/2021,10074752009,1007475
2690,04/08/2021,2830,5,2500,190,330,12/04/2021,"Chateau Angelus Premier Grand Cru Classe B, Saint-Emilion Grand Cru",Bordeaux,2007,05/08/2021,10060452007,1006045
8100,11/06/2021,8471,19,7950,150,521,12/03/2021,"Chateau Margaux Premier Cru Classe, Margaux",Bordeaux,2000,12/06/2021,10127812000,1012781
1310,11/06/2021,1375,6,1172,138,203,07/04/2021,"Tignanello, Toscana",Tuscany,2010,12/06/2021,10953912010,1095391
2690,03/08/2021,2830,5,2500,190,330,12/04/2021,"Chateau Angelus Premier Grand Cru Classe B, Saint-Emilion Grand Cru",Bordeaux,2007,03/08/2021,10060452007,1006045
870,29/06/2021,954,4,705,165,249,01/02/2021,"Chateau Calon Segur 3eme Cru Classe, Saint-Estephe",Bordeaux,2002,30/06/2021,10074752002,1007475
8100,28/06/2021,8354,14,8100,0,254,21/06/2021,"Chateau Margaux Premier Cru Classe, Margaux",Bordeaux,2000,30/06/2021,10127812000,1012781
900,11/06/2021,1212,15,850,50,362,28/01/2021,"Tignanello, Toscana",Tuscany,2012,12/06/2021,10953912012,1095391
468,01/06/2021,582,2,465,3,117,04/05/2020,"Chateau Batailley 5eme Cru Classe, Pauillac",Bordeaux,2001,02/06/2021,10063222001,1006322
2690,03/08/2021,2830,5,2500,190,330,12/04/2021,"Chateau Angelus Premier Grand Cru Classe B, Saint-Emilion Grand Cru",Bordeaux,2007,04/08/2021,10060452007,1006045
2690,02/08/2021,2830,5,2500,190,330,12/04/2021,"Chateau Angelus Premier Grand Cru Classe B, Saint-Emilion Grand Cru",Bordeaux,2007,03/08/2021,10060452007,1006045
3900,10/06/2021,4610,94,3861,39,749,28/05/2021,"Chateau Margaux Premier Cru Classe, Margaux",Bordeaux,2006,11/06/2021,10127812006,1012781
2690,02/08/2021,2830,5,2500,190,330,12/04/2021,"Chateau Angelus Premier Grand Cru Classe B, Saint-Emilion Grand Cru",Bordeaux,2007,03/08/2021,10060452007,1006045
6250,04/06/2021,7443,47,6776,-526,667,10/06/2021,"Chateau Margaux Premier Cru Classe, Margaux",Bordeaux,2005,12/06/2021,10127812005,1012781
1300,11/06/2021,1333,5,1200,100,133,06/03/2021,"Tignanello, Toscana",Tuscany,2007,12/06/2021,10953912007,1095391
750,11/06/2021,1002,51,790,-40,212,01/06/2020,"Chateau Calon Segur 3eme Cru Classe, Saint-Estephe",Bordeaux,2011,12/06/2021,10074752011,1007475
880,03/06/2021,945,14,781,99,164,16/11/2020,"Chateau Calon Segur 3eme Cru Classe, Saint-Estephe",Bordeaux,2008,11/06/2021,10074752008,1007475
1050,11/06/2021,1212,23,940,110,272,18/03/2021,"Chateau Calon Segur 3eme Cru Classe, Saint-Estephe",Bordeaux,2000,12/06/2021,10074752000,1007475
1678,22/06/2021,1683,4,1180,498,503,25/06/2020,"Tignanello, Toscana",Tuscany,2004,23/06/2021,10953912004,1095391
2690,30/07/2021,2830,5,2500,190,330,12/04/2021,"Chateau Angelus Premier Grand Cru Classe B, Saint-Emilion Grand Cru",Bordeaux,2007,31/07/2021,10060452007,1006045
2690,30/07/2021,2830,5,2500,190,330,12/04/2021,"Chateau Angelus Premier Grand Cru Classe B, Saint-Emilion Grand Cru",Bordeaux,2007,31/07/2021,10060452007,1006045
3720,10/06/2021,4292,146,3480,240,812,10/04/2021,"Chateau Margaux Premier Cru Classe, Margaux",Bordeaux,2014,11/06/2021,10127812014,1012781
3750,04/06/2021,4192,40,3560,190,632,20/11/2020,"Chateau Margaux Premier Cru Classe, Margaux",Bordeaux,2012,11/06/2021,10127812012,1012781
3740,13/07/2021,4093,25,3520,220,573,07/04/2021,"Chateau Margaux Premier Cru Classe, Margaux",Bordeaux,2013,14/07/2021,10127812013,1012781
2690,29/07/2021,2830,5,2500,190,330,12/04/2021,"Chateau Angelus Premier Grand Cru Classe B, Saint-Emilion Grand Cru",Bordeaux,2007,30/07/2021,10060452007,1006045
686,13/07/2021,809,7,682,4,127,15/09/2020,"Chateau Calon Segur 3eme Cru Classe, Saint-Estephe",Bordeaux,2013,14/07/2021,10074752013,1007475
3740,10/06/2021,3977,53,3520,220,457,07/04/2021,"Chateau Margaux Premier Cru Classe, Margaux",Bordeaux,2013,11/06/2021,10127812013,1012781
880,10/06/2021,986,13,725,155,261,13/04/2021,"Chateau Calon Segur 3eme Cru Classe, Saint-Estephe",Bordeaux,2007,11/06/2021,10074752007,1007475
6830,09/06/2021,7684,49,6525,305,1159,23/05/2021,"Chateau Margaux Premier Cru Classe, Margaux",Bordeaux,2009,11/06/2021,10127812009,1012781
870,10/06/2021,948,10,705,165,243,01/02/2021,"Chateau Calon Segur 3eme Cru Classe, Saint-Estephe",Bordeaux,2002,11/06/2021,10074752002,1007475
950,10/06/2021,1020,53,863,87,157,10/05/2021,"Chateau Calon Segur 3eme Cru Classe, Saint-Estephe",Bordeaux,2006,11/06/2021,10074752006,1007475
9600,11/06/2021,9798,2,8000,1600,1798,30/01/2020,"Domaine Leflaive, Chevalier-Montrachet Grand Cru",Burgundy,2014,12/06/2021,10734012014,1073401
870,11/06/2021,948,10,705,165,243,01/02/2021,"Chateau Calon Segur 3eme Cru Classe, Saint-Estephe",Bordeaux,2002,12/06/2021,10074752002,1007475
10328,21/06/2021,11941,52,9800,528,2141,11/06/2021,"Chateau Margaux Premier Cru Classe, Margaux",Bordeaux,2015,23/06/2021,10127812015,1012781
4850,18/06/2021,5655,28,4650,200,1005,21/06/2021,"Chateau Margaux Premier Cru Classe, Margaux",Bordeaux,2003,23/06/2021,10127812003,1012781
1000,22/06/2021,1155,93,988,12,167,28/05/2021,"Chateau Calon Segur 3eme Cru Classe, Saint-Estephe",Bordeaux,2005,23/06/2021,10074752005,1007475
2690,29/07/2021,2830,5,2500,190,330,12/04/2021,"Chateau Angelus Premier Grand Cru Classe B, Saint-Emilion Grand Cru",Bordeaux,2007,30/07/2021,10060452007,1006045
2690,28/07/2021,2830,5,2500,190,330,12/04/2021,"Chateau Angelus Premier Grand Cru Classe B, Saint-Emilion Grand Cru",Bordeaux,2007,29/07/2021,10060452007,1006045
1000,10/06/2021,1145,83,988,12,157,28/05/2021,"Chateau Calon Segur 3eme Cru Classe, Saint-Estephe",Bordeaux,2005,11/06/2021,10074752005,1007475
790,03/06/2021,1088,78,860,-70,228,19/04/2021,"Chateau Calon Segur 3eme Cru Classe, Saint-Estephe",Bordeaux,2015,11/06/2021,10074752015,1007475
2690,28/07/2021,2830,5,2500,190,330,12/04/2021,"Chateau Angelus Premier Grand Cru Classe B, Saint-Emilion Grand Cru",Bordeaux,2007,29/07/2021,10060452007,1006045
900,04/06/2021,1221,14,850,50,371,28/01/2021,"Tignanello, Toscana",Tuscany,2012,11/06/2021,10953912012,1095391
6300,10/06/2021,7477,63,6190,110,1287,23/05/2021,"Chateau Margaux Premier Cru Classe, Margaux",Bordeaux,2010,11/06/2021,10127812010,1012781
2690,27/07/2021,2830,5,2500,190,330,12/04/2021,"Chateau Angelus Premier Grand Cru Classe B, Saint-Emilion Grand Cru",Bordeaux,2007,28/07/2021,10060452007,1006045
3560,21/06/2021,4163,44,3525,35,638,18/06/2021,"Chateau Margaux Premier Cru Classe, Margaux",Bordeaux,2007,23/06/2021,10127812007,1012781
2690,27/07/2021,2830,5,2500,190,330,12/04/2021,"Chateau Angelus Premier Grand Cru Classe B, Saint-Emilion Grand Cru",Bordeaux,2007,28/07/2021,10060452007,1006045
1000,10/06/2021,1057,8,860,140,197,08/03/2021,"Tignanello, Toscana",Tuscany,2011,12/06/2021,10953912011,1095391
2232,10/06/2021,2369,5,2190,42,179,01/05/2021,"Gaja, Barbaresco",Piedmont,2004,11/06/2021,10996052004,1099605
1700,11/06/2021,1658,4,1378,322,280,29/07/2020,"Tignanello, Toscana",Tuscany,2001,12/06/2021,10953912001,1095391
3900,11/06/2021,4610,94,3861,39,749,28/05/2021,"Chateau Margaux Premier Cru Classe, Margaux",Bordeaux,2006,12/06/2021,10127812006,1012781
2690,26/07/2021,2830,5,2500,190,330,12/04/2021,"Chateau Angelus Premier Grand Cru Classe B, Saint-Emilion Grand Cru",Bordeaux,2007,27/07/2021,10060452007,1006045
3900,10/06/2021,4422,110,3700,200,722,07/06/2021,"Chateau Margaux Premier Cru Classe, Margaux",Bordeaux,2008,11/06/2021,10127812008,1012781
907,10/06/2021,957,24,805,102,152,20/11/2019,"Chateau Calon Segur 3eme Cru Classe, Saint-Estephe",Bordeaux,2001,11/06/2021,10074752001,1007475
790,04/06/2021,902,24,801,-11,101,31/05/2021,"Chateau Calon Segur 3eme Cru Classe, Saint-Estephe",Bordeaux,2014,11/06/2021,10074752014,1007475
2690,26/07/2021,2830,5,2500,190,330,12/04/2021,"Chateau Angelus Premier Grand Cru Classe B, Saint-Emilion Grand Cru",Bordeaux,2007,27/07/2021,10060452007,1006045
686,10/06/2021,828,13,682,4,146,15/09/2020,"Chateau Calon Segur 3eme Cru Classe, Saint-Estephe",Bordeaux,2013,11/06/2021,10074752013,1007475
2690,23/07/2021,2830,5,2500,190,330,12/04/2021,"Chateau Angelus Premier Grand Cru Classe B, Saint-Emilion Grand Cru",Bordeaux,2007,24/07/2021,10060452007,1006045
790,11/06/2021,902,24,801,-11,101,31/05/2021,"Chateau Calon Segur 3eme Cru Classe, Saint-Estephe",Bordeaux,2014,12/06/2021,10074752014,1007475
2690,23/07/2021,2830,5,2500,190,330,12/04/2021,"Chateau Angelus Premier Grand Cru Classe B, Saint-Emilion Grand Cru",Bordeaux,2007,24/07/2021,10060452007,1006045
4850,04/06/2021,5601,32,4842,8,759,19/05/2021,"Chateau Margaux Premier Cru Classe, Margaux",Bordeaux,2003,11/06/2021,10127812003,1012781
3826,10/06/2021,4531,54,4116,-290,415,25/02/2021,"Chateau Margaux Premier Cru Classe, Margaux",Bordeaux,2004,11/06/2021,10127812004,1012781
990,10/06/2021,1110,21,1000,-10,110,12/04/2021,"Chateau Calon Segur 3eme Cru Classe, Saint-Estephe",Bordeaux,2010,11/06/2021,10074752010,1007475
412,01/06/2021,430,3,220,192,210,17/06/2015,"Chateau Batailley 5eme Cru Classe, Pauillac",Bordeaux,2002,04/06/2021,10063222002,1006322
1310,09/06/2021,1375,6,1172,138,203,07/04/2021,"Tignanello, Toscana",Tuscany,2010,11/06/2021,10953912010,1095391
2690,22/07/2021,2830,5,2500,190,330,12/04/2021,"Chateau Angelus Premier Grand Cru Classe B, Saint-Emilion Grand Cru",Bordeaux,2007,23/07/2021,10060452007,1006045
1245,22/06/2021,1615,2,882,363,733,26/04/2019,"Tignanello, Toscana",Tuscany,2003,23/06/2021,10953912003,1095391
3560,09/06/2021,4076,32,3592,-32,484,06/05/2021,"Chateau Margaux Premier Cru Classe, Margaux",Bordeaux,2007,11/06/2021,10127812007,1012781
10500,10/06/2021,11988,53,9844,656,2144,29/03/2021,"Chateau Margaux Premier Cru Classe, Margaux",Bordeaux,2015,11/06/2021,10127812015,1012781
3758,10/06/2021,4050,97,3690,68,360,13/04/2021,"Chateau Margaux Premier Cru Classe, Margaux",Bordeaux,2011,11/06/2021,10127812011,1012781
2690,22/07/2021,2830,5,2500,190,330,12/04/2021,"Chateau Angelus Premier Grand Cru Classe B, Saint-Emilion Grand Cru",Bordeaux,2007,23/07/2021,10060452007,1006045
2500,11/06/2021,3334,3,1200,1300,2134,16/05/2012,"Gaja, Barbaresco",Piedmont,2001,12/06/2021,10996052001,1099605
412,01/06/2021,437,2,220,192,217,17/06/2015,"Chateau Batailley 5eme Cru Classe, Pauillac",Bordeaux,2002,02/06/2021,10063222002,1006322
960,12/07/2021,1346,11,850,110,496,28/01/2021,"Tignanello, Toscana",Tuscany,2012,14/07/2021,10953912012,1095391
3800,13/07/2021,4342,123,3480,320,862,17/06/2021,"Chateau Margaux Premier Cru Classe, Margaux",Bordeaux,2014,14/07/2021,10127812014,1012781
790,09/07/2021,881,19,801,-11,80,31/05/2021,"Chateau Calon Segur 3eme Cru Classe, Saint-Estephe",Bordeaux,2014,14/07/2021,10074752014,1007475
790,03/06/2021,946,26,745,45,201,16/11/2020,"Chateau Calon Segur 3eme Cru Classe, Saint-Estephe",Bordeaux,2004,12/06/2021,10074752004,1007475
3900,11/06/2021,4422,110,3700,200,722,07/06/2021,"Chateau Margaux Premier Cru Classe, Margaux",Bordeaux,2008,12/06/2021,10127812008,1012781
880,11/06/2021,986,13,725,155,261,13/04/2021,"Chateau Calon Segur 3eme Cru Classe, Saint-Estephe",Bordeaux,2007,12/06/2021,10074752007,1007475
2690,21/07/2021,2830,5,2500,190,330,12/04/2021,"Chateau Angelus Premier Grand Cru Classe B, Saint-Emilion Grand Cru",Bordeaux,2007,22/07/2021,10060452007,1006045
3900,21/06/2021,4494,25,3684,216,810,10/06/2020,"Chateau Margaux Premier Cru Classe, Margaux",Bordeaux,2002,23/06/2021,10127812002,1012781
3740,11/06/2021,3977,53,3520,220,457,07/04/2021,"Chateau Margaux Premier Cru Classe, Margaux",Bordeaux,2013,12/06/2021,10127812013,1012781
990,11/06/2021,1110,21,1000,-10,110,12/04/2021,"Chateau Calon Segur 3eme Cru Classe, Saint-Estephe",Bordeaux,2010,12/06/2021,10074752010,1007475
3900,09/06/2021,4472,28,3684,216,788,10/06/2020,"Chateau Margaux Premier Cru Classe, Margaux",Bordeaux,2002,10/06/2021,10127812002,1012781
8100,09/06/2021,8471,19,7950,150,521,12/03/2021,"Chateau Margaux Premier Cru Classe, Margaux",Bordeaux,2000,10/06/2021,10127812000,1012781
1090,13/07/2021,1157,6,860,230,297,08/03/2021,"Tignanello, Toscana",Tuscany,2013,14/07/2021,10953912013,1095391
984,13/07/2021,1106,45,830,154,276,22/06/2021,"Tignanello, Toscana",Tuscany,2014,14/07/2021,10953912014,1095391
6300,09/06/2021,7458,64,6190,110,1268,23/05/2021,"Chateau Margaux Premier Cru Classe, Margaux",Bordeaux,2010,10/06/2021,10127812010,1012781
589,01/06/2021,674,94,450,139,224,04/05/2021,"Chateau Batailley 5eme Cru Classe, Pauillac",Bordeaux,2005,02/06/2021,10063222005,1006322
1700,09/06/2021,1658,4,1378,322,280,29/07/2020,"Tignanello, Toscana",Tuscany,2001,10/06/2021,10953912001,1095391
900,09/06/2021,1090,29,800,100,290,21/11/2019,"Chateau Calon Segur 3eme Cru Classe, Saint-Estephe",Bordeaux,2003,10/06/2021,10074752003,1007475
6250,04/06/2021,7437,49,6360,-110,1077,24/05/2021,"Chateau Margaux Premier Cru Classe, Margaux",Bordeaux,2005,10/06/2021,10127812005,1012781
1000,11/06/2021,1169,44,1030,-30,139,25/05/2021,"Chateau Calon Segur 3eme Cru Classe, Saint-Estephe",Bordeaux,2009,12/06/2021,10074752009,1007475
2690,21/07/2021,2830,5,2500,190,330,12/04/2021,"Chateau Angelus Premier Grand Cru Classe B, Saint-Emilion Grand Cru",Bordeaux,2007,22/07/2021,10060452007,1006045
1299,08/06/2021,1489,7,1010,289,479,18/12/2020,"Tignanello, Toscana",Tuscany,2008,10/06/2021,10953912008,1095391
686,09/06/2021,828,13,682,4,146,15/09/2020,"Chateau Calon Segur 3eme Cru Classe, Saint-Estephe",Bordeaux,2013,10/06/2021,10074752013,1007475
589,01/06/2021,674,94,450,139,224,04/05/2021,"Chateau Batailley 5eme Cru Classe, Pauillac",Bordeaux,2005,02/06/2021,10063222005,1006322
940,13/07/2021,1091,77,822,118,269,28/06/2021,"Chateau Calon Segur 3eme Cru Classe, Saint-Estephe",Bordeaux,2015,14/07/2021,10074752015,1007475
10400,13/07/2021,11802,52,9800,600,2002,11/06/2021,"Chateau Margaux Premier Cru Classe, Margaux",Bordeaux,2015,14/07/2021,10127812015,1012781
450,01/06/2021,450,1,340,110,110,31/08/2018,"Chateau Batailley 5eme Cru Classe, Pauillac",Bordeaux,2007,02/06/2021,10063222007,1006322
2690,20/07/2021,2830,5,2500,190,330,12/04/2021,"Chateau Angelus Premier Grand Cru Classe B, Saint-Emilion Grand Cru",Bordeaux,2007,21/07/2021,10060452007,1006045
3900,09/06/2021,4613,95,3861,39,752,28/05/2021,"Chateau Margaux Premier Cru Classe, Margaux",Bordeaux,2006,10/06/2021,10127812006,1012781
1024,09/06/2021,1203,9,1072,-48,131,20/01/2021,"Tignanello, Toscana",Tuscany,2009,10/06/2021,10953912009,1095391
2690,20/07/2021,2830,5,2500,190,330,12/04/2021,"Chateau Angelus Premier Grand Cru Classe B, Saint-Emilion Grand Cru",Bordeaux,2007,21/07/2021,10060452007,1006045
1408,09/06/2021,1386,5,1238,170,148,02/11/2020,"Tignanello, Toscana",Tuscany,2006,10/06/2021,10953912006,1095391
3826,09/06/2021,4526,58,4116,-290,410,25/02/2021,"Chateau Margaux Premier Cru Classe, Margaux",Bordeaux,2004,10/06/2021,10127812004,1012781
4386,02/06/2021,4703,28,4400,-14,303,29/09/2020,"Chateau Margaux Premier Cru Classe, Margaux",Bordeaux,2001,10/06/2021,10127812001,1012781
6830,09/06/2021,7662,50,6525,305,1137,23/05/2021,"Chateau Margaux Premier Cru Classe, Margaux",Bordeaux,2009,10/06/2021,10127812009,1012781
2690,19/07/2021,2731,17,2500,190,231,12/04/2021,"Chateau Angelus Premier Grand Cru Classe B, Saint-Emilion Grand Cru",Bordeaux,2007,20/07/2021,10060452007,1006045
880,11/06/2021,986,13,725,155,261,13/04/2021,"Chateau Calon Segur 3eme Cru Classe, Saint-Estephe",Bordeaux,2007,12/06/2021,10074752007,1007475
686,11/06/2021,828,13,682,4,146,15/09/2020,"Chateau Calon Segur 3eme Cru Classe, Saint-Estephe",Bordeaux,2013,12/06/2021,10074752013,1007475
3826,11/06/2021,4525,55,4116,-290,409,25/02/2021,"Chateau Margaux Premier Cru Classe, Margaux",Bordeaux,2004,12/06/2021,10127812004,1012781
1000,09/06/2021,1169,44,1030,-30,139,25/05/2021,"Chateau Calon Segur 3eme Cru Classe, Saint-Estephe",Bordeaux,2009,10/06/2021,10074752009,1007475
1000,11/06/2021,1145,83,988,12,157,28/05/2021,"Chateau Calon Segur 3eme Cru Classe, Saint-Estephe",Bordeaux,2005,12/06/2021,10074752005,1007475
2690,19/07/2021,2731,17,2500,190,231,12/04/2021,"Chateau Angelus Premier Grand Cru Classe B, Saint-Emilion Grand Cru",Bordeaux,2007,20/07/2021,10060452007,1006045
6300,11/06/2021,7477,63,6190,110,1287,23/05/2021,"Chateau Margaux Premier Cru Classe, Margaux",Bordeaux,2010,12/06/2021,10127812010,1012781
990,09/06/2021,1110,21,1000,-10,110,12/04/2021,"Chateau Calon Segur 3eme Cru Classe, Saint-Estephe",Bordeaux,2010,10/06/2021,10074752010,1007475
1028,08/06/2021,1057,8,860,168,197,08/03/2021,"Tignanello, Toscana",Tuscany,2011,10/06/2021,10953912011,1095391
1300,27/05/2021,1368,7,1172,128,196,07/04/2021,"Tignanello, Toscana",Tuscany,2010,10/06/2021,10953912010,1095391
490,01/06/2021,570,26,450,40,120,25/05/2021,"Chateau Batailley 5eme Cru Classe, Pauillac",Bordeaux,2009,02/06/2021,10063222009,1006322
2690,16/07/2021,2830,5,2500,190,330,12/04/2021,"Chateau Angelus Premier Grand Cru Classe B, Saint-Emilion Grand Cru",Bordeaux,2007,17/07/2021,10060452007,1006045
3900,09/06/2021,4431,108,3700,200,731,07/06/2021,"Chateau Margaux Premier Cru Classe, Margaux",Bordeaux,2008,10/06/2021,10127812008,1012781
2690,16/07/2021,2830,5,2500,190,330,12/04/2021,"Chateau Angelus Premier Grand Cru Classe B, Saint-Emilion Grand Cru",Bordeaux,2007,17/07/2021,10060452007,1006045
3850,14/05/2021,4165,41,3560,290,605,20/11/2020,"Chateau Margaux Premier Cru Classe, Margaux",Bordeaux,2012,16/05/2021,10127812012,1012781
6250,14/05/2021,6929,39,6116,134,813,07/05/2021,"Chateau Margaux Premier Cru Classe, Margaux",Bordeaux,2005,16/05/2021,10127812005,1012781
3860,10/05/2021,4811,74,3800,60,1011,07/04/2021,"Chateau Margaux Premier Cru Classe, Margaux",Bordeaux,2006,16/05/2021,10127812006,1012781
790,04/05/2021,964,16,745,45,219,16/11/2020,"Chateau Calon Segur 3eme Cru Classe, Saint-Estephe",Bordeaux,2004,16/05/2021,10074752004,1007475
4800,12/05/2021,5754,26,4800,0,954,11/03/2021,"Chateau Margaux Premier Cru Classe, Margaux",Bordeaux,2003,16/05/2021,10127812003,1012781
2690,15/07/2021,2830,5,2500,190,330,12/04/2021,"Chateau Angelus Premier Grand Cru Classe B, Saint-Emilion Grand Cru",Bordeaux,2007,16/07/2021,10060452007,1006045
6300,14/05/2021,7576,47,5922,378,1654,13/04/2021,"Chateau Margaux Premier Cru Classe, Margaux",Bordeaux,2010,16/05/2021,10127812010,1012781
490,01/06/2021,570,26,450,40,120,25/05/2021,"Chateau Batailley 5eme Cru Classe, Pauillac",Bordeaux,2009,02/06/2021,10063222009,1006322
2690,15/07/2021,2830,5,2500,190,330,12/04/2021,"Chateau Angelus Premier Grand Cru Classe B, Saint-Emilion Grand Cru",Bordeaux,2007,16/07/2021,10060452007,1006045
3950,14/05/2021,4461,85,3800,150,661,12/05/2021,"Chateau Margaux Premier Cru Classe, Margaux",Bordeaux,2008,16/05/2021,10127812008,1012781
4400,14/05/2021,4883,27,4400,0,483,29/09/2020,"Chateau Margaux Premier Cru Classe, Margaux",Bordeaux,2001,16/05/2021,10127812001,1012781
3900,14/05/2021,4522,33,3684,216,838,10/06/2020,"Chateau Margaux Premier Cru Classe, Margaux",Bordeaux,2002,16/05/2021,10127812002,1012781
6650,14/05/2021,7976,70,6500,150,1476,12/05/2021,"Chateau Margaux Premier Cru Classe, Margaux",Bordeaux,2009,16/05/2021,10127812009,1012781
3720,11/06/2021,4292,146,3480,240,812,10/04/2021,"Chateau Margaux Premier Cru Classe, Margaux",Bordeaux,2014,12/06/2021,10127812014,1012781
3758,13/05/2021,4389,122,3690,68,699,13/04/2021,"Chateau Margaux Premier Cru Classe, Margaux",Bordeaux,2011,16/05/2021,10127812011,1012781
10500,09/06/2021,11988,53,9844,656,2144,29/03/2021,"Chateau Margaux Premier Cru Classe, Margaux",Bordeaux,2015,10/06/2021,10127812015,1012781
4850,11/06/2021,5601,32,4842,8,759,19/05/2021,"Chateau Margaux Premier Cru Classe, Margaux",Bordeaux,2003,12/06/2021,10127812003,1012781
2690,14/07/2021,2830,5,2500,190,330,12/04/2021,"Chateau Angelus Premier Grand Cru Classe B, Saint-Emilion Grand Cru",Bordeaux,2007,15/07/2021,10060452007,1006045
1000,09/06/2021,1157,98,988,12,169,28/05/2021,"Chateau Calon Segur 3eme Cru Classe, Saint-Estephe",Bordeaux,2005,10/06/2021,10074752005,1007475
2690,14/07/2021,2830,5,2500,190,330,12/04/2021,"Chateau Angelus Premier Grand Cru Classe B, Saint-Emilion Grand Cru",Bordeaux,2007,15/07/2021,10060452007,1006045
3740,09/06/2021,3976,53,3520,220,456,07/04/2021,"Chateau Margaux Premier Cru Classe, Margaux",Bordeaux,2013,10/06/2021,10127812013,1012781
490,01/06/2021,594,407,494,-4,100,20/04/2021,"Chateau Batailley 5eme Cru Classe, Pauillac",Bordeaux,2010,02/06/2021,10063222010,1006322
2690,13/07/2021,2830,5,2500,190,330,12/04/2021,"Chateau Angelus Premier Grand Cru Classe B, Saint-Emilion Grand Cru",Bordeaux,2007,14/07/2021,10060452007,1006045
3560,09/06/2021,4098,34,3592,-32,506,06/05/2021,"Chateau Margaux Premier Cru Classe, Margaux",Bordeaux,2007,10/06/2021,10127812007,1012781
2500,09/06/2021,3334,3,1200,1300,2134,16/05/2012,"Gaja, Barbaresco",Piedmont,2001,10/06/2021,10996052001,1099605
2690,13/07/2021,2830,5,2500,190,330,12/04/2021,"Chateau Angelus Premier Grand Cru Classe B, Saint-Emilion Grand Cru",Bordeaux,2007,14/07/2021,10060452007,1006045
870,09/06/2021,948,10,705,165,243,01/02/2021,"Chateau Calon Segur 3eme Cru Classe, Saint-Estephe",Bordeaux,2002,10/06/2021,10074752002,1007475
750,09/06/2021,1007,50,790,-40,217,01/06/2020,"Chateau Calon Segur 3eme Cru Classe, Saint-Estephe",Bordeaux,2011,10/06/2021,10074752011,1007475
6250,04/06/2021,7443,47,6776,-526,667,10/06/2021,"Chateau Margaux Premier Cru Classe, Margaux",Bordeaux,2005,12/06/2021,10127812005,1012781
6830,09/06/2021,7684,49,6525,305,1159,23/05/2021,"Chateau Margaux Premier Cru Classe, Margaux",Bordeaux,2009,11/06/2021,10127812009,1012781
3720,10/06/2021,4292,146,3480,240,812,10/04/2021,"Chateau Margaux Premier Cru Classe, Margaux",Bordeaux,2014,11/06/2021,10127812014,1012781
2690,12/07/2021,2830,5,2500,190,330,12/04/2021,"Chateau Angelus Premier Grand Cru Classe B, Saint-Emilion Grand Cru",Bordeaux,2007,13/07/2021,10060452007,1006045
3750,17/06/2021,4056,78,3690,60,366,13/04/2021,"Chateau Margaux Premier Cru Classe, Margaux",Bordeaux,2011,22/06/2021,10127812011,1012781
6400,18/06/2021,7419,40,6776,-376,643,10/06/2021,"Chateau Margaux Premier Cru Classe, Margaux",Bordeaux,2005,22/06/2021,10127812005,1012781
3900,21/06/2021,4628,83,3822,78,806,20/06/2021,"Chateau Margaux Premier Cru Classe, Margaux",Bordeaux,2006,22/06/2021,10127812006,1012781
8100,21/06/2021,8466,17,8100,0,366,21/06/2021,"Chateau Margaux Premier Cru Classe, Margaux",Bordeaux,2000,22/06/2021,10127812000,1012781
2690,12/07/2021,2830,5,2500,190,330,12/04/2021,"Chateau Angelus Premier Grand Cru Classe B, Saint-Emilion Grand Cru",Bordeaux,2007,13/07/2021,10060452007,1006045
1245,15/06/2021,1615,2,882,363,733,26/04/2019,"Tignanello, Toscana",Tuscany,2003,22/06/2021,10953912003,1095391
6450,21/06/2021,7504,51,6190,260,1314,23/05/2021,"Chateau Margaux Premier Cru Classe, Margaux",Bordeaux,2010,22/06/2021,10127812010,1012781
2690,09/07/2021,2836,6,2500,190,336,12/04/2021,"Chateau Angelus Premier Grand Cru Classe B, Saint-Emilion Grand Cru",Bordeaux,2007,10/07/2021,10060452007,1006045
4450,29/06/2021,4688,22,4400,50,288,29/09/2020,"Chateau Margaux Premier Cru Classe, Margaux",Bordeaux,2001,30/06/2021,10127812001,1012781
3826,29/06/2021,4495,57,4116,-290,379,25/02/2021,"Chateau Margaux Premier Cru Classe, Margaux",Bordeaux,2004,30/06/2021,10127812004,1012781
4850,25/06/2021,5898,20,4650,200,1248,21/06/2021,"Chateau Margaux Premier Cru Classe, Margaux",Bordeaux,2003,30/06/2021,10127812003,1012781
2690,09/07/2021,2836,6,2500,190,336,12/04/2021,"Chateau Angelus Premier Grand Cru Classe B, Saint-Emilion Grand Cru",Bordeaux,2007,10/07/2021,10060452007,1006045
800,29/06/2021,921,19,745,55,176,16/11/2020,"Chateau Calon Segur 3eme Cru Classe, Saint-Estephe",Bordeaux,2004,30/06/2021,10074752004,1007475
3750,14/06/2021,4202,38,3560,190,642,20/11/2020,"Chateau Margaux Premier Cru Classe, Margaux",Bordeaux,2012,22/06/2021,10127812012,1012781
1700,21/06/2021,1652,3,1378,322,274,29/07/2020,"Tignanello, Toscana",Tuscany,2001,22/06/2021,10953912001,1095391
3560,21/06/2021,3992,29,3525,35,467,18/06/2021,"Chateau Margaux Premier Cru Classe, Margaux",Bordeaux,2007,22/06/2021,10127812007,1012781
1310,21/06/2021,1403,4,1172,138,231,07/04/2021,"Tignanello, Toscana",Tuscany,2010,22/06/2021,10953912010,1095391
686,21/06/2021,838,8,682,4,156,15/09/2020,"Chateau Calon Segur 3eme Cru Classe, Saint-Estephe",Bordeaux,2013,22/06/2021,10074752013,1007475
900,02/06/2021,1090,29,800,100,290,21/11/2019,"Chateau Calon Segur 3eme Cru Classe, Saint-Estephe",Bordeaux,2003,05/06/2021,10074752003,1007475
490,01/06/2021,594,407,494,-4,100,20/04/2021,"Chateau Batailley 5eme Cru Classe, Pauillac",Bordeaux,2010,02/06/2021,10063222010,1006322
2690,08/07/2021,2836,6,2500,190,336,12/04/2021,"Chateau Angelus Premier Grand Cru Classe B, Saint-Emilion Grand Cru",Bordeaux,2007,09/07/2021,10060452007,1006045
4850,04/06/2021,5640,35,4842,8,798,19/05/2021,"Chateau Margaux Premier Cru Classe, Margaux",Bordeaux,2003,05/06/2021,10127812003,1012781
3720,04/06/2021,4300,146,3480,240,820,10/04/2021,"Chateau Margaux Premier Cru Classe, Margaux",Bordeaux,2014,05/06/2021,10127812014,1012781
2690,08/07/2021,2836,6,2500,190,336,12/04/2021,"Chateau Angelus Premier Grand Cru Classe B, Saint-Emilion Grand Cru",Bordeaux,2007,09/07/2021,10060452007,1006045
2690,07/07/2021,2836,6,2500,190,336,12/04/2021,"Chateau Angelus Premier Grand Cru Classe B, Saint-Emilion Grand Cru",Bordeaux,2007,08/07/2021,10060452007,1006045
740,17/06/2021,994,35,790,-50,204,01/06/2020,"Chateau Calon Segur 3eme Cru Classe, Saint-Estephe",Bordeaux,2011,22/06/2021,10074752011,1007475
900,21/06/2021,1054,22,800,100,254,21/11/2019,"Chateau Calon Segur 3eme Cru Classe, Saint-Estephe",Bordeaux,2003,22/06/2021,10074752003,1007475
6300,04/06/2021,7484,58,6190,110,1294,23/05/2021,"Chateau Margaux Premier Cru Classe, Margaux",Bordeaux,2010,05/06/2021,10127812010,1012781
2690,07/07/2021,2836,6,2500,190,336,12/04/2021,"Chateau Angelus Premier Grand Cru Classe B, Saint-Emilion Grand Cru",Bordeaux,2007,08/07/2021,10060452007,1006045
6830,21/06/2021,7675,46,7086,-256,589,11/06/2021,"Chateau Margaux Premier Cru Classe, Margaux",Bordeaux,2009,22/06/2021,10127812009,1012781
1299,15/06/2021,1459,7,1010,289,449,18/12/2020,"Tignanello, Toscana",Tuscany,2008,22/06/2021,10953912008,1095391
880,21/06/2021,967,9,725,155,242,13/04/2021,"Chateau Calon Segur 3eme Cru Classe, Saint-Estephe",Bordeaux,2007,22/06/2021,10074752007,1007475
2690,06/07/2021,2836,6,2500,190,336,12/04/2021,"Chateau Angelus Premier Grand Cru Classe B, Saint-Emilion Grand Cru",Bordeaux,2007,07/07/2021,10060452007,1006045
790,04/06/2021,926,29,801,-11,125,31/05/2021,"Chateau Calon Segur 3eme Cru Classe, Saint-Estephe",Bordeaux,2014,05/06/2021,10074752014,1007475
790,03/06/2021,982,21,745,45,237,16/11/2020,"Chateau Calon Segur 3eme Cru Classe, Saint-Estephe",Bordeaux,2004,05/06/2021,10074752004,1007475
6250,04/06/2021,7376,44,6360,-110,1016,24/05/2021,"Chateau Margaux Premier Cru Classe, Margaux",Bordeaux,2005,05/06/2021,10127812005,1012781
1290,03/06/2021,1352,8,1172,118,180,07/04/2021,"Tignanello, Toscana",Tuscany,2010,05/06/2021,10953912010,1095391
880,03/06/2021,932,14,781,99,151,16/11/2020,"Chateau Calon Segur 3eme Cru Classe, Saint-Estephe",Bordeaux,2008,05/06/2021,10074752008,1007475
2804,04/06/2021,3496,3,1200,1604,2296,16/05/2012,"Gaja, Barbaresco",Piedmont,2001,05/06/2021,10996052001,1099605
2690,06/07/2021,2836,6,2500,190,336,12/04/2021,"Chateau Angelus Premier Grand Cru Classe B, Saint-Emilion Grand Cru",Bordeaux,2007,07/07/2021,10060452007,1006045
845,21/06/2021,940,23,805,40,135,20/11/2019,"Chateau Calon Segur 3eme Cru Classe, Saint-Estephe",Bordeaux,2001,22/06/2021,10074752001,1007475
400,01/06/2021,433,9,355,45,78,15/04/2021,"Chateau Batailley 5eme Cru Classe, Pauillac",Bordeaux,2012,02/06/2021,10063222012,1006322
1245,27/05/2021,1545,3,882,363,663,26/04/2019,"Tignanello, Toscana",Tuscany,2003,05/06/2021,10953912003,1095391
1028,27/05/2021,1044,9,860,168,184,08/03/2021,"Tignanello, Toscana",Tuscany,2011,05/06/2021,10953912011,1095391
990,04/06/2021,1110,21,1000,-10,110,12/04/2021,"Chateau Calon Segur 3eme Cru Classe, Saint-Estephe",Bordeaux,2010,05/06/2021,10074752010,1007475
3900,02/06/2021,4471,28,3684,216,787,10/06/2020,"Chateau Margaux Premier Cru Classe, Margaux",Bordeaux,2002,05/06/2021,10127812002,1012781
2690,05/07/2021,2836,6,2500,190,336,12/04/2021,"Chateau Angelus Premier Grand Cru Classe B, Saint-Emilion Grand Cru",Bordeaux,2007,06/07/2021,10060452007,1006045
790,27/05/2021,921,31,858,-68,63,29/05/2021,"Chateau Calon Segur 3eme Cru Classe, Saint-Estephe",Bordeaux,2014,30/05/2021,10074752014,1007475
3740,28/05/2021,3986,51,3520,220,466,07/04/2021,"Chateau Margaux Premier Cru Classe, Margaux",Bordeaux,2013,30/05/2021,10127812013,1012781
400,01/06/2021,433,9,355,45,78,15/04/2021,"Chateau Batailley 5eme Cru Classe, Pauillac",Bordeaux,2012,02/06/2021,10063222012,1006322
300,01/06/2021,301,104,304,-4,-3,10/01/2021,"Chateau Batailley 5eme Cru Classe, Pauillac",Bordeaux,2013,02/06/2021,10063222013,1006322
1000,04/06/2021,1153,98,988,12,165,28/05/2021,"Chateau Calon Segur 3eme Cru Classe, Saint-Estephe",Bordeaux,2005,05/06/2021,10074752005,1007475
1300,27/05/2021,1333,5,1200,100,133,06/03/2021,"Tignanello, Toscana",Tuscany,2007,30/05/2021,10953912007,1095391
1000,28/05/2021,1160,41,1030,-30,130,25/05/2021,"Chateau Calon Segur 3eme Cru Classe, Saint-Estephe",Bordeaux,2009,30/05/2021,10074752009,1007475
476,01/06/2021,529,45,364,112,165,12/05/2021,"Chateau Batailley 5eme Cru Classe, Pauillac",Bordeaux,2016,02/06/2021,10063222016,1006322
6750,03/06/2021,7627,40,6525,225,1102,23/05/2021,"Chateau Margaux Premier Cru Classe, Margaux",Bordeaux,2009,05/06/2021,10127812009,1012781
8100,03/06/2021,8513,22,7950,150,563,12/03/2021,"Chateau Margaux Premier Cru Classe, Margaux",Bordeaux,2000,05/06/2021,10127812000,1012781
3758,04/06/2021,4048,97,3690,68,358,13/04/2021,"Chateau Margaux Premier Cru Classe, Margaux",Bordeaux,2011,05/06/2021,10127812011,1012781
750,02/06/2021,1007,50,790,-40,217,01/06/2020,"Chateau Calon Segur 3eme Cru Classe, Saint-Estephe",Bordeaux,2011,05/06/2021,10074752011,1007475
2690,05/07/2021,2836,6,2500,190,336,12/04/2021,"Chateau Angelus Premier Grand Cru Classe B, Saint-Emilion Grand Cru",Bordeaux,2007,06/07/2021,10060452007,1006045
408,01/06/2021,418,19,357,51,61,06/05/2021,"Chateau Batailley 5eme Cru Classe, Pauillac",Bordeaux,2018,02/06/2021,10063222018,1006322
8040,28/05/2021,8483,23,7950,90,533,12/03/2021,"Chateau Margaux Premier Cru Classe, Margaux",Bordeaux,2000,30/05/2021,10127812000,1012781
3900,21/06/2021,4493,25,3684,216,809,10/06/2020,"Chateau Margaux Premier Cru Classe, Margaux",Bordeaux,2002,22/06/2021,10127812002,1012781
2098,21/06/2021,2300,4,2190,-92,110,01/05/2021,"Gaja, Barbaresco",Piedmont,2004,22/06/2021,10996052004,1099605
2500,21/06/2021,2636,2,2220,280,416,14/06/2021,"Gaja, Barbaresco",Piedmont,2001,22/06/2021,10996052001,1099605
1408,27/05/2021,1394,5,1238,170,156,02/11/2020,"Tignanello, Toscana",Tuscany,2006,30/05/2021,10953912006,1095391
468,02/06/2021,582,2,465,3,117,04/05/2020,"Chateau Batailley 5eme Cru Classe, Pauillac",Bordeaux,2001,03/06/2021,10063222001,1006322
790,27/05/2021,918,30,858,-68,60,29/05/2021,"Chateau Calon Segur 3eme Cru Classe, Saint-Estephe",Bordeaux,2014,31/05/2021,10074752014,1007475
1300,04/06/2021,1333,5,1200,100,133,06/03/2021,"Tignanello, Toscana",Tuscany,2007,05/06/2021,10953912007,1095391
1000,03/06/2021,1163,42,1030,-30,133,25/05/2021,"Chateau Calon Segur 3eme Cru Classe, Saint-Estephe",Bordeaux,2009,05/06/2021,10074752009,1007475
9600,27/05/2021,9821,2,8000,1600,1821,30/01/2020,"Domaine Leflaive, Chevalier-Montrachet Grand Cru",Burgundy,2014,05/06/2021,10734012014,1073401
2690,02/07/2021,2836,6,2500,190,336,12/04/2021,"Chateau Angelus Premier Grand Cru Classe B, Saint-Emilion Grand Cru",Bordeaux,2007,03/07/2021,10060452007,1006045
2232,01/06/2021,2369,5,2190,42,179,01/05/2021,"Gaja, Barbaresco",Piedmont,2004,05/06/2021,10996052004,1099605
2690,02/07/2021,2836,6,2500,190,336,12/04/2021,"Chateau Angelus Premier Grand Cru Classe B, Saint-Emilion Grand Cru",Bordeaux,2007,03/07/2021,10060452007,1006045
530,02/06/2021,674,94,450,80,224,04/05/2021,"Chateau Batailley 5eme Cru Classe, Pauillac",Bordeaux,2005,03/06/2021,10063222005,1006322
826,21/06/2021,948,4,705,121,243,01/02/2021,"Chateau Calon Segur 3eme Cru Classe, Saint-Estephe",Bordeaux,2002,22/06/2021,10074752002,1007475
3560,02/06/2021,4084,36,3592,-32,492,06/05/2021,"Chateau Margaux Premier Cru Classe, Margaux",Bordeaux,2007,05/06/2021,10127812007,1012781
1678,27/05/2021,1648,4,1180,498,468,25/06/2020,"Tignanello, Toscana",Tuscany,2004,05/06/2021,10953912004,1095391
3740,04/06/2021,3981,52,3520,220,461,07/04/2021,"Chateau Margaux Premier Cru Classe, Margaux",Bordeaux,2013,05/06/2021,10127812013,1012781
1000,21/06/2021,1144,76,988,12,156,28/05/2021,"Chateau Calon Segur 3eme Cru Classe, Saint-Estephe",Bordeaux,2005,22/06/2021,10074752005,1007475
3900,04/06/2021,4693,78,3861,39,832,28/05/2021,"Chateau Margaux Premier Cru Classe, Margaux",Bordeaux,2006,05/06/2021,10127812006,1012781
880,17/06/2021,971,8,781,99,190,16/11/2020,"Chateau Calon Segur 3eme Cru Classe, Saint-Estephe",Bordeaux,2008,22/06/2021,10074752008,1007475
2690,01/07/2021,2836,6,2500,190,336,12/04/2021,"Chateau Angelus Premier Grand Cru Classe B, Saint-Emilion Grand Cru",Bordeaux,2007,02/07/2021,10060452007,1006045
790,03/06/2021,1087,80,860,-70,227,19/04/2021,"Chateau Calon Segur 3eme Cru Classe, Saint-Estephe",Bordeaux,2015,05/06/2021,10074752015,1007475
900,04/06/2021,1245,13,850,50,395,28/01/2021,"Tignanello, Toscana",Tuscany,2012,05/06/2021,10953912012,1095391
10500,02/06/2021,12151,50,9844,656,2307,29/03/2021,"Chateau Margaux Premier Cru Classe, Margaux",Bordeaux,2015,05/06/2021,10127812015,1012781
1050,01/06/2021,1212,23,940,110,272,18/03/2021,"Chateau Calon Segur 3eme Cru Classe, Saint-Estephe",Bordeaux,2000,05/06/2021,10074752000,1007475
2690,01/07/2021,2836,6,2500,190,336,12/04/2021,"Chateau Angelus Premier Grand Cru Classe B, Saint-Emilion Grand Cru",Bordeaux,2007,02/07/2021,10060452007,1006045
950,21/06/2021,1019,52,863,87,156,10/05/2021,"Chateau Calon Segur 3eme Cru Classe, Saint-Estephe",Bordeaux,2006,22/06/2021,10074752006,1007475
2690,30/06/2021,2836,6,2500,190,336,12/04/2021,"Chateau Angelus Premier Grand Cru Classe B, Saint-Emilion Grand Cru",Bordeaux,2007,01/07/2021,10060452007,1006045
2690,30/06/2021,2836,6,2500,190,336,12/04/2021,"Chateau Angelus Premier Grand Cru Classe B, Saint-Emilion Grand Cru",Bordeaux,2007,01/07/2021,10060452007,1006045
750,17/06/2021,921,19,745,5,176,16/11/2020,"Chateau Calon Segur 3eme Cru Classe, Saint-Estephe",Bordeaux,2004,22/06/2021,10074752004,1007475
3826,04/06/2021,4521,57,4116,-290,405,25/02/2021,"Chateau Margaux Premier Cru Classe, Margaux",Bordeaux,2004,05/06/2021,10127812004,1012781
4386,02/06/2021,4723,25,4400,-14,323,29/09/2020,"Chateau Margaux Premier Cru Classe, Margaux",Bordeaux,2001,05/06/2021,10127812001,1012781
530,02/06/2021,675,93,450,80,225,04/05/2021,"Chateau Batailley 5eme Cru Classe, Pauillac",Bordeaux,2005,05/06/2021,10063222005,1006322
3720,21/06/2021,4294,136,3480,240,814,17/06/2021,"Chateau Margaux Premier Cru Classe, Margaux",Bordeaux,2014,22/06/2021,10127812014,1012781
1100,17/06/2021,1158,32,1030,70,128,25/05/2021,"Chateau Calon Segur 3eme Cru Classe, Saint-Estephe",Bordeaux,2009,22/06/2021,10074752009,1007475
530,02/06/2021,674,94,450,80,224,04/05/2021,"Chateau Batailley 5eme Cru Classe, Pauillac",Bordeaux,2005,03/06/2021,10063222005,1006322
530,02/06/2021,675,93,450,80,225,04/05/2021,"Chateau Batailley 5eme Cru Classe, Pauillac",Bordeaux,2005,05/06/2021,10063222005,1006322
2690,29/06/2021,2836,6,2500,190,336,12/04/2021,"Chateau Angelus Premier Grand Cru Classe B, Saint-Emilion Grand Cru",Bordeaux,2007,30/06/2021,10060452007,1006045
870,03/06/2021,948,10,705,165,243,01/02/2021,"Chateau Calon Segur 3eme Cru Classe, Saint-Estephe",Bordeaux,2002,05/06/2021,10074752002,1007475
1040,14/07/2021,1135,14,940,100,195,18/03/2021,"Chateau Calon Segur 3eme Cru Classe, Saint-Estephe",Bordeaux,2000,15/07/2021,10074752000,1007475
870,14/07/2021,966,5,705,165,261,01/02/2021,"Chateau Calon Segur 3eme Cru Classe, Saint-Estephe",Bordeaux,2002,15/07/2021,10074752002,1007475
8200,12/07/2021,8969,13,8100,100,869,21/06/2021,"Chateau Margaux Premier Cru Classe, Margaux",Bordeaux,2000,15/07/2021,10127812000,1012781
945,14/07/2021,1128,23,800,145,328,21/11/2019,"Chateau Calon Segur 3eme Cru Classe, Saint-Estephe",Bordeaux,2003,15/07/2021,10074752003,1007475
4450,14/07/2021,4805,24,4400,50,405,29/09/2020,"Chateau Margaux Premier Cru Classe, Margaux",Bordeaux,2001,15/07/2021,10127812001,1012781
3939,14/07/2021,4425,22,3684,255,741,10/06/2020,"Chateau Margaux Premier Cru Classe, Margaux",Bordeaux,2002,15/07/2021,10127812002,1012781
3826,14/07/2021,4583,48,4116,-290,467,25/02/2021,"Chateau Margaux Premier Cru Classe, Margaux",Bordeaux,2004,15/07/2021,10127812004,1012781
2690,29/06/2021,2836,6,2500,190,336,12/04/2021,"Chateau Angelus Premier Grand Cru Classe B, Saint-Emilion Grand Cru",Bordeaux,2007,30/06/2021,10060452007,1006045
3750,04/06/2021,4146,41,3560,190,586,20/11/2020,"Chateau Margaux Premier Cru Classe, Margaux",Bordeaux,2012,05/06/2021,10127812012,1012781
3900,04/06/2021,4441,100,3800,100,641,12/05/2021,"Chateau Margaux Premier Cru Classe, Margaux",Bordeaux,2008,05/06/2021,10127812008,1012781
2690,28/06/2021,2836,6,2500,190,336,12/04/2021,"Chateau Angelus Premier Grand Cru Classe B, Saint-Emilion Grand Cru",Bordeaux,2007,29/06/2021,10060452007,1006045
907,04/06/2021,956,23,805,102,151,20/11/2019,"Chateau Calon Segur 3eme Cru Classe, Saint-Estephe",Bordeaux,2001,05/06/2021,10074752001,1007475
10328,21/06/2021,11935,51,9800,528,2135,11/06/2021,"Chateau Margaux Premier Cru Classe, Margaux",Bordeaux,2015,22/06/2021,10127812015,1012781
4400,17/06/2021,4724,25,4400,0,324,29/09/2020,"Chateau Margaux Premier Cru Classe, Margaux",Bordeaux,2001,22/06/2021,10127812001,1012781
1678,15/06/2021,1683,4,1180,498,503,25/06/2020,"Tignanello, Toscana",Tuscany,2004,22/06/2021,10953912004,1095391
3900,21/06/2021,4214,66,3700,200,514,07/06/2021,"Chateau Margaux Premier Cru Classe, Margaux",Bordeaux,2008,22/06/2021,10127812008,1012781
3826,04/06/2021,4533,56,4116,-290,417,25/02/2021,"Chateau Margaux Premier Cru Classe, Margaux",Bordeaux,2004,06/06/2021,10127812004,1012781
2690,28/06/2021,2836,6,2500,190,336,12/04/2021,"Chateau Angelus Premier Grand Cru Classe B, Saint-Emilion Grand Cru",Bordeaux,2007,29/06/2021,10060452007,1006045
4850,18/06/2021,5656,27,4650,200,1006,21/06/2021,"Chateau Margaux Premier Cru Classe, Margaux",Bordeaux,2003,22/06/2021,10127812003,1012781
420,02/06/2021,521,5,400,20,121,11/05/2021,"Chateau Batailley 5eme Cru Classe, Pauillac",Bordeaux,2006,07/06/2021,10063222006,1006322
1408,21/06/2021,1389,4,1238,170,151,02/11/2020,"Tignanello, Toscana",Tuscany,2006,22/06/2021,10953912006,1095391
1024,21/06/2021,1233,5,1072,-48,161,20/01/2021,"Tignanello, Toscana",Tuscany,2009,22/06/2021,10953912009,1095391
2690,25/06/2021,2836,6,2500,190,336,12/04/2021,"Chateau Angelus Premier Grand Cru Classe B, Saint-Emilion Grand Cru",Bordeaux,2007,26/06/2021,10060452007,1006045
2690,25/06/2021,2836,6,2500,190,336,12/04/2021,"Chateau Angelus Premier Grand Cru Classe B, Saint-Emilion Grand Cru",Bordeaux,2007,26/06/2021,10060452007,1006045
1408,15/06/2021,1436,1,1150,258,286,21/04/2019,"Tignanello, Toscana",Tuscany,2005,22/06/2021,10953912005,1095391
16200,28/07/2021,16327,0,18750,-2550,-2423,29/08/2018,"Jacques-Frederic Mugnier, Chambolle-Musigny Premier Cru, Les Amoureuses",Burgundy,2015,29/07/2021,10496422015,1049642
2690,24/06/2021,2836,6,2500,190,336,12/04/2021,"Chateau Angelus Premier Grand Cru Classe B, Saint-Emilion Grand Cru",Bordeaux,2007,25/06/2021,10060452007,1006045
1408,27/05/2021,1410,1,996,412,414,14/06/2019,"Tignanello, Toscana",Tuscany,2000,22/06/2021,10953912000,1095391
420,02/06/2021,508,6,400,20,108,11/05/2021,"Chateau Batailley 5eme Cru Classe, Pauillac",Bordeaux,2006,03/06/2021,10063222006,1006322
3826,21/06/2021,4507,50,4116,-290,391,25/02/2021,"Chateau Margaux Premier Cru Classe, Margaux",Bordeaux,2004,22/06/2021,10127812004,1012781
1570,15/06/2021,1344,3,1200,370,144,06/03/2021,"Tignanello, Toscana",Tuscany,2007,22/06/2021,10953912007,1095391
990,21/06/2021,1108,16,990,0,118,16/06/2021,"Chateau Calon Segur 3eme Cru Classe, Saint-Estephe",Bordeaux,2010,22/06/2021,10074752010,1007475
2690,24/06/2021,2836,6,2500,190,336,12/04/2021,"Chateau Angelus Premier Grand Cru Classe B, Saint-Emilion Grand Cru",Bordeaux,2007,25/06/2021,10060452007,1006045
3740,21/06/2021,3975,52,3520,220,455,07/04/2021,"Chateau Margaux Premier Cru Classe, Margaux",Bordeaux,2013,22/06/2021,10127812013,1012781
2690,23/06/2021,2836,6,2500,190,336,12/04/2021,"Chateau Angelus Premier Grand Cru Classe B, Saint-Emilion Grand Cru",Bordeaux,2007,24/06/2021,10060452007,1006045
420,02/06/2021,511,6,400,20,111,11/05/2021,"Chateau Batailley 5eme Cru Classe, Pauillac",Bordeaux,2006,04/06/2021,10063222006,1006322
3560,25/06/2021,4172,44,3525,35,647,18/06/2021,"Chateau Margaux Premier Cru Classe, Margaux",Bordeaux,2007,28/06/2021,10127812007,1012781
1050,17/06/2021,1150,6,860,190,290,08/03/2021,"Tignanello, Toscana",Tuscany,2013,28/06/2021,10953912013,1095391
420,02/06/2021,516,6,400,20,116,11/05/2021,"Chateau Batailley 5eme Cru Classe, Pauillac",Bordeaux,2006,05/06/2021,10063222006,1006322
3900,25/06/2021,4634,95,3822,78,812,20/06/2021,"Chateau Margaux Premier Cru Classe, Margaux",Bordeaux,2006,28/06/2021,10127812006,1012781
1304,23/06/2021,1461,3,1170,134,291,24/06/2021,"Tignanello, Toscana",Tuscany,2010,28/06/2021,10953912010,1095391
5500,28/07/2021,5887,159,5500,0,387,06/07/2021,"Chateau Margaux Premier Cru Classe, Margaux",Bordeaux,2016,29/07/2021,10127812016,1012781
2690,23/06/2021,2836,6,2500,190,336,12/04/2021,"Chateau Angelus Premier Grand Cru Classe B, Saint-Emilion Grand Cru",Bordeaux,2007,24/06/2021,10060452007,1006045
1100,28/07/2021,1218,78,1036,64,182,27/05/2021,"Chateau Calon Segur 3eme Cru Classe, Saint-Estephe",Bordeaux,2016,29/07/2021,10074752016,1007475
420,02/06/2021,511,6,400,20,111,11/05/2021,"Chateau Batailley 5eme Cru Classe, Pauillac",Bordeaux,2006,04/06/2021,10063222006,1006322
1280,28/07/2021,1367,49,1220,60,147,14/07/2021,"Tignanello, Toscana",Tuscany,2016,29/07/2021,10953912016,1095391
1299,22/06/2021,1555,5,1010,289,545,18/12/2020,"Tignanello, Toscana",Tuscany,2008,28/06/2021,10953912008,1095391
1024,25/06/2021,1251,4,1072,-48,179,20/01/2021,"Tignanello, Toscana",Tuscany,2009,28/06/2021,10953912009,1095391
4850,25/06/2021,5841,20,4650,200,1191,21/06/2021,"Chateau Margaux Premier Cru Classe, Margaux",Bordeaux,2003,28/06/2021,10127812003,1012781
2690,22/06/2021,2836,6,2500,190,336,12/04/2021,"Chateau Angelus Premier Grand Cru Classe B, Saint-Emilion Grand Cru",Bordeaux,2007,23/06/2021,10060452007,1006045
2690,22/06/2021,2836,6,2500,190,336,12/04/2021,"Chateau Angelus Premier Grand Cru Classe B, Saint-Emilion Grand Cru",Bordeaux,2007,23/06/2021,10060452007,1006045
9600,18/06/2021,9792,1,8000,1600,1792,30/01/2020,"Domaine Leflaive, Chevalier-Montrachet Grand Cru",Burgundy,2014,28/06/2021,10734012014,1073401
1440,28/07/2021,1677,32,1510,-70,167,18/07/2021,"Gaja, Barbaresco",Piedmont,2016,29/07/2021,10996052016,1099605
420,02/06/2021,508,6,400,20,108,11/05/2021,"Chateau Batailley 5eme Cru Classe, Pauillac",Bordeaux,2006,03/06/2021,10063222006,1006322
1500,15/06/2021,1681,50,1408,92,273,09/04/2021,"Gaja, Barbaresco",Piedmont,2016,16/06/2021,10996052016,1099605
2690,21/06/2021,2771,5,2500,190,271,12/04/2021,"Chateau Angelus Premier Grand Cru Classe B, Saint-Emilion Grand Cru",Bordeaux,2007,22/06/2021,10060452007,1006045
1050,17/06/2021,1145,6,860,190,285,08/03/2021,"Tignanello, Toscana",Tuscany,2013,24/06/2021,10953912013,1095391
1408,23/06/2021,1389,4,1238,170,151,02/11/2020,"Tignanello, Toscana",Tuscany,2006,24/06/2021,10953912006,1095391
2690,21/06/2021,2771,5,2500,190,271,12/04/2021,"Chateau Angelus Premier Grand Cru Classe B, Saint-Emilion Grand Cru",Bordeaux,2007,22/06/2021,10060452007,1006045
950,23/06/2021,1019,52,863,87,156,10/05/2021,"Chateau Calon Segur 3eme Cru Classe, Saint-Estephe",Bordeaux,2006,24/06/2021,10074752006,1007475
10500,23/06/2021,11956,52,9800,700,2156,11/06/2021,"Chateau Margaux Premier Cru Classe, Margaux",Bordeaux,2015,24/06/2021,10127812015,1012781
780,28/07/2021,936,95,740,40,196,21/05/2021,"Chateau Calon Segur 3eme Cru Classe, Saint-Estephe",Bordeaux,2017,29/07/2021,10074752017,1007475
3820,28/07/2021,4608,227,3950,-130,658,30/06/2021,"Chateau Margaux Premier Cru Classe, Margaux",Bordeaux,2017,29/07/2021,10127812017,1012781
1350,28/07/2021,1480,55,1260,90,220,18/02/2021,"Gaja, Barbaresco",Piedmont,2015,29/07/2021,10996052015,1099605
460,28/07/2021,498,179,420,40,78,28/05/2021,"Tua Rita, Giusto di Notri, Toscana",Tuscany,2016,29/07/2021,11058072016,1105807
8000,19/07/2021,8934,2,6974,1026,1960,14/03/2021,"Domaine Leflaive, Chevalier-Montrachet Grand Cru",Burgundy,2017,29/07/2021,10734012017,1073401
3900,23/06/2021,4494,25,3684,216,810,10/06/2020,"Chateau Margaux Premier Cru Classe, Margaux",Bordeaux,2002,24/06/2021,10127812002,1012781
870,23/06/2021,955,4,705,165,250,01/02/2021,"Chateau Calon Segur 3eme Cru Classe, Saint-Estephe",Bordeaux,2002,24/06/2021,10074752002,1007475
860,15/06/2021,1027,72,908,-48,119,15/06/2021,"Tignanello, Toscana",Tuscany,2018,16/06/2021,10953912018,1095391
1408,15/06/2021,1386,5,1238,170,148,02/11/2020,"Tignanello, Toscana",Tuscany,2006,16/06/2021,10953912006,1095391
420,02/06/2021,521,5,400,20,121,11/05/2021,"Chateau Batailley 5eme Cru Classe, Pauillac",Bordeaux,2006,07/06/2021,10063222006,1006322
6300,15/06/2021,7464,63,6190,110,1274,23/05/2021,"Chateau Margaux Premier Cru Classe, Margaux",Bordeaux,2010,16/06/2021,10127812010,1012781
2690,18/06/2021,2899,9,2500,190,399,12/04/2021,"Chateau Angelus Premier Grand Cru Classe B, Saint-Emilion Grand Cru",Bordeaux,2007,19/06/2021,10060452007,1006045
3758,15/06/2021,4049,97,3690,68,359,13/04/2021,"Chateau Margaux Premier Cru Classe, Margaux",Bordeaux,2011,16/06/2021,10127812011,1012781
2690,18/06/2021,2771,5,2500,190,271,12/04/2021,"Chateau Angelus Premier Grand Cru Classe B, Saint-Emilion Grand Cru",Bordeaux,2007,20/06/2021,10060452007,1006045
5415,03/06/2021,5680,98,5238,177,442,17/05/2021,"Chateau Margaux Premier Cru Classe, Margaux",Bordeaux,2016,16/06/2021,10127812016,1012781
840,09/06/2021,1089,26,842,-2,247,22/08/2020,"Chateau Calon Segur 3eme Cru Classe, Saint-Estephe",Bordeaux,2019,16/06/2021,10074752019,1007475
7800,15/06/2021,8250,8,7330,470,920,02/06/2021,"Domaine Leflaive, Chevalier-Montrachet Grand Cru",Burgundy,2018,16/06/2021,10734012018,1073401
2690,18/06/2021,2899,9,2500,190,399,12/04/2021,"Chateau Angelus Premier Grand Cru Classe B, Saint-Emilion Grand Cru",Bordeaux,2007,19/06/2021,10060452007,1006045
1040,23/06/2021,1210,21,940,100,270,18/03/2021,"Chateau Calon Segur 3eme Cru Classe, Saint-Estephe",Bordeaux,2000,25/06/2021,10074752000,1007475
880,24/06/2021,967,9,725,155,242,13/04/2021,"Chateau Calon Segur 3eme Cru Classe, Saint-Estephe",Bordeaux,2007,25/06/2021,10074752007,1007475
1040,23/06/2021,1204,22,940,100,264,18/03/2021,"Chateau Calon Segur 3eme Cru Classe, Saint-Estephe",Bordeaux,2000,24/06/2021,10074752000,1007475
760,03/06/2021,923,110,740,20,183,21/05/2021,"Chateau Calon Segur 3eme Cru Classe, Saint-Estephe",Bordeaux,2017,16/06/2021,10074752017,1007475
1150,03/06/2021,1223,9,1202,-52,21,10/05/2021,"Tignanello, Toscana",Tuscany,2015,16/06/2021,10953912015,1095391
2690,18/06/2021,2771,5,2500,190,271,12/04/2021,"Chateau Angelus Premier Grand Cru Classe B, Saint-Emilion Grand Cru",Bordeaux,2007,20/06/2021,10060452007,1006045
900,23/06/2021,1054,22,800,100,254,21/11/2019,"Chateau Calon Segur 3eme Cru Classe, Saint-Estephe",Bordeaux,2003,24/06/2021,10074752003,1007475
2690,17/06/2021,2899,9,2500,190,399,12/04/2021,"Chateau Angelus Premier Grand Cru Classe B, Saint-Emilion Grand Cru",Bordeaux,2007,18/06/2021,10060452007,1006045
420,02/06/2021,516,6,400,20,116,11/05/2021,"Chateau Batailley 5eme Cru Classe, Pauillac",Bordeaux,2006,05/06/2021,10063222006,1006322
6400,23/06/2021,7483,53,5950,450,1533,23/06/2021,"Chateau Margaux Premier Cru Classe, Margaux",Bordeaux,2010,24/06/2021,10127812010,1012781
1350,15/06/2021,1445,7,1352,-2,93,23/09/2020,"Gaja, Barbaresco",Piedmont,2011,16/06/2021,10996052011,1099605
1010,03/06/2021,1221,48,950,60,271,03/05/2021,"Chateau Calon Segur 3eme Cru Classe, Saint-Estephe",Bordeaux,2018,16/06/2021,10074752018,1007475
8100,15/06/2021,8469,19,7950,150,519,12/03/2021,"Chateau Margaux Premier Cru Classe, Margaux",Bordeaux,2000,16/06/2021,10127812000,1012781
2690,17/06/2021,2899,9,2500,190,399,12/04/2021,"Chateau Angelus Premier Grand Cru Classe B, Saint-Emilion Grand Cru",Bordeaux,2007,18/06/2021,10060452007,1006045
450,02/06/2021,450,1,340,110,110,31/08/2018,"Chateau Batailley 5eme Cru Classe, Pauillac",Bordeaux,2007,03/06/2021,10063222007,1006322
10100,11/06/2021,12006,54,9800,300,2206,11/06/2021,"Chateau Margaux Premier Cru Classe, Margaux",Bordeaux,2015,16/06/2021,10127812015,1012781
3750,14/06/2021,4219,40,3560,190,659,20/11/2020,"Chateau Margaux Premier Cru Classe, Margaux",Bordeaux,2012,24/06/2021,10127812012,1012781
450,02/06/2021,431,9,332,118,99,06/10/2020,"Chateau Batailley 5eme Cru Classe, Pauillac",Bordeaux,2008,03/06/2021,10063222008,1006322
990,23/06/2021,1108,16,990,0,118,16/06/2021,"Chateau Calon Segur 3eme Cru Classe, Saint-Estephe",Bordeaux,2010,24/06/2021,10074752010,1007475
2500,23/06/2021,2636,2,2220,280,416,14/06/2021,"Gaja, Barbaresco",Piedmont,2001,24/06/2021,10996052001,1099605
6250,15/06/2021,7421,48,6776,-526,645,10/06/2021,"Chateau Margaux Premier Cru Classe, Margaux",Bordeaux,2005,16/06/2021,10127812005,1012781
490,02/06/2021,570,26,450,40,120,25/05/2021,"Chateau Batailley 5eme Cru Classe, Pauillac",Bordeaux,2009,03/06/2021,10063222009,1006322
900,15/06/2021,1090,29,800,100,290,21/11/2019,"Chateau Calon Segur 3eme Cru Classe, Saint-Estephe",Bordeaux,2003,16/06/2021,10074752003,1007475
907,23/06/2021,953,23,805,102,148,20/11/2019,"Chateau Calon Segur 3eme Cru Classe, Saint-Estephe",Bordeaux,2001,24/06/2021,10074752001,1007475
686,23/06/2021,838,8,682,4,156,15/09/2020,"Chateau Calon Segur 3eme Cru Classe, Saint-Estephe",Bordeaux,2013,24/06/2021,10074752013,1007475
1000,23/06/2021,1245,49,1030,-30,215,25/05/2021,"Chateau Calon Segur 3eme Cru Classe, Saint-Estephe",Bordeaux,2009,24/06/2021,10074752009,1007475
6830,23/06/2021,7698,51,7086,-256,612,11/06/2021,"Chateau Margaux Premier Cru Classe, Margaux",Bordeaux,2009,24/06/2021,10127812009,1012781
490,02/06/2021,570,26,450,40,120,25/05/2021,"Chateau Batailley 5eme Cru Classe, Pauillac",Bordeaux,2009,03/06/2021,10063222009,1006322
2199,15/06/2021,2219,3,1340,859,879,13/03/2020,"Gaja, Barbaresco",Piedmont,2009,16/06/2021,10996052009,1099605
750,15/06/2021,1002,51,790,-40,212,01/06/2020,"Chateau Calon Segur 3eme Cru Classe, Saint-Estephe",Bordeaux,2011,16/06/2021,10074752011,1007475
360,02/06/2021,439,7,300,60,139,05/11/2020,"Chateau Batailley 5eme Cru Classe, Pauillac",Bordeaux,2011,03/06/2021,10063222011,1006322
2690,16/06/2021,2899,9,2500,190,399,12/04/2021,"Chateau Angelus Premier Grand Cru Classe B, Saint-Emilion Grand Cru",Bordeaux,2007,17/06/2021,10060452007,1006045
2348,15/06/2021,2348,1,2554,-206,-206,22/05/2020,"Gaja, Barbaresco",Piedmont,2006,16/06/2021,10996052006,1099605
3720,15/06/2021,4290,146,3480,240,810,10/04/2021,"Chateau Margaux Premier Cru Classe, Margaux",Bordeaux,2014,16/06/2021,10127812014,1012781
460,15/06/2021,492,185,420,40,72,28/05/2021,"Tua Rita, Giusto di Notri, Toscana",Tuscany,2016,16/06/2021,11058072016,1105807
7600,15/06/2021,7792,2,7124,476,668,15/02/2019,"Domaine Leflaive, Chevalier-Montrachet Grand Cru",Burgundy,2016,16/06/2021,10734012016,1073401
2690,16/06/2021,2899,9,2500,190,399,12/04/2021,"Chateau Angelus Premier Grand Cru Classe B, Saint-Emilion Grand Cru",Bordeaux,2007,17/06/2021,10060452007,1006045
1700,15/06/2021,1658,4,1378,322,280,29/07/2020,"Tignanello, Toscana",Tuscany,2001,16/06/2021,10953912001,1095391
1000,24/06/2021,1245,49,1026,-26,219,24/06/2021,"Chateau Calon Segur 3eme Cru Classe, Saint-Estephe",Bordeaux,2009,25/06/2021,10074752009,1007475
1304,23/06/2021,1402,4,1172,132,230,07/04/2021,"Tignanello, Toscana",Tuscany,2010,24/06/2021,10953912010,1095391
3826,15/06/2021,4525,55,4116,-290,409,25/02/2021,"Chateau Margaux Premier Cru Classe, Margaux",Bordeaux,2004,16/06/2021,10127812004,1012781
990,15/06/2021,1109,20,1000,-10,109,12/04/2021,"Chateau Calon Segur 3eme Cru Classe, Saint-Estephe",Bordeaux,2010,16/06/2021,10074752010,1007475
686,15/06/2021,844,13,682,4,162,15/09/2020,"Chateau Calon Segur 3eme Cru Classe, Saint-Estephe",Bordeaux,2013,16/06/2021,10074752013,1007475
830,03/06/2021,989,6,735,95,254,09/09/2020,"Chateau Calon Segur 3eme Cru Classe, Saint-Estephe",Bordeaux,2012,16/06/2021,10074752012,1007475
8000,15/06/2021,8639,6,6974,1026,1665,14/03/2021,"Domaine Leflaive, Chevalier-Montrachet Grand Cru",Burgundy,2017,16/06/2021,10734012017,1073401
1000,23/06/2021,1155,93,988,12,167,28/05/2021,"Chateau Calon Segur 3eme Cru Classe, Saint-Estephe",Bordeaux,2005,24/06/2021,10074752005,1007475
3900,23/06/2021,4629,95,3822,78,807,20/06/2021,"Chateau Margaux Premier Cru Classe, Margaux",Bordeaux,2006,24/06/2021,10127812006,1012781
2690,15/06/2021,2899,9,2500,190,399,12/04/2021,"Chateau Angelus Premier Grand Cru Classe B, Saint-Emilion Grand Cru",Bordeaux,2007,16/06/2021,10060452007,1006045
540,15/06/2021,533,3,300,240,233,03/11/2011,"Tua Rita, Giusto di Notri, Toscana",Tuscany,2007,16/06/2021,11058072007,1105807
900,11/06/2021,1259,12,850,50,409,28/01/2021,"Tignanello, Toscana",Tuscany,2012,16/06/2021,10953912012,1095391
3900,15/06/2021,4428,110,3700,200,728,07/06/2021,"Chateau Margaux Premier Cru Classe, Margaux",Bordeaux,2008,16/06/2021,10127812008,1012781
2690,15/06/2021,2899,9,2500,190,399,12/04/2021,"Chateau Angelus Premier Grand Cru Classe B, Saint-Emilion Grand Cru",Bordeaux,2007,16/06/2021,10060452007,1006045
2098,23/06/2021,2300,4,2190,-92,110,01/05/2021,"Gaja, Barbaresco",Piedmont,2004,24/06/2021,10996052004,1099605
1700,23/06/2021,1652,3,1378,322,274,29/07/2020,"Tignanello, Toscana",Tuscany,2001,24/06/2021,10953912001,1095391
3900,23/06/2021,4269,76,3700,200,569,07/06/2021,"Chateau Margaux Premier Cru Classe, Margaux",Bordeaux,2008,24/06/2021,10127812008,1012781
2690,14/06/2021,2899,9,2500,190,399,12/04/2021,"Chateau Angelus Premier Grand Cru Classe B, Saint-Emilion Grand Cru",Bordeaux,2007,15/06/2021,10060452007,1006045
1024,23/06/2021,1232,5,1072,-48,160,20/01/2021,"Tignanello, Toscana",Tuscany,2009,24/06/2021,10953912009,1095391
1260,15/06/2021,1375,7,1172,88,203,07/04/2021,"Tignanello, Toscana",Tuscany,2010,16/06/2021,10953912010,1095391
1245,15/06/2021,1545,3,882,363,663,26/04/2019,"Tignanello, Toscana",Tuscany,2003,16/06/2021,10953912003,1095391
870,15/06/2021,948,10,705,165,243,01/02/2021,"Chateau Calon Segur 3eme Cru Classe, Saint-Estephe",Bordeaux,2002,16/06/2021,10074752002,1007475
360,02/06/2021,439,5,300,60,139,05/11/2020,"Chateau Batailley 5eme Cru Classe, Pauillac",Bordeaux,2011,04/06/2021,10063222011,1006322
1000,15/06/2021,1147,82,988,12,159,28/05/2021,"Chateau Calon Segur 3eme Cru Classe, Saint-Estephe",Bordeaux,2005,16/06/2021,10074752005,1007475
6300,14/05/2021,7621,45,5922,378,1699,13/04/2021,"Chateau Margaux Premier Cru Classe, Margaux",Bordeaux,2010,17/05/2021,10127812010,1012781
1000,14/05/2021,1170,78,975,25,195,12/04/2021,"Chateau Calon Segur 3eme Cru Classe, Saint-Estephe",Bordeaux,2005,17/05/2021,10074752005,1007475
10500,14/05/2021,12486,70,9844,656,2642,29/03/2021,"Chateau Margaux Premier Cru Classe, Margaux",Bordeaux,2015,17/05/2021,10127812015,1012781
3950,14/05/2021,4467,84,3800,150,667,12/05/2021,"Chateau Margaux Premier Cru Classe, Margaux",Bordeaux,2008,17/05/2021,10127812008,1012781
3740,14/05/2021,3965,47,3520,220,445,07/04/2021,"Chateau Margaux Premier Cru Classe, Margaux",Bordeaux,2013,17/05/2021,10127812013,1012781
990,24/06/2021,1108,16,990,0,118,16/06/2021,"Chateau Calon Segur 3eme Cru Classe, Saint-Estephe",Bordeaux,2010,25/06/2021,10074752010,1007475
686,24/06/2021,838,8,682,4,156,15/09/2020,"Chateau Calon Segur 3eme Cru Classe, Saint-Estephe",Bordeaux,2013,25/06/2021,10074752013,1007475
360,02/06/2021,439,5,300,60,139,05/11/2020,"Chateau Batailley 5eme Cru Classe, Pauillac",Bordeaux,2011,04/06/2021,10063222011,1006322
360,02/06/2021,439,7,300,60,139,05/11/2020,"Chateau Batailley 5eme Cru Classe, Pauillac",Bordeaux,2011,03/06/2021,10063222011,1006322
2690,14/06/2021,2899,9,2500,190,399,12/04/2021,"Chateau Angelus Premier Grand Cru Classe B, Saint-Emilion Grand Cru",Bordeaux,2007,15/06/2021,10060452007,1006045
790,03/06/2021,1088,79,860,-70,228,19/04/2021,"Chateau Calon Segur 3eme Cru Classe, Saint-Estephe",Bordeaux,2015,16/06/2021,10074752015,1007475
3900,15/06/2021,4616,93,3861,39,755,28/05/2021,"Chateau Margaux Premier Cru Classe, Margaux",Bordeaux,2006,16/06/2021,10127812006,1012781
2690,11/06/2021,2899,9,2500,190,399,12/04/2021,"Chateau Angelus Premier Grand Cru Classe B, Saint-Emilion Grand Cru",Bordeaux,2007,12/06/2021,10060452007,1006045
1408,15/06/2021,1368,1,1150,258,218,21/04/2019,"Tignanello, Toscana",Tuscany,2005,16/06/2021,10953912005,1095391
4850,11/06/2021,5653,30,4842,8,811,19/05/2021,"Chateau Margaux Premier Cru Classe, Margaux",Bordeaux,2003,16/06/2021,10127812003,1012781
5490,15/06/2021,5845,105,5254,236,591,26/05/2021,"Chateau Margaux Premier Cru Classe, Margaux",Bordeaux,2018,16/06/2021,10127812018,1012781
3740,23/06/2021,4028,62,3520,220,508,07/04/2021,"Chateau Margaux Premier Cru Classe, Margaux",Bordeaux,2013,24/06/2021,10127812013,1012781
3700,15/06/2021,4222,118,3660,40,562,02/06/2021,"Chateau Margaux Premier Cru Classe, Margaux",Bordeaux,2017,16/06/2021,10127812017,1012781
15600,28/07/2021,15175,4,13000,2600,2175,29/04/2021,"Jacques-Frederic Mugnier, Chambolle-Musigny Premier Cru, Les Amoureuses",Burgundy,2017,29/07/2021,10496422017,1049642
2690,11/06/2021,2899,9,2500,190,399,12/04/2021,"Chateau Angelus Premier Grand Cru Classe B, Saint-Emilion Grand Cru",Bordeaux,2007,12/06/2021,10060452007,1006045
3720,24/06/2021,4311,146,3480,240,831,17/06/2021,"Chateau Margaux Premier Cru Classe, Margaux",Bordeaux,2014,25/06/2021,10127812014,1012781
1304,23/06/2021,1402,4,1170,134,232,24/06/2021,"Tignanello, Toscana",Tuscany,2010,25/06/2021,10953912010,1095391
1050,15/06/2021,1212,23,940,110,272,18/03/2021,"Chateau Calon Segur 3eme Cru Classe, Saint-Estephe",Bordeaux,2000,16/06/2021,10074752000,1007475
1200,15/06/2021,1260,38,1050,150,210,10/06/2021,"Tignanello, Toscana",Tuscany,2016,16/06/2021,10953912016,1095391
950,15/06/2021,1020,53,863,87,157,10/05/2021,"Chateau Calon Segur 3eme Cru Classe, Saint-Estephe",Bordeaux,2006,16/06/2021,10074752006,1007475
9600,15/06/2021,9798,2,8000,1600,1798,30/01/2020,"Domaine Leflaive, Chevalier-Montrachet Grand Cru",Burgundy,2014,16/06/2021,10734012014,1073401
2690,10/06/2021,2899,9,2500,190,399,12/04/2021,"Chateau Angelus Premier Grand Cru Classe B, Saint-Emilion Grand Cru",Bordeaux,2007,11/06/2021,10060452007,1006045
1000,17/06/2021,1051,8,880,120,171,22/06/2021,"Tignanello, Toscana",Tuscany,2011,24/06/2021,10953912011,1095391
400,02/06/2021,433,9,355,45,78,15/04/2021,"Chateau Batailley 5eme Cru Classe, Pauillac",Bordeaux,2012,03/06/2021,10063222012,1006322
880,23/06/2021,967,9,725,155,242,13/04/2021,"Chateau Calon Segur 3eme Cru Classe, Saint-Estephe",Bordeaux,2007,24/06/2021,10074752007,1007475
2690,10/06/2021,2899,9,2500,190,399,12/04/2021,"Chateau Angelus Premier Grand Cru Classe B, Saint-Emilion Grand Cru",Bordeaux,2007,11/06/2021,10060452007,1006045
2750,09/06/2021,2920,9,2500,250,420,12/04/2021,"Chateau Angelus Premier Grand Cru Classe B, Saint-Emilion Grand Cru",Bordeaux,2007,10/06/2021,10060452007,1006045
1299,15/06/2021,1493,7,1010,289,483,18/12/2020,"Tignanello, Toscana",Tuscany,2008,16/06/2021,10953912008,1095391
880,15/06/2021,986,13,725,155,261,13/04/2021,"Chateau Calon Segur 3eme Cru Classe, Saint-Estephe",Bordeaux,2007,16/06/2021,10074752007,1007475
1550,15/06/2021,1557,1,1300,250,257,27/04/2021,"Gaja, Barbaresco",Piedmont,2012,16/06/2021,10996052012,1099605
5000,15/06/2021,5058,6,4160,840,898,19/03/2021,"Chateau Margaux Premier Cru Classe, Margaux",Bordeaux,2019,16/06/2021,10127812019,1012781
3800,14/05/2021,4076,44,3480,320,596,10/04/2021,"Chateau Margaux Premier Cru Classe, Margaux",Bordeaux,2014,17/05/2021,10127812014,1012781
2750,09/06/2021,2920,9,2500,250,420,12/04/2021,"Chateau Angelus Premier Grand Cru Classe B, Saint-Emilion Grand Cru",Bordeaux,2007,10/06/2021,10060452007,1006045
400,02/06/2021,433,9,355,45,78,15/04/2021,"Chateau Batailley 5eme Cru Classe, Pauillac",Bordeaux,2012,03/06/2021,10063222012,1006322
3560,15/06/2021,4062,33,3592,-32,470,06/05/2021,"Chateau Margaux Premier Cru Classe, Margaux",Bordeaux,2007,16/06/2021,10127812007,1012781
660,15/06/2021,726,5,390,270,336,18/08/2017,"Tua Rita, Giusto di Notri, Toscana",Tuscany,2006,16/06/2021,11058072006,1105807
300,02/06/2021,301,105,304,-4,-3,10/01/2021,"Chateau Batailley 5eme Cru Classe, Pauillac",Bordeaux,2013,04/06/2021,10063222013,1006322
8100,23/06/2021,8544,18,8100,0,444,21/06/2021,"Chateau Margaux Premier Cru Classe, Margaux",Bordeaux,2000,24/06/2021,10127812000,1012781
950,23/06/2021,1246,14,850,100,396,28/01/2021,"Tignanello, Toscana",Tuscany,2012,24/06/2021,10953912012,1095391
3826,23/06/2021,4526,54,4116,-290,410,25/02/2021,"Chateau Margaux Premier Cru Classe, Margaux",Bordeaux,2004,24/06/2021,10127812004,1012781
3560,23/06/2021,4171,44,3525,35,646,18/06/2021,"Chateau Margaux Premier Cru Classe, Margaux",Bordeaux,2007,25/06/2021,10127812007,1012781
950,24/06/2021,1019,52,863,87,156,10/05/2021,"Chateau Calon Segur 3eme Cru Classe, Saint-Estephe",Bordeaux,2006,25/06/2021,10074752006,1007475
300,02/06/2021,301,104,304,-4,-3,10/01/2021,"Chateau Batailley 5eme Cru Classe, Pauillac",Bordeaux,2013,03/06/2021,10063222013,1006322
2750,08/06/2021,2920,9,2500,250,420,12/04/2021,"Chateau Angelus Premier Grand Cru Classe B, Saint-Emilion Grand Cru",Bordeaux,2007,09/06/2021,10060452007,1006045
6830,15/06/2021,7692,49,7086,-256,606,11/06/2021,"Chateau Margaux Premier Cru Classe, Margaux",Bordeaux,2009,16/06/2021,10127812009,1012781
3900,15/06/2021,4472,28,3684,216,788,10/06/2020,"Chateau Margaux Premier Cru Classe, Margaux",Bordeaux,2002,16/06/2021,10127812002,1012781
1024,15/06/2021,1213,6,1072,-48,141,20/01/2021,"Tignanello, Toscana",Tuscany,2009,16/06/2021,10953912009,1095391
2098,15/06/2021,2331,5,2190,-92,141,01/05/2021,"Gaja, Barbaresco",Piedmont,2004,16/06/2021,10996052004,1099605
2750,08/06/2021,2920,9,2500,250,420,12/04/2021,"Chateau Angelus Premier Grand Cru Classe B, Saint-Emilion Grand Cru",Bordeaux,2007,09/06/2021,10060452007,1006045
14520,15/06/2021,14270,1,12000,2520,2270,28/05/2020,"Jacques-Frederic Mugnier, Chambolle-Musigny Premier Cru, Les Amoureuses",Burgundy,2014,16/06/2021,10496422014,1049642
2750,07/06/2021,2920,9,2500,250,420,12/04/2021,"Chateau Angelus Premier Grand Cru Classe B, Saint-Emilion Grand Cru",Bordeaux,2007,08/06/2021,10060452007,1006045
1678,15/06/2021,1648,4,1180,498,468,25/06/2020,"Tignanello, Toscana",Tuscany,2004,16/06/2021,10953912004,1095391
15600,09/06/2021,15099,6,13000,2600,2099,29/04/2021,"Jacques-Frederic Mugnier, Chambolle-Musigny Premier Cru, Les Amoureuses",Burgundy,2017,16/06/2021,10496422017,1049642
2750,07/06/2021,2920,9,2500,250,420,12/04/2021,"Chateau Angelus Premier Grand Cru Classe B, Saint-Emilion Grand Cru",Bordeaux,2007,08/06/2021,10060452007,1006045
1516,15/06/2021,1559,177,1358,158,201,12/05/2021,"Gaja, Barbaresco",Piedmont,2017,16/06/2021,10996052017,1099605
3560,23/06/2021,4173,44,3525,35,648,18/06/2021,"Chateau Margaux Premier Cru Classe, Margaux",Bordeaux,2007,24/06/2021,10127812007,1012781
3720,23/06/2021,4311,146,3480,240,831,17/06/2021,"Chateau Margaux Premier Cru Classe, Margaux",Bordeaux,2014,24/06/2021,10127812014,1012781
3740,15/06/2021,3977,53,3520,220,457,07/04/2021,"Chateau Margaux Premier Cru Classe, Margaux",Bordeaux,2013,16/06/2021,10127812013,1012781
1083,02/06/2021,1162,58,1036,47,126,27/05/2021,"Chateau Calon Segur 3eme Cru Classe, Saint-Estephe",Bordeaux,2016,16/06/2021,10074752016,1007475
503,02/06/2021,530,35,312,191,218,12/03/2021,"Chateau Batailley 5eme Cru Classe, Pauillac",Bordeaux,2015,03/06/2021,10063222015,1006322
3900,15/06/2021,4616,93,3861,39,755,28/05/2021,"Chateau Margaux Premier Cru Classe, Margaux",Bordeaux,2006,16/06/2021,10127812006,1012781
2750,04/06/2021,2920,9,2500,250,420,12/04/2021,"Chateau Angelus Premier Grand Cru Classe B, Saint-Emilion Grand Cru",Bordeaux,2007,05/06/2021,10060452007,1006045
2750,04/06/2021,2920,9,2500,250,420,12/04/2021,"Chateau Angelus Premier Grand Cru Classe B, Saint-Emilion Grand Cru",Bordeaux,2007,05/06/2021,10060452007,1006045
10500,23/06/2021,11933,53,9800,700,2133,11/06/2021,"Chateau Margaux Premier Cru Classe, Margaux",Bordeaux,2015,25/06/2021,10127812015,1012781
740,17/06/2021,1001,34,790,-50,211,01/06/2020,"Chateau Calon Segur 3eme Cru Classe, Saint-Estephe",Bordeaux,2011,25/06/2021,10074752011,1007475
2750,02/06/2021,2921,8,2500,250,421,12/04/2021,"Chateau Angelus Premier Grand Cru Classe B, Saint-Emilion Grand Cru",Bordeaux,2007,03/06/2021,10060452007,1006045
3826,24/06/2021,4499,55,4116,-290,383,25/02/2021,"Chateau Margaux Premier Cru Classe, Margaux",Bordeaux,2004,25/06/2021,10127812004,1012781
1000,24/06/2021,1157,92,988,12,169,28/05/2021,"Chateau Calon Segur 3eme Cru Classe, Saint-Estephe",Bordeaux,2005,25/06/2021,10074752005,1007475
2750,02/06/2021,2920,9,2500,250,420,12/04/2021,"Chateau Angelus Premier Grand Cru Classe B, Saint-Emilion Grand Cru",Bordeaux,2007,04/06/2021,10060452007,1006045
4850,18/06/2021,5654,29,4650,200,1004,21/06/2021,"Chateau Margaux Premier Cru Classe, Margaux",Bordeaux,2003,24/06/2021,10127812003,1012781
2750,02/06/2021,2920,9,2500,250,420,12/04/2021,"Chateau Angelus Premier Grand Cru Classe B, Saint-Emilion Grand Cru",Bordeaux,2007,04/06/2021,10060452007,1006045
880,17/06/2021,989,9,781,99,208,16/11/2020,"Chateau Calon Segur 3eme Cru Classe, Saint-Estephe",Bordeaux,2008,25/06/2021,10074752008,1007475
2500,24/06/2021,2636,2,2220,280,416,14/06/2021,"Gaja, Barbaresco",Piedmont,2001,25/06/2021,10996052001,1099605
2750,02/06/2021,2921,8,2500,250,421,12/04/2021,"Chateau Angelus Premier Grand Cru Classe B, Saint-Emilion Grand Cru",Bordeaux,2007,03/06/2021,10060452007,1006045
5600,28/07/2021,5876,96,5254,346,622,26/05/2021,"Chateau Margaux Premier Cru Classe, Margaux",Bordeaux,2018,29/07/2021,10127812018,1012781
1028,23/07/2021,1231,46,1058,-30,173,14/07/2021,"Chateau Calon Segur 3eme Cru Classe, Saint-Estephe",Bordeaux,2018,29/07/2021,10074752018,1007475
900,23/07/2021,989,100,864,36,125,26/07/2021,"Tignanello, Toscana",Tuscany,2017,29/07/2021,10953912017,1095391
9378,27/07/2021,8654,4,7330,2048,1324,02/06/2021,"Domaine Leflaive, Chevalier-Montrachet Grand Cru",Burgundy,2018,29/07/2021,10734012018,1073401
2098,24/06/2021,2300,4,2190,-92,110,01/05/2021,"Gaja, Barbaresco",Piedmont,2004,25/06/2021,10996052004,1099605
6400,24/06/2021,7446,55,5950,450,1496,23/06/2021,"Chateau Margaux Premier Cru Classe, Margaux",Bordeaux,2010,25/06/2021,10127812010,1012781
2750,01/06/2021,2921,8,2500,250,421,12/04/2021,"Chateau Angelus Premier Grand Cru Classe B, Saint-Emilion Grand Cru",Bordeaux,2007,02/06/2021,10060452007,1006045
2750,01/06/2021,2921,8,2500,250,421,12/04/2021,"Chateau Angelus Premier Grand Cru Classe B, Saint-Emilion Grand Cru",Bordeaux,2007,02/06/2021,10060452007,1006045
2750,31/05/2021,2921,8,2500,250,421,12/04/2021,"Chateau Angelus Premier Grand Cru Classe B, Saint-Emilion Grand Cru",Bordeaux,2007,01/06/2021,10060452007,1006045
6830,23/06/2021,7715,50,7086,-256,629,11/06/2021,"Chateau Margaux Premier Cru Classe, Margaux",Bordeaux,2009,25/06/2021,10127812009,1012781
3900,24/06/2021,4264,77,3700,200,564,07/06/2021,"Chateau Margaux Premier Cru Classe, Margaux",Bordeaux,2008,25/06/2021,10127812008,1012781
3900,24/06/2021,4629,95,3822,78,807,20/06/2021,"Chateau Margaux Premier Cru Classe, Margaux",Bordeaux,2006,25/06/2021,10127812006,1012781
3740,24/06/2021,4028,62,3520,220,508,07/04/2021,"Chateau Margaux Premier Cru Classe, Margaux",Bordeaux,2013,25/06/2021,10127812013,1012781
1020,11/05/2021,1170,78,975,45,195,12/04/2021,"Chateau Calon Segur 3eme Cru Classe, Saint-Estephe",Bordeaux,2005,12/05/2021,10074752005,1007475
3850,11/05/2021,4163,43,3560,290,603,20/11/2020,"Chateau Margaux Premier Cru Classe, Margaux",Bordeaux,2012,12/05/2021,10127812012,1012781
995,11/05/2021,1122,18,1000,-5,122,12/04/2021,"Chateau Calon Segur 3eme Cru Classe, Saint-Estephe",Bordeaux,2010,12/05/2021,10074752010,1007475
1050,11/05/2021,1348,40,940,110,408,18/03/2021,"Chateau Calon Segur 3eme Cru Classe, Saint-Estephe",Bordeaux,2000,12/05/2021,10074752000,1007475
476,02/06/2021,529,45,364,112,165,12/05/2021,"Chateau Batailley 5eme Cru Classe, Pauillac",Bordeaux,2016,03/06/2021,10063222016,1006322
870,24/06/2021,955,4,705,165,250,01/02/2021,"Chateau Calon Segur 3eme Cru Classe, Saint-Estephe",Bordeaux,2002,25/06/2021,10074752002,1007475
1008,28/07/2021,1158,92,998,10,160,28/07/2021,"Tignanello, Toscana",Tuscany,2018,29/07/2021,10953912018,1095391
880,03/06/2021,975,11,781,99,194,16/11/2020,"Chateau Calon Segur 3eme Cru Classe, Saint-Estephe",Bordeaux,2008,14/06/2021,10074752008,1007475
3750,24/06/2021,4219,40,3560,190,659,20/11/2020,"Chateau Margaux Premier Cru Classe, Margaux",Bordeaux,2012,25/06/2021,10127812012,1012781
2750,31/05/2021,2921,8,2500,250,421,12/04/2021,"Chateau Angelus Premier Grand Cru Classe B, Saint-Emilion Grand Cru",Bordeaux,2007,01/06/2021,10060452007,1006045
920,28/07/2021,1036,39,842,78,194,22/08/2020,"Chateau Calon Segur 3eme Cru Classe, Saint-Estephe",Bordeaux,2019,29/07/2021,10074752019,1007475
5290,26/07/2021,5275,7,4160,1130,1115,19/03/2021,"Chateau Margaux Premier Cru Classe, Margaux",Bordeaux,2019,29/07/2021,10127812019,1012781
950,11/05/2021,1014,61,863,87,151,10/05/2021,"Chateau Calon Segur 3eme Cru Classe, Saint-Estephe",Bordeaux,2006,12/05/2021,10074752006,1007475
4800,10/05/2021,5717,28,4800,0,917,11/03/2021,"Chateau Margaux Premier Cru Classe, Margaux",Bordeaux,2003,12/05/2021,10127812003,1012781
1000,11/06/2021,1165,43,1030,-30,135,25/05/2021,"Chateau Calon Segur 3eme Cru Classe, Saint-Estephe",Bordeaux,2009,14/06/2021,10074752009,1007475
468,03/06/2021,582,2,465,3,117,04/05/2020,"Chateau Batailley 5eme Cru Classe, Pauillac",Bordeaux,2001,04/06/2021,10063222001,1006322
1310,11/06/2021,1398,6,1172,138,226,07/04/2021,"Tignanello, Toscana",Tuscany,2010,14/06/2021,10953912010,1095391
830,03/06/2021,987,5,735,95,252,09/09/2020,"Chateau Calon Segur 3eme Cru Classe, Saint-Estephe",Bordeaux,2012,14/06/2021,10074752012,1007475
950,23/06/2021,1272,13,850,100,422,28/01/2021,"Tignanello, Toscana",Tuscany,2012,25/06/2021,10953912012,1095391
6750,11/05/2021,7939,81,6412,338,1527,25/03/2021,"Chateau Margaux Premier Cru Classe, Margaux",Bordeaux,2009,12/05/2021,10127812009,1012781
3827,11/05/2021,4512,71,4116,-289,396,25/02/2021,"Chateau Margaux Premier Cru Classe, Margaux",Bordeaux,2004,12/05/2021,10127812004,1012781
2750,28/05/2021,2921,8,2500,250,421,12/04/2021,"Chateau Angelus Premier Grand Cru Classe B, Saint-Emilion Grand Cru",Bordeaux,2007,29/05/2021,10060452007,1006045
2750,28/05/2021,2921,8,2500,250,421,12/04/2021,"Chateau Angelus Premier Grand Cru Classe B, Saint-Emilion Grand Cru",Bordeaux,2007,29/05/2021,10060452007,1006045
780,11/05/2021,836,6,682,98,154,15/09/2020,"Chateau Calon Segur 3eme Cru Classe, Saint-Estephe",Bordeaux,2013,12/05/2021,10074752013,1007475
768,07/05/2021,902,9,705,63,197,01/02/2021,"Chateau Calon Segur 3eme Cru Classe, Saint-Estephe",Bordeaux,2002,12/05/2021,10074752002,1007475
2750,27/05/2021,2921,8,2500,250,421,12/04/2021,"Chateau Angelus Premier Grand Cru Classe B, Saint-Emilion Grand Cru",Bordeaux,2007,28/05/2021,10060452007,1006045
6400,29/06/2021,7230,26,6776,-376,454,10/06/2021,"Chateau Margaux Premier Cru Classe, Margaux",Bordeaux,2005,30/06/2021,10127812005,1012781
2750,27/05/2021,2921,8,2500,250,421,12/04/2021,"Chateau Angelus Premier Grand Cru Classe B, Saint-Emilion Grand Cru",Bordeaux,2007,28/05/2021,10060452007,1006045
3920,11/05/2021,4451,91,3880,40,571,22/03/2021,"Chateau Margaux Premier Cru Classe, Margaux",Bordeaux,2008,12/05/2021,10127812008,1012781
2750,26/05/2021,2921,8,2500,250,421,12/04/2021,"Chateau Angelus Premier Grand Cru Classe B, Saint-Emilion Grand Cru",Bordeaux,2007,27/05/2021,10060452007,1006045
1000,11/05/2021,1057,9,860,140,197,08/03/2021,"Tignanello, Toscana",Tuscany,2011,12/05/2021,10953912011,1095391
2750,26/05/2021,2921,8,2500,250,421,12/04/2021,"Chateau Angelus Premier Grand Cru Classe B, Saint-Emilion Grand Cru",Bordeaux,2007,27/05/2021,10060452007,1006045
990,11/06/2021,1109,20,1000,-10,109,12/04/2021,"Chateau Calon Segur 3eme Cru Classe, Saint-Estephe",Bordeaux,2010,14/06/2021,10074752010,1007475
10100,11/06/2021,11970,52,9800,300,2170,11/06/2021,"Chateau Margaux Premier Cru Classe, Margaux",Bordeaux,2015,14/06/2021,10127812015,1012781
3900,11/06/2021,4616,93,3861,39,755,28/05/2021,"Chateau Margaux Premier Cru Classe, Margaux",Bordeaux,2006,14/06/2021,10127812006,1012781
420,03/06/2021,430,3,220,200,210,17/06/2015,"Chateau Batailley 5eme Cru Classe, Pauillac",Bordeaux,2002,09/06/2021,10063222002,1006322
4386,02/06/2021,4709,27,4400,-14,309,29/09/2020,"Chateau Margaux Premier Cru Classe, Margaux",Bordeaux,2001,14/06/2021,10127812001,1012781
6250,11/05/2021,7040,47,6116,134,924,07/05/2021,"Chateau Margaux Premier Cru Classe, Margaux",Bordeaux,2005,12/05/2021,10127812005,1012781
3800,11/05/2021,4374,128,3690,110,684,13/04/2021,"Chateau Margaux Premier Cru Classe, Margaux",Bordeaux,2011,12/05/2021,10127812011,1012781
2260,11/05/2021,2305,4,2190,70,115,01/05/2021,"Gaja, Barbaresco",Piedmont,2004,12/05/2021,10996052004,1099605
525,03/06/2021,542,3,420,105,122,09/07/2019,"Chateau Batailley 5eme Cru Classe, Pauillac",Bordeaux,2003,04/06/2021,10063222003,1006322
8040,11/05/2021,8232,20,7950,90,282,12/03/2021,"Chateau Margaux Premier Cru Classe, Margaux",Bordeaux,2000,12/05/2021,10127812000,1012781
1280,11/05/2021,1227,12,1172,108,55,07/04/2021,"Tignanello, Toscana",Tuscany,2010,12/05/2021,10953912010,1095391
2750,25/05/2021,2921,8,2500,250,421,12/04/2021,"Chateau Angelus Premier Grand Cru Classe B, Saint-Emilion Grand Cru",Bordeaux,2007,26/05/2021,10060452007,1006045
6400,22/06/2021,7416,42,6776,-376,640,10/06/2021,"Chateau Margaux Premier Cru Classe, Margaux",Bordeaux,2005,25/06/2021,10127812005,1012781
1024,09/06/2021,1240,7,1072,-48,168,20/01/2021,"Tignanello, Toscana",Tuscany,2009,15/06/2021,10953912009,1095391
3860,10/05/2021,4791,77,3800,60,991,07/04/2021,"Chateau Margaux Premier Cru Classe, Margaux",Bordeaux,2006,12/05/2021,10127812006,1012781
850,11/05/2021,1098,97,860,-10,238,19/04/2021,"Chateau Calon Segur 3eme Cru Classe, Saint-Estephe",Bordeaux,2015,12/05/2021,10074752015,1007475
2750,25/05/2021,2921,8,2500,250,421,12/04/2021,"Chateau Angelus Premier Grand Cru Classe B, Saint-Emilion Grand Cru",Bordeaux,2007,26/05/2021,10060452007,1006045
2750,24/05/2021,2921,8,2500,250,421,12/04/2021,"Chateau Angelus Premier Grand Cru Classe B, Saint-Emilion Grand Cru",Bordeaux,2007,25/05/2021,10060452007,1006045
2750,24/05/2021,2921,8,2500,250,421,12/04/2021,"Chateau Angelus Premier Grand Cru Classe B, Saint-Emilion Grand Cru",Bordeaux,2007,25/05/2021,10060452007,1006045
500,03/06/2021,520,2,300,200,220,15/12/2019,"Chateau Batailley 5eme Cru Classe, Pauillac",Bordeaux,2004,04/06/2021,10063222004,1006322
1100,11/05/2021,1536,7,1010,90,526,18/12/2020,"Tignanello, Toscana",Tuscany,2008,12/05/2021,10953912008,1095391
3740,11/05/2021,3962,48,3520,220,442,07/04/2021,"Chateau Margaux Premier Cru Classe, Margaux",Bordeaux,2013,12/05/2021,10127812013,1012781
830,04/05/2021,982,4,735,95,247,09/09/2020,"Chateau Calon Segur 3eme Cru Classe, Saint-Estephe",Bordeaux,2012,12/05/2021,10074752012,1007475
2750,21/05/2021,2914,9,2500,250,414,12/04/2021,"Chateau Angelus Premier Grand Cru Classe B, Saint-Emilion Grand Cru",Bordeaux,2007,22/05/2021,10060452007,1006045
450,03/06/2021,450,1,340,110,110,31/08/2018,"Chateau Batailley 5eme Cru Classe, Pauillac",Bordeaux,2007,04/06/2021,10063222007,1006322
880,11/05/2021,943,10,725,155,218,13/04/2021,"Chateau Calon Segur 3eme Cru Classe, Saint-Estephe",Bordeaux,2007,12/05/2021,10074752007,1007475
4400,11/05/2021,4857,32,4400,0,457,29/09/2020,"Chateau Margaux Premier Cru Classe, Margaux",Bordeaux,2001,12/05/2021,10127812001,1012781
400,03/06/2021,451,8,332,68,119,06/10/2020,"Chateau Batailley 5eme Cru Classe, Pauillac",Bordeaux,2008,15/06/2021,10063222008,1006322
2750,21/05/2021,2914,9,2500,250,414,12/04/2021,"Chateau Angelus Premier Grand Cru Classe B, Saint-Emilion Grand Cru",Bordeaux,2007,22/05/2021,10060452007,1006045
2750,20/05/2021,2914,9,2500,250,414,12/04/2021,"Chateau Angelus Premier Grand Cru Classe B, Saint-Emilion Grand Cru",Bordeaux,2007,21/05/2021,10060452007,1006045
3900,10/05/2021,4520,33,3684,216,836,10/06/2020,"Chateau Margaux Premier Cru Classe, Margaux",Bordeaux,2002,12/05/2021,10127812002,1012781
2750,20/05/2021,2914,9,2500,250,414,12/04/2021,"Chateau Angelus Premier Grand Cru Classe B, Saint-Emilion Grand Cru",Bordeaux,2007,21/05/2021,10060452007,1006045
6250,11/05/2021,7445,56,5922,328,1523,13/04/2021,"Chateau Margaux Premier Cru Classe, Margaux",Bordeaux,2010,12/05/2021,10127812010,1012781
2750,19/05/2021,2914,9,2500,250,414,12/04/2021,"Chateau Angelus Premier Grand Cru Classe B, Saint-Emilion Grand Cru",Bordeaux,2007,20/05/2021,10060452007,1006045
3800,11/05/2021,4083,53,3480,320,603,10/04/2021,"Chateau Margaux Premier Cru Classe, Margaux",Bordeaux,2014,12/05/2021,10127812014,1012781
2750,19/05/2021,2914,9,2500,250,414,12/04/2021,"Chateau Angelus Premier Grand Cru Classe B, Saint-Emilion Grand Cru",Bordeaux,2007,20/05/2021,10060452007,1006045
900,11/05/2021,1177,14,850,50,327,28/01/2021,"Tignanello, Toscana",Tuscany,2012,12/05/2021,10953912012,1095391
3702,04/05/2021,3662,2,1200,2502,2462,16/05/2012,"Gaja, Barbaresco",Piedmont,2001,12/05/2021,10996052001,1099605
2750,18/05/2021,2800,5,2500,250,300,12/04/2021,"Chateau Angelus Premier Grand Cru Classe B, Saint-Emilion Grand Cru",Bordeaux,2007,19/05/2021,10060452007,1006045
400,03/06/2021,431,9,332,68,99,06/10/2020,"Chateau Batailley 5eme Cru Classe, Pauillac",Bordeaux,2008,04/06/2021,10063222008,1006322
400,03/06/2021,441,10,332,68,109,06/10/2020,"Chateau Batailley 5eme Cru Classe, Pauillac",Bordeaux,2008,05/06/2021,10063222008,1006322
2750,18/05/2021,2800,5,2500,250,300,12/04/2021,"Chateau Angelus Premier Grand Cru Classe B, Saint-Emilion Grand Cru",Bordeaux,2007,19/05/2021,10060452007,1006045
900,25/06/2021,1054,22,800,100,254,21/11/2019,"Chateau Calon Segur 3eme Cru Classe, Saint-Estephe",Bordeaux,2003,26/06/2021,10074752003,1007475
1480,26/07/2021,1615,78,1398,82,217,01/07/2021,"Gaja, Barbaresco",Piedmont,2017,29/07/2021,10996052017,1099605
1624,28/07/2021,1731,18,1598,26,133,26/07/2021,"Gaja, Barbaresco",Piedmont,2018,29/07/2021,10996052018,1099605
490,03/06/2021,572,25,450,40,122,25/05/2021,"Chateau Batailley 5eme Cru Classe, Pauillac",Bordeaux,2009,04/06/2021,10063222009,1006322
2750,17/05/2021,2800,5,2500,250,300,12/04/2021,"Chateau Angelus Premier Grand Cru Classe B, Saint-Emilion Grand Cru",Bordeaux,2007,18/05/2021,10060452007,1006045
10500,11/05/2021,12398,74,9844,656,2554,29/03/2021,"Chateau Margaux Premier Cru Classe, Margaux",Bordeaux,2015,12/05/2021,10127812015,1012781
490,03/06/2021,572,25,450,40,122,25/05/2021,"Chateau Batailley 5eme Cru Classe, Pauillac",Bordeaux,2009,04/06/2021,10063222009,1006322
750,14/05/2021,1013,35,790,-40,223,01/06/2020,"Chateau Calon Segur 3eme Cru Classe, Saint-Estephe",Bordeaux,2011,15/05/2021,10074752011,1007475
1120,13/05/2021,1274,9,1172,-52,102,07/04/2021,"Tignanello, Toscana",Tuscany,2010,15/05/2021,10953912010,1095391
1010,14/05/2021,1048,9,860,150,188,08/03/2021,"Tignanello, Toscana",Tuscany,2011,15/05/2021,10953912011,1095391
3900,14/05/2021,4520,33,3684,216,836,10/06/2020,"Chateau Margaux Premier Cru Classe, Margaux",Bordeaux,2002,15/05/2021,10127812002,1012781
3950,14/05/2021,4455,88,3800,150,655,12/05/2021,"Chateau Margaux Premier Cru Classe, Margaux",Bordeaux,2008,15/05/2021,10127812008,1012781
8040,14/05/2021,8232,20,7950,90,282,12/03/2021,"Chateau Margaux Premier Cru Classe, Margaux",Bordeaux,2000,15/05/2021,10127812000,1012781
6300,14/05/2021,7484,52,5922,378,1562,13/04/2021,"Chateau Margaux Premier Cru Classe, Margaux",Bordeaux,2010,15/05/2021,10127812010,1012781
1000,14/05/2021,1167,79,975,25,192,12/04/2021,"Chateau Calon Segur 3eme Cru Classe, Saint-Estephe",Bordeaux,2005,15/05/2021,10074752005,1007475
6650,14/05/2021,7942,75,6500,150,1442,12/05/2021,"Chateau Margaux Premier Cru Classe, Margaux",Bordeaux,2009,15/05/2021,10127812009,1012781
1100,14/05/2021,1536,7,1010,90,526,18/12/2020,"Tignanello, Toscana",Tuscany,2008,15/05/2021,10953912008,1095391
6250,14/05/2021,6937,42,6116,134,821,07/05/2021,"Chateau Margaux Premier Cru Classe, Margaux",Bordeaux,2005,15/05/2021,10127812005,1012781
2750,17/05/2021,2800,5,2500,250,300,12/04/2021,"Chateau Angelus Premier Grand Cru Classe B, Saint-Emilion Grand Cru",Bordeaux,2007,18/05/2021,10060452007,1006045
900,14/05/2021,1057,23,800,100,257,21/11/2019,"Chateau Calon Segur 3eme Cru Classe, Saint-Estephe",Bordeaux,2003,15/05/2021,10074752003,1007475
500,03/06/2021,595,402,494,6,101,20/04/2021,"Chateau Batailley 5eme Cru Classe, Pauillac",Bordeaux,2010,15/06/2021,10063222010,1006322
10500,14/05/2021,12426,73,9844,656,2582,29/03/2021,"Chateau Margaux Premier Cru Classe, Margaux",Bordeaux,2015,15/05/2021,10127812015,1012781
768,14/05/2021,902,9,705,63,197,01/02/2021,"Chateau Calon Segur 3eme Cru Classe, Saint-Estephe",Bordeaux,2002,15/05/2021,10074752002,1007475
900,14/05/2021,1177,14,850,50,327,28/01/2021,"Tignanello, Toscana",Tuscany,2012,15/05/2021,10953912012,1095391
950,14/05/2021,1014,61,863,87,151,10/05/2021,"Chateau Calon Segur 3eme Cru Classe, Saint-Estephe",Bordeaux,2006,15/05/2021,10074752006,1007475
3827,14/05/2021,4532,68,4116,-289,416,25/02/2021,"Chateau Margaux Premier Cru Classe, Margaux",Bordeaux,2004,15/05/2021,10127812004,1012781
2750,14/05/2021,2800,5,2500,250,300,12/04/2021,"Chateau Angelus Premier Grand Cru Classe B, Saint-Emilion Grand Cru",Bordeaux,2007,15/05/2021,10060452007,1006045
4400,14/05/2021,4882,29,4400,0,482,29/09/2020,"Chateau Margaux Premier Cru Classe, Margaux",Bordeaux,2001,15/05/2021,10127812001,1012781
2750,14/05/2021,2800,5,2500,250,300,12/04/2021,"Chateau Angelus Premier Grand Cru Classe B, Saint-Emilion Grand Cru",Bordeaux,2007,15/05/2021,10060452007,1006045
2750,13/05/2021,2800,5,2500,250,300,12/04/2021,"Chateau Angelus Premier Grand Cru Classe B, Saint-Emilion Grand Cru",Bordeaux,2007,14/05/2021,10060452007,1006045
850,14/05/2021,1098,97,860,-10,238,19/04/2021,"Chateau Calon Segur 3eme Cru Classe, Saint-Estephe",Bordeaux,2015,15/05/2021,10074752015,1007475
3850,14/05/2021,4163,43,3560,290,603,20/11/2020,"Chateau Margaux Premier Cru Classe, Margaux",Bordeaux,2012,15/05/2021,10127812012,1012781
2750,13/05/2021,2800,5,2500,250,300,12/04/2021,"Chateau Angelus Premier Grand Cru Classe B, Saint-Emilion Grand Cru",Bordeaux,2007,14/05/2021,10060452007,1006045
1000,14/05/2021,1237,17,1047,-47,190,27/04/2021,"Chateau Calon Segur 3eme Cru Classe, Saint-Estephe",Bordeaux,2009,15/05/2021,10074752009,1007475
4800,12/05/2021,5741,26,4800,0,941,11/03/2021,"Chateau Margaux Premier Cru Classe, Margaux",Bordeaux,2003,15/05/2021,10127812003,1012781
1024,28/06/2021,1255,4,1072,-48,183,20/01/2021,"Tignanello, Toscana",Tuscany,2009,29/06/2021,10953912009,1095391
1000,28/06/2021,1157,92,988,12,169,28/05/2021,"Chateau Calon Segur 3eme Cru Classe, Saint-Estephe",Bordeaux,2005,29/06/2021,10074752005,1007475
500,03/06/2021,595,402,494,6,101,20/04/2021,"Chateau Batailley 5eme Cru Classe, Pauillac",Bordeaux,2010,15/06/2021,10063222010,1006322
1000,04/05/2021,1202,12,860,140,342,08/03/2021,"Tignanello, Toscana",Tuscany,2013,15/05/2021,10953912013,1095391
870,28/06/2021,954,4,705,165,249,01/02/2021,"Chateau Calon Segur 3eme Cru Classe, Saint-Estephe",Bordeaux,2002,29/06/2021,10074752002,1007475
2750,12/05/2021,2800,5,2500,250,300,12/04/2021,"Chateau Angelus Premier Grand Cru Classe B, Saint-Emilion Grand Cru",Bordeaux,2007,13/05/2021,10060452007,1006045
400,03/06/2021,436,9,355,45,81,15/04/2021,"Chateau Batailley 5eme Cru Classe, Pauillac",Bordeaux,2012,04/06/2021,10063222012,1006322
2750,12/05/2021,2800,5,2500,250,300,12/04/2021,"Chateau Angelus Premier Grand Cru Classe B, Saint-Emilion Grand Cru",Bordeaux,2007,13/05/2021,10060452007,1006045
2750,11/05/2021,2800,5,2500,250,300,12/04/2021,"Chateau Angelus Premier Grand Cru Classe B, Saint-Emilion Grand Cru",Bordeaux,2007,12/05/2021,10060452007,1006045
950,28/06/2021,1019,52,863,87,156,10/05/2021,"Chateau Calon Segur 3eme Cru Classe, Saint-Estephe",Bordeaux,2006,29/06/2021,10074752006,1007475
2750,11/05/2021,2800,5,2500,250,300,12/04/2021,"Chateau Angelus Premier Grand Cru Classe B, Saint-Emilion Grand Cru",Bordeaux,2007,12/05/2021,10060452007,1006045
880,17/06/2021,980,10,781,99,199,16/11/2020,"Chateau Calon Segur 3eme Cru Classe, Saint-Estephe",Bordeaux,2008,29/06/2021,10074752008,1007475
900,28/06/2021,1055,23,800,100,255,21/11/2019,"Chateau Calon Segur 3eme Cru Classe, Saint-Estephe",Bordeaux,2003,29/06/2021,10074752003,1007475
1300,13/05/2021,1327,4,1200,100,127,06/03/2021,"Tignanello, Toscana",Tuscany,2007,15/05/2021,10953912007,1095391
3800,14/05/2021,4070,50,3480,320,590,10/04/2021,"Chateau Margaux Premier Cru Classe, Margaux",Bordeaux,2014,15/05/2021,10127812014,1012781
3900,28/06/2021,4260,78,3750,150,510,28/06/2021,"Chateau Margaux Premier Cru Classe, Margaux",Bordeaux,2008,29/06/2021,10127812008,1012781
2750,10/05/2021,2800,5,2500,250,300,12/04/2021,"Chateau Angelus Premier Grand Cru Classe B, Saint-Emilion Grand Cru",Bordeaux,2007,11/05/2021,10060452007,1006045
3740,14/05/2021,3962,48,3520,220,442,07/04/2021,"Chateau Margaux Premier Cru Classe, Margaux",Bordeaux,2013,15/05/2021,10127812013,1012781
995,14/05/2021,1116,19,1000,-5,116,12/04/2021,"Chateau Calon Segur 3eme Cru Classe, Saint-Estephe",Bordeaux,2010,15/05/2021,10074752010,1007475
2750,10/05/2021,2800,5,2500,250,300,12/04/2021,"Chateau Angelus Premier Grand Cru Classe B, Saint-Emilion Grand Cru",Bordeaux,2007,11/05/2021,10060452007,1006045
3560,28/06/2021,4183,39,3525,35,658,18/06/2021,"Chateau Margaux Premier Cru Classe, Margaux",Bordeaux,2007,29/06/2021,10127812007,1012781
2098,28/06/2021,2300,4,2190,-92,110,01/05/2021,"Gaja, Barbaresco",Piedmont,2004,29/06/2021,10996052004,1099605
2750,07/05/2021,2800,5,2500,250,300,12/04/2021,"Chateau Angelus Premier Grand Cru Classe B, Saint-Emilion Grand Cru",Bordeaux,2007,10/05/2021,10060452007,1006045
400,03/06/2021,436,9,355,45,81,15/04/2021,"Chateau Batailley 5eme Cru Classe, Pauillac",Bordeaux,2012,04/06/2021,10063222012,1006322
3750,24/06/2021,4198,39,3560,190,638,20/11/2020,"Chateau Margaux Premier Cru Classe, Margaux",Bordeaux,2012,29/06/2021,10127812012,1012781
3900,28/06/2021,4638,94,3822,78,816,20/06/2021,"Chateau Margaux Premier Cru Classe, Margaux",Bordeaux,2006,29/06/2021,10127812006,1012781
3900,28/06/2021,4495,25,3684,216,811,10/06/2020,"Chateau Margaux Premier Cru Classe, Margaux",Bordeaux,2002,29/06/2021,10127812002,1012781
907,28/06/2021,966,18,805,102,161,20/11/2019,"Chateau Calon Segur 3eme Cru Classe, Saint-Estephe",Bordeaux,2001,29/06/2021,10074752001,1007475
8100,28/06/2021,8362,12,8100,0,262,21/06/2021,"Chateau Margaux Premier Cru Classe, Margaux",Bordeaux,2000,29/06/2021,10127812000,1012781
1320,28/06/2021,1467,3,1170,150,297,24/06/2021,"Tignanello, Toscana",Tuscany,2010,29/06/2021,10953912010,1095391
3750,17/06/2021,4043,74,3690,60,353,13/04/2021,"Chateau Margaux Premier Cru Classe, Margaux",Bordeaux,2011,29/06/2021,10127812011,1012781
880,14/05/2021,967,9,725,155,242,13/04/2021,"Chateau Calon Segur 3eme Cru Classe, Saint-Estephe",Bordeaux,2007,15/05/2021,10074752007,1007475
990,28/06/2021,1116,15,990,0,126,16/06/2021,"Chateau Calon Segur 3eme Cru Classe, Saint-Estephe",Bordeaux,2010,29/06/2021,10074752010,1007475
2750,07/05/2021,2842,6,2500,250,342,12/04/2021,"Chateau Angelus Premier Grand Cru Classe B, Saint-Emilion Grand Cru",Bordeaux,2007,08/05/2021,10060452007,1006045
880,28/06/2021,967,9,725,155,242,13/04/2021,"Chateau Calon Segur 3eme Cru Classe, Saint-Estephe",Bordeaux,2007,29/06/2021,10074752007,1007475
1700,28/06/2021,1652,3,1378,322,274,29/07/2020,"Tignanello, Toscana",Tuscany,2001,29/06/2021,10953912001,1095391
2750,07/05/2021,2800,5,2500,250,300,12/04/2021,"Chateau Angelus Premier Grand Cru Classe B, Saint-Emilion Grand Cru",Bordeaux,2007,10/05/2021,10060452007,1006045
2750,07/05/2021,2842,6,2500,250,342,12/04/2021,"Chateau Angelus Premier Grand Cru Classe B, Saint-Emilion Grand Cru",Bordeaux,2007,08/05/2021,10060452007,1006045
1700,14/05/2021,1674,3,1378,322,296,29/07/2020,"Tignanello, Toscana",Tuscany,2001,15/05/2021,10953912001,1095391
3750,14/05/2021,4070,27,3592,158,478,06/05/2021,"Chateau Margaux Premier Cru Classe, Margaux",Bordeaux,2007,15/05/2021,10127812007,1012781
2750,06/05/2021,2842,6,2500,250,342,12/04/2021,"Chateau Angelus Premier Grand Cru Classe B, Saint-Emilion Grand Cru",Bordeaux,2007,07/05/2021,10060452007,1006045
1024,14/05/2021,1125,10,1072,-48,53,20/01/2021,"Tignanello, Toscana",Tuscany,2009,15/05/2021,10953912009,1095391
498,03/06/2021,530,35,312,186,218,12/03/2021,"Chateau Batailley 5eme Cru Classe, Pauillac",Bordeaux,2015,04/06/2021,10063222015,1006322
498,03/06/2021,534,30,312,186,222,12/03/2021,"Chateau Batailley 5eme Cru Classe, Pauillac",Bordeaux,2015,05/06/2021,10063222015,1006322
476,03/06/2021,529,45,364,112,165,12/05/2021,"Chateau Batailley 5eme Cru Classe, Pauillac",Bordeaux,2016,04/06/2021,10063222016,1006322
1408,28/06/2021,1389,4,1238,170,151,02/11/2020,"Tignanello, Toscana",Tuscany,2006,29/06/2021,10953912006,1095391
4850,25/06/2021,5881,19,4650,200,1231,21/06/2021,"Chateau Margaux Premier Cru Classe, Margaux",Bordeaux,2003,29/06/2021,10127812003,1012781
840,17/06/2021,1078,85,822,18,256,28/06/2021,"Chateau Calon Segur 3eme Cru Classe, Saint-Estephe",Bordeaux,2015,29/06/2021,10074752015,1007475
2750,06/05/2021,2842,6,2500,250,342,12/04/2021,"Chateau Angelus Premier Grand Cru Classe B, Saint-Emilion Grand Cru",Bordeaux,2007,07/05/2021,10060452007,1006045
2750,05/05/2021,2842,6,2500,250,342,12/04/2021,"Chateau Angelus Premier Grand Cru Classe B, Saint-Emilion Grand Cru",Bordeaux,2007,06/05/2021,10060452007,1006045
1000,14/05/2021,1170,78,975,25,195,12/04/2021,"Chateau Calon Segur 3eme Cru Classe, Saint-Estephe",Bordeaux,2005,17/05/2021,10074752005,1007475
10500,28/06/2021,11893,50,9800,700,2093,11/06/2021,"Chateau Margaux Premier Cru Classe, Margaux",Bordeaux,2015,29/06/2021,10127812015,1012781
6830,28/06/2021,7741,47,7086,-256,655,11/06/2021,"Chateau Margaux Premier Cru Classe, Margaux",Bordeaux,2009,29/06/2021,10127812009,1012781
950,28/06/2021,1272,13,850,100,422,28/01/2021,"Tignanello, Toscana",Tuscany,2012,29/06/2021,10953912012,1095391
3740,28/06/2021,4016,53,3520,220,496,07/04/2021,"Chateau Margaux Premier Cru Classe, Margaux",Bordeaux,2013,29/06/2021,10127812013,1012781
2750,05/05/2021,2842,6,2500,250,342,12/04/2021,"Chateau Angelus Premier Grand Cru Classe B, Saint-Emilion Grand Cru",Bordeaux,2007,06/05/2021,10060452007,1006045
6400,28/06/2021,7230,26,6776,-376,454,10/06/2021,"Chateau Margaux Premier Cru Classe, Margaux",Bordeaux,2005,29/06/2021,10127812005,1012781
3900,06/08/2021,4652,92,3822,78,830,20/06/2021,"Chateau Margaux Premier Cru Classe, Margaux",Bordeaux,2006,08/08/2021,10127812006,1012781
3950,06/08/2021,4466,103,3780,170,686,23/07/2021,"Chateau Margaux Premier Cru Classe, Margaux",Bordeaux,2008,08/08/2021,10127812008,1012781
6400,06/08/2021,7608,61,6188,212,1420,16/07/2021,"Chateau Margaux Premier Cru Classe, Margaux",Bordeaux,2010,08/08/2021,10127812010,1012781
3900,06/08/2021,4229,46,3690,210,539,13/04/2021,"Chateau Margaux Premier Cru Classe, Margaux",Bordeaux,2011,08/08/2021,10127812011,1012781
3702,19/05/2021,3684,2,1200,2502,2484,16/05/2012,"Gaja, Barbaresco",Piedmont,2001,20/05/2021,10996052001,1099605
3850,19/05/2021,4179,43,3560,290,619,20/11/2020,"Chateau Margaux Premier Cru Classe, Margaux",Bordeaux,2012,20/05/2021,10127812012,1012781
900,18/05/2021,1197,16,850,50,347,28/01/2021,"Tignanello, Toscana",Tuscany,2012,20/05/2021,10953912012,1095391
709,13/05/2021,837,11,682,27,155,15/09/2020,"Chateau Calon Segur 3eme Cru Classe, Saint-Estephe",Bordeaux,2013,20/05/2021,10074752013,1007475
3740,19/05/2021,3974,49,3520,220,454,07/04/2021,"Chateau Margaux Premier Cru Classe, Margaux",Bordeaux,2013,20/05/2021,10127812013,1012781
6650,18/05/2021,7639,41,6500,150,1139,12/05/2021,"Chateau Margaux Premier Cru Classe, Margaux",Bordeaux,2009,20/05/2021,10127812009,1012781
10500,19/05/2021,12484,70,9844,656,2640,29/03/2021,"Chateau Margaux Premier Cru Classe, Margaux",Bordeaux,2015,20/05/2021,10127812015,1012781
2750,04/05/2021,2842,6,2500,250,342,12/04/2021,"Chateau Angelus Premier Grand Cru Classe B, Saint-Emilion Grand Cru",Bordeaux,2007,05/05/2021,10060452007,1006045
1010,18/05/2021,1046,10,860,150,186,08/03/2021,"Tignanello, Toscana",Tuscany,2011,20/05/2021,10953912011,1095391
1100,19/05/2021,1531,7,1010,90,521,18/12/2020,"Tignanello, Toscana",Tuscany,2008,20/05/2021,10953912008,1095391
2750,04/05/2021,2842,6,2500,250,342,12/04/2021,"Chateau Angelus Premier Grand Cru Classe B, Saint-Emilion Grand Cru",Bordeaux,2007,05/05/2021,10060452007,1006045
900,19/05/2021,1092,30,800,100,292,21/11/2019,"Chateau Calon Segur 3eme Cru Classe, Saint-Estephe",Bordeaux,2003,20/05/2021,10074752003,1007475
950,19/05/2021,1003,61,863,87,140,10/05/2021,"Chateau Calon Segur 3eme Cru Classe, Saint-Estephe",Bordeaux,2006,20/05/2021,10074752006,1007475
2750,03/05/2021,2842,6,2500,250,342,12/04/2021,"Chateau Angelus Premier Grand Cru Classe B, Saint-Emilion Grand Cru",Bordeaux,2007,04/05/2021,10060452007,1006045
2750,03/05/2021,2842,6,2500,250,342,12/04/2021,"Chateau Angelus Premier Grand Cru Classe B, Saint-Emilion Grand Cru",Bordeaux,2007,04/05/2021,10060452007,1006045
4400,19/05/2021,4860,27,4400,0,460,29/09/2020,"Chateau Margaux Premier Cru Classe, Margaux",Bordeaux,2001,20/05/2021,10127812001,1012781
880,19/05/2021,986,13,725,155,261,13/04/2021,"Chateau Calon Segur 3eme Cru Classe, Saint-Estephe",Bordeaux,2007,20/05/2021,10074752007,1007475
840,14/05/2021,938,18,781,59,157,16/11/2020,"Chateau Calon Segur 3eme Cru Classe, Saint-Estephe",Bordeaux,2008,20/05/2021,10074752008,1007475
1050,18/05/2021,1194,23,940,110,254,18/03/2021,"Chateau Calon Segur 3eme Cru Classe, Saint-Estephe",Bordeaux,2000,20/05/2021,10074752000,1007475
2750,10/08/2021,3055,14,2505,245,550,28/07/2021,"Chateau Angelus Premier Grand Cru Classe B, Saint-Emilion Grand Cru",Bordeaux,2008,11/08/2021,10060452008,1006045
3860,19/05/2021,4751,72,3800,60,951,07/04/2021,"Chateau Margaux Premier Cru Classe, Margaux",Bordeaux,2006,20/05/2021,10127812006,1012781
1120,13/05/2021,1348,9,1172,-52,176,07/04/2021,"Tignanello, Toscana",Tuscany,2010,20/05/2021,10953912010,1095391
3827,19/05/2021,4484,63,4116,-289,368,25/02/2021,"Chateau Margaux Premier Cru Classe, Margaux",Bordeaux,2004,20/05/2021,10127812004,1012781
2750,10/08/2021,3055,14,2505,245,550,28/07/2021,"Chateau Angelus Premier Grand Cru Classe B, Saint-Emilion Grand Cru",Bordeaux,2008,11/08/2021,10060452008,1006045
1050,17/06/2021,1164,6,860,190,304,08/03/2021,"Tignanello, Toscana",Tuscany,2013,29/06/2021,10953912013,1095391
9600,19/05/2021,9718,3,8000,1600,1718,30/01/2020,"Domaine Leflaive, Chevalier-Montrachet Grand Cru",Burgundy,2014,20/05/2021,10734012014,1073401
408,03/06/2021,418,19,357,51,61,06/05/2021,"Chateau Batailley 5eme Cru Classe, Pauillac",Bordeaux,2018,04/06/2021,10063222018,1006322
1000,19/05/2021,1168,47,1047,-47,121,27/04/2021,"Chateau Calon Segur 3eme Cru Classe, Saint-Estephe",Bordeaux,2009,20/05/2021,10074752009,1007475
2750,09/08/2021,3055,14,2505,245,550,28/07/2021,"Chateau Angelus Premier Grand Cru Classe B, Saint-Emilion Grand Cru",Bordeaux,2008,10/08/2021,10060452008,1006045
2750,09/08/2021,3055,14,2505,245,550,28/07/2021,"Chateau Angelus Premier Grand Cru Classe B, Saint-Emilion Grand Cru",Bordeaux,2008,10/08/2021,10060452008,1006045
686,28/06/2021,826,7,682,4,144,15/09/2020,"Chateau Calon Segur 3eme Cru Classe, Saint-Estephe",Bordeaux,2013,29/06/2021,10074752013,1007475
3826,28/06/2021,4515,55,4116,-290,399,25/02/2021,"Chateau Margaux Premier Cru Classe, Margaux",Bordeaux,2004,29/06/2021,10127812004,1012781
1000,19/05/2021,1164,85,975,25,189,12/04/2021,"Chateau Calon Segur 3eme Cru Classe, Saint-Estephe",Bordeaux,2005,20/05/2021,10074752005,1007475
6400,28/06/2021,7579,50,5950,450,1629,23/06/2021,"Chateau Margaux Premier Cru Classe, Margaux",Bordeaux,2010,29/06/2021,10127812010,1012781
468,04/06/2021,565,3,465,3,100,04/05/2020,"Chateau Batailley 5eme Cru Classe, Pauillac",Bordeaux,2001,05/06/2021,10063222001,1006322
1024,19/05/2021,1132,12,1072,-48,60,20/01/2021,"Tignanello, Toscana",Tuscany,2009,20/05/2021,10953912009,1095391
1408,19/05/2021,1445,5,1238,170,207,02/11/2020,"Tignanello, Toscana",Tuscany,2006,20/05/2021,10953912006,1095391
790,18/05/2021,967,18,745,45,222,16/11/2020,"Chateau Calon Segur 3eme Cru Classe, Saint-Estephe",Bordeaux,2004,20/05/2021,10074752004,1007475
8040,19/05/2021,8372,22,7950,90,422,12/03/2021,"Chateau Margaux Premier Cru Classe, Margaux",Bordeaux,2000,20/05/2021,10127812000,1012781
3600,19/05/2021,4029,78,3690,-90,339,13/04/2021,"Chateau Margaux Premier Cru Classe, Margaux",Bordeaux,2011,20/05/2021,10127812011,1012781
3560,19/05/2021,4088,30,3592,-32,496,06/05/2021,"Chateau Margaux Premier Cru Classe, Margaux",Bordeaux,2007,20/05/2021,10127812007,1012781
1280,19/05/2021,1338,6,1200,80,138,06/03/2021,"Tignanello, Toscana",Tuscany,2007,20/05/2021,10953912007,1095391
6300,19/05/2021,7578,55,5922,378,1656,13/04/2021,"Chateau Margaux Premier Cru Classe, Margaux",Bordeaux,2010,20/05/2021,10127812010,1012781
950,18/05/2021,1096,42,830,120,266,18/04/2021,"Tignanello, Toscana",Tuscany,2014,20/05/2021,10953912014,1095391
750,19/05/2021,1025,48,790,-40,235,01/06/2020,"Chateau Calon Segur 3eme Cru Classe, Saint-Estephe",Bordeaux,2011,20/05/2021,10074752011,1007475
6250,19/05/2021,6998,40,6116,134,882,07/05/2021,"Chateau Margaux Premier Cru Classe, Margaux",Bordeaux,2005,20/05/2021,10127812005,1012781
3720,28/06/2021,4315,141,3480,240,835,17/06/2021,"Chateau Margaux Premier Cru Classe, Margaux",Bordeaux,2014,29/06/2021,10127812014,1012781
907,19/05/2021,1052,38,805,102,247,20/11/2019,"Chateau Calon Segur 3eme Cru Classe, Saint-Estephe",Bordeaux,2001,20/05/2021,10074752001,1007475
4400,17/06/2021,4688,22,4400,0,288,29/09/2020,"Chateau Margaux Premier Cru Classe, Margaux",Bordeaux,2001,29/06/2021,10127812001,1012781
870,29/06/2021,954,4,705,165,249,01/02/2021,"Chateau Calon Segur 3eme Cru Classe, Saint-Estephe",Bordeaux,2002,30/06/2021,10074752002,1007475
8100,28/06/2021,8354,14,8100,0,254,21/06/2021,"Chateau Margaux Premier Cru Classe, Margaux",Bordeaux,2000,30/06/2021,10127812000,1012781
4450,29/06/2021,4688,22,4400,50,288,29/09/2020,"Chateau Margaux Premier Cru Classe, Margaux",Bordeaux,2001,30/06/2021,10127812001,1012781
3826,29/06/2021,4495,57,4116,-290,379,25/02/2021,"Chateau Margaux Premier Cru Classe, Margaux",Bordeaux,2004,30/06/2021,10127812004,1012781
4850,13/05/2021,5822,27,4842,8,980,19/05/2021,"Chateau Margaux Premier Cru Classe, Margaux",Bordeaux,2003,20/05/2021,10127812003,1012781
995,19/05/2021,1119,24,1000,-5,119,12/04/2021,"Chateau Calon Segur 3eme Cru Classe, Saint-Estephe",Bordeaux,2010,20/05/2021,10074752010,1007475
2750,06/08/2021,3074,14,2505,245,569,28/07/2021,"Chateau Angelus Premier Grand Cru Classe B, Saint-Emilion Grand Cru",Bordeaux,2008,07/08/2021,10060452008,1006045
840,18/05/2021,1084,97,860,-20,224,19/04/2021,"Chateau Calon Segur 3eme Cru Classe, Saint-Estephe",Bordeaux,2015,20/05/2021,10074752015,1007475
450,04/06/2021,450,1,340,110,110,31/08/2018,"Chateau Batailley 5eme Cru Classe, Pauillac",Bordeaux,2007,05/06/2021,10063222007,1006322
2750,06/08/2021,3074,14,2505,245,569,28/07/2021,"Chateau Angelus Premier Grand Cru Classe B, Saint-Emilion Grand Cru",Bordeaux,2008,07/08/2021,10060452008,1006045
2232,19/05/2021,2335,5,2190,42,145,01/05/2021,"Gaja, Barbaresco",Piedmont,2004,20/05/2021,10996052004,1099605
3920,19/05/2021,4447,87,3800,120,647,12/05/2021,"Chateau Margaux Premier Cru Classe, Margaux",Bordeaux,2008,20/05/2021,10127812008,1012781
490,04/06/2021,570,26,450,40,120,25/05/2021,"Chateau Batailley 5eme Cru Classe, Pauillac",Bordeaux,2009,05/06/2021,10063222009,1006322
2750,05/08/2021,3074,14,2505,245,569,28/07/2021,"Chateau Angelus Premier Grand Cru Classe B, Saint-Emilion Grand Cru",Bordeaux,2008,06/08/2021,10060452008,1006045
2750,05/08/2021,3074,14,2505,245,569,28/07/2021,"Chateau Angelus Premier Grand Cru Classe B, Saint-Emilion Grand Cru",Bordeaux,2008,06/08/2021,10060452008,1006045
3900,19/05/2021,4527,29,3684,216,843,10/06/2020,"Chateau Margaux Premier Cru Classe, Margaux",Bordeaux,2002,20/05/2021,10127812002,1012781
3720,19/05/2021,4102,51,3480,240,622,10/04/2021,"Chateau Margaux Premier Cru Classe, Margaux",Bordeaux,2014,20/05/2021,10127812014,1012781
2750,04/08/2021,3074,14,2505,245,569,28/07/2021,"Chateau Angelus Premier Grand Cru Classe B, Saint-Emilion Grand Cru",Bordeaux,2008,05/08/2021,10060452008,1006045
1700,20/05/2021,1674,3,1378,322,296,29/07/2020,"Tignanello, Toscana",Tuscany,2001,21/05/2021,10953912001,1095391
2750,04/08/2021,3074,14,2505,245,569,28/07/2021,"Chateau Angelus Premier Grand Cru Classe B, Saint-Emilion Grand Cru",Bordeaux,2008,05/08/2021,10060452008,1006045
1280,20/05/2021,1355,8,1172,108,183,07/04/2021,"Tignanello, Toscana",Tuscany,2010,21/05/2021,10953912010,1095391
2710,02/08/2021,3096,13,2505,205,591,28/07/2021,"Chateau Angelus Premier Grand Cru Classe B, Saint-Emilion Grand Cru",Bordeaux,2008,03/08/2021,10060452008,1006045
900,29/06/2021,1017,53,863,37,154,10/05/2021,"Chateau Calon Segur 3eme Cru Classe, Saint-Estephe",Bordeaux,2006,30/06/2021,10074752006,1007475
3900,29/06/2021,4638,94,3822,78,816,20/06/2021,"Chateau Margaux Premier Cru Classe, Margaux",Bordeaux,2006,30/06/2021,10127812006,1012781
880,29/06/2021,967,9,725,155,242,13/04/2021,"Chateau Calon Segur 3eme Cru Classe, Saint-Estephe",Bordeaux,2007,30/06/2021,10074752007,1007475
2710,02/08/2021,3096,13,2505,205,591,28/07/2021,"Chateau Angelus Premier Grand Cru Classe B, Saint-Emilion Grand Cru",Bordeaux,2008,03/08/2021,10060452008,1006045
880,05/08/2021,967,9,725,155,242,13/04/2021,"Chateau Calon Segur 3eme Cru Classe, Saint-Estephe",Bordeaux,2007,06/08/2021,10074752007,1007475
2710,30/07/2021,3090,13,2505,205,585,28/07/2021,"Chateau Angelus Premier Grand Cru Classe B, Saint-Emilion Grand Cru",Bordeaux,2008,31/07/2021,10060452008,1006045
660,05/08/2021,727,5,390,270,337,18/08/2017,"Tua Rita, Giusto di Notri, Toscana",Tuscany,2006,06/08/2021,11058072006,1105807
490,04/06/2021,570,26,450,40,120,25/05/2021,"Chateau Batailley 5eme Cru Classe, Pauillac",Bordeaux,2009,05/06/2021,10063222009,1006322
900,04/08/2021,1099,25,800,100,299,21/11/2019,"Chateau Calon Segur 3eme Cru Classe, Saint-Estephe",Bordeaux,2003,06/08/2021,10074752003,1007475
1040,04/08/2021,1382,69,940,100,442,18/03/2021,"Chateau Calon Segur 3eme Cru Classe, Saint-Estephe",Bordeaux,2000,06/08/2021,10074752000,1007475
1008,05/08/2021,1165,78,998,10,167,28/07/2021,"Tignanello, Toscana",Tuscany,2018,06/08/2021,10953912018,1095391
2710,30/07/2021,3090,13,2505,205,585,28/07/2021,"Chateau Angelus Premier Grand Cru Classe B, Saint-Emilion Grand Cru",Bordeaux,2008,31/07/2021,10060452008,1006045
980,05/08/2021,1077,62,908,72,169,04/08/2021,"Tignanello, Toscana",Tuscany,2017,06/08/2021,10953912017,1095391
3750,05/08/2021,4325,54,3650,100,675,27/07/2021,"Chateau Margaux Premier Cru Classe, Margaux",Bordeaux,2012,06/08/2021,10127812012,1012781
1400,05/08/2021,1427,9,1360,40,67,18/07/2021,"Gaja, Barbaresco",Piedmont,2013,06/08/2021,10996052013,1099605
840,14/07/2021,977,16,745,95,232,16/11/2020,"Chateau Calon Segur 3eme Cru Classe, Saint-Estephe",Bordeaux,2004,15/07/2021,10074752004,1007475
2710,28/07/2021,3101,15,2505,205,596,28/07/2021,"Chateau Angelus Premier Grand Cru Classe B, Saint-Emilion Grand Cru",Bordeaux,2008,29/07/2021,10060452008,1006045
907,14/07/2021,926,18,805,102,121,20/11/2019,"Chateau Calon Segur 3eme Cru Classe, Saint-Estephe",Bordeaux,2001,15/07/2021,10074752001,1007475
490,04/06/2021,595,402,494,-4,101,20/04/2021,"Chateau Batailley 5eme Cru Classe, Pauillac",Bordeaux,2010,14/06/2021,10063222010,1006322
2710,28/07/2021,3113,14,2505,205,608,28/07/2021,"Chateau Angelus Premier Grand Cru Classe B, Saint-Emilion Grand Cru",Bordeaux,2008,30/07/2021,10060452008,1006045
490,04/06/2021,595,404,494,-4,101,20/04/2021,"Chateau Batailley 5eme Cru Classe, Pauillac",Bordeaux,2010,12/06/2021,10063222010,1006322
2710,28/07/2021,3101,15,2505,205,596,28/07/2021,"Chateau Angelus Premier Grand Cru Classe B, Saint-Emilion Grand Cru",Bordeaux,2008,29/07/2021,10060452008,1006045
6500,14/07/2021,7284,27,6776,-276,508,10/06/2021,"Chateau Margaux Premier Cru Classe, Margaux",Bordeaux,2005,15/07/2021,10127812005,1012781
2710,28/07/2021,3113,14,2505,205,608,28/07/2021,"Chateau Angelus Premier Grand Cru Classe B, Saint-Emilion Grand Cru",Bordeaux,2008,30/07/2021,10060452008,1006045
2710,26/07/2021,3101,15,2530,180,571,10/07/2021,"Chateau Angelus Premier Grand Cru Classe B, Saint-Emilion Grand Cru",Bordeaux,2008,28/07/2021,10060452008,1006045
1584,05/08/2021,1670,4,1378,206,292,29/07/2020,"Tignanello, Toscana",Tuscany,2001,06/08/2021,10953912001,1095391
2710,26/07/2021,3082,14,2530,180,552,10/07/2021,"Chateau Angelus Premier Grand Cru Classe B, Saint-Emilion Grand Cru",Bordeaux,2008,27/07/2021,10060452008,1006045
2710,26/07/2021,3082,14,2530,180,552,10/07/2021,"Chateau Angelus Premier Grand Cru Classe B, Saint-Emilion Grand Cru",Bordeaux,2008,27/07/2021,10060452008,1006045
3900,29/06/2021,4256,79,3750,150,506,28/06/2021,"Chateau Margaux Premier Cru Classe, Margaux",Bordeaux,2008,30/06/2021,10127812008,1012781
895,29/06/2021,980,10,781,114,199,16/11/2020,"Chateau Calon Segur 3eme Cru Classe, Saint-Estephe",Bordeaux,2008,30/06/2021,10074752008,1007475
6830,28/06/2021,7732,48,7086,-256,646,11/06/2021,"Chateau Margaux Premier Cru Classe, Margaux",Bordeaux,2009,30/06/2021,10127812009,1012781
1624,03/08/2021,1734,18,1663,-39,71,01/08/2021,"Gaja, Barbaresco",Piedmont,2018,03/08/2021,10996052018,1099605
11298,02/08/2021,10860,2,8000,3298,2860,30/01/2020,"Domaine Leflaive, Chevalier-Montrachet Grand Cru",Burgundy,2014,03/08/2021,10734012014,1073401
950,03/08/2021,1140,7,960,-10,180,27/07/2021,"Tignanello, Toscana",Tuscany,2013,03/08/2021,10953912013,1095391
520,05/08/2021,563,3,460,60,103,05/05/2020,"Tua Rita, Giusto di Notri, Toscana",Tuscany,2008,06/08/2021,11058072008,1105807
4450,05/08/2021,4739,16,4400,50,339,29/09/2020,"Chateau Margaux Premier Cru Classe, Margaux",Bordeaux,2001,06/08/2021,10127812001,1012781
866,05/08/2021,955,8,705,161,250,01/02/2021,"Chateau Calon Segur 3eme Cru Classe, Saint-Estephe",Bordeaux,2002,06/08/2021,10074752002,1007475
8252,05/08/2021,9889,3,7290,962,2599,21/08/2020,"Domaine Denis Mortet, Chambertin Grand Cru",Burgundy,2017,06/08/2021,10490202017,1049020
2710,26/07/2021,3101,15,2530,180,571,10/07/2021,"Chateau Angelus Premier Grand Cru Classe B, Saint-Emilion Grand Cru",Bordeaux,2008,28/07/2021,10060452008,1006045
1028,13/07/2021,1166,82,988,40,178,28/05/2021,"Chateau Calon Segur 3eme Cru Classe, Saint-Estephe",Bordeaux,2005,15/07/2021,10074752005,1007475
490,04/06/2021,595,404,494,-4,101,20/04/2021,"Chateau Batailley 5eme Cru Classe, Pauillac",Bordeaux,2010,12/06/2021,10063222010,1006322
490,04/06/2021,595,405,494,-4,101,20/04/2021,"Chateau Batailley 5eme Cru Classe, Pauillac",Bordeaux,2010,05/06/2021,10063222010,1006322
895,14/07/2021,921,39,863,32,58,10/05/2021,"Chateau Calon Segur 3eme Cru Classe, Saint-Estephe",Bordeaux,2006,15/07/2021,10074752006,1007475
3900,14/07/2021,4698,82,3822,78,876,20/06/2021,"Chateau Margaux Premier Cru Classe, Margaux",Bordeaux,2006,15/07/2021,10127812006,1012781
2710,23/07/2021,3082,14,2530,180,552,10/07/2021,"Chateau Angelus Premier Grand Cru Classe B, Saint-Emilion Grand Cru",Bordeaux,2008,24/07/2021,10060452008,1006045
6500,03/08/2021,7571,28,6400,100,1171,22/07/2021,"Chateau Margaux Premier Cru Classe, Margaux",Bordeaux,2005,03/08/2021,10127812005,1012781
490,04/06/2021,595,402,494,-4,101,20/04/2021,"Chateau Batailley 5eme Cru Classe, Pauillac",Bordeaux,2010,14/06/2021,10063222010,1006322
920,05/08/2021,954,24,842,78,112,22/08/2020,"Chateau Calon Segur 3eme Cru Classe, Saint-Estephe",Bordeaux,2019,06/08/2021,10074752019,1007475
1550,05/08/2021,1550,1,1300,250,250,27/04/2021,"Gaja, Barbaresco",Piedmont,2012,06/08/2021,10996052012,1099605
3750,14/07/2021,4242,83,3525,225,717,18/06/2021,"Chateau Margaux Premier Cru Classe, Margaux",Bordeaux,2007,15/07/2021,10127812007,1012781
880,14/07/2021,980,7,725,155,255,13/04/2021,"Chateau Calon Segur 3eme Cru Classe, Saint-Estephe",Bordeaux,2007,15/07/2021,10074752007,1007475
2710,23/07/2021,3082,14,2530,180,552,10/07/2021,"Chateau Angelus Premier Grand Cru Classe B, Saint-Emilion Grand Cru",Bordeaux,2008,24/07/2021,10060452008,1006045
6500,05/08/2021,7571,28,6400,100,1171,22/07/2021,"Chateau Margaux Premier Cru Classe, Margaux",Bordeaux,2005,06/08/2021,10127812005,1012781
480,05/08/2021,456,99,380,100,76,25/03/2021,"Tua Rita, Giusto di Notri, Toscana",Tuscany,2018,06/08/2021,11058072018,1105807
2710,21/07/2021,3082,14,2530,180,552,10/07/2021,"Chateau Angelus Premier Grand Cru Classe B, Saint-Emilion Grand Cru",Bordeaux,2008,22/07/2021,10060452008,1006045
490,04/06/2021,595,405,494,-4,101,20/04/2021,"Chateau Batailley 5eme Cru Classe, Pauillac",Bordeaux,2010,05/06/2021,10063222010,1006322
520,03/08/2021,563,3,460,60,103,05/05/2020,"Tua Rita, Giusto di Notri, Toscana",Tuscany,2008,03/08/2021,11058072008,1105807
14520,03/08/2021,14520,1,12000,2520,2520,28/05/2020,"Jacques-Frederic Mugnier, Chambolle-Musigny Premier Cru, Les Amoureuses",Burgundy,2014,03/08/2021,10496422014,1049642
960,02/08/2021,1204,9,850,110,354,28/01/2021,"Tignanello, Toscana",Tuscany,2012,03/08/2021,10953912012,1095391
8400,14/07/2021,8400,1,5700,2700,2700,10/09/2020,"Domaine Leflaive, Chevalier-Montrachet Grand Cru",Burgundy,2007,15/07/2021,10734012007,1073401
2710,21/07/2021,3082,14,2530,180,552,10/07/2021,"Chateau Angelus Premier Grand Cru Classe B, Saint-Emilion Grand Cru",Bordeaux,2008,22/07/2021,10060452008,1006045
3950,14/07/2021,4350,67,3870,80,480,10/07/2021,"Chateau Margaux Premier Cru Classe, Margaux",Bordeaux,2008,15/07/2021,10127812008,1012781
895,14/07/2021,978,10,781,114,197,16/11/2020,"Chateau Calon Segur 3eme Cru Classe, Saint-Estephe",Bordeaux,2008,15/07/2021,10074752008,1007475
6880,14/07/2021,7754,48,7086,-206,668,11/06/2021,"Chateau Margaux Premier Cru Classe, Margaux",Bordeaux,2009,15/07/2021,10127812009,1012781
9000,14/07/2021,10761,2,5400,3600,5361,13/08/2020,"Domaine Leflaive, Chevalier-Montrachet Grand Cru",Burgundy,2008,15/07/2021,10734012008,1073401
780,03/08/2021,940,88,740,40,200,21/05/2021,"Chateau Calon Segur 3eme Cru Classe, Saint-Estephe",Bordeaux,2017,03/08/2021,10074752017,1007475
1350,02/08/2021,1480,55,1260,90,220,18/02/2021,"Gaja, Barbaresco",Piedmont,2015,03/08/2021,10996052015,1099605
930,29/07/2021,1062,66,864,66,198,26/07/2021,"Tignanello, Toscana",Tuscany,2017,03/08/2021,10953912017,1095391
1299,29/06/2021,1265,45,1026,273,239,24/06/2021,"Chateau Calon Segur 3eme Cru Classe, Saint-Estephe",Bordeaux,2009,30/06/2021,10074752009,1007475
400,04/06/2021,439,5,300,100,139,05/11/2020,"Chateau Batailley 5eme Cru Classe, Pauillac",Bordeaux,2011,10/06/2021,10063222011,1006322
2710,19/07/2021,3082,14,2530,180,552,10/07/2021,"Chateau Angelus Premier Grand Cru Classe B, Saint-Emilion Grand Cru",Bordeaux,2008,20/07/2021,10060452008,1006045
2710,19/07/2021,3082,14,2530,180,552,10/07/2021,"Chateau Angelus Premier Grand Cru Classe B, Saint-Emilion Grand Cru",Bordeaux,2008,20/07/2021,10060452008,1006045
400,04/06/2021,439,5,300,100,139,05/11/2020,"Chateau Batailley 5eme Cru Classe, Pauillac",Bordeaux,2011,10/06/2021,10063222011,1006322
840,05/08/2021,1050,21,745,95,305,16/11/2020,"Chateau Calon Segur 3eme Cru Classe, Saint-Estephe",Bordeaux,2004,06/08/2021,10074752004,1007475
5100,05/08/2021,5703,19,4650,450,1053,21/06/2021,"Chateau Margaux Premier Cru Classe, Margaux",Bordeaux,2003,06/08/2021,10127812003,1012781
400,04/06/2021,427,8,355,45,72,15/04/2021,"Chateau Batailley 5eme Cru Classe, Pauillac",Bordeaux,2012,05/06/2021,10063222012,1006322
2710,16/07/2021,3058,15,2530,180,528,10/07/2021,"Chateau Angelus Premier Grand Cru Classe B, Saint-Emilion Grand Cru",Bordeaux,2008,17/07/2021,10060452008,1006045
2710,16/07/2021,3058,15,2530,180,528,10/07/2021,"Chateau Angelus Premier Grand Cru Classe B, Saint-Emilion Grand Cru",Bordeaux,2008,17/07/2021,10060452008,1006045
3820,04/08/2021,4615,219,3950,-130,665,30/06/2021,"Chateau Margaux Premier Cru Classe, Margaux",Bordeaux,2017,06/08/2021,10127812017,1012781
400,04/06/2021,427,8,355,45,72,15/04/2021,"Chateau Batailley 5eme Cru Classe, Pauillac",Bordeaux,2012,05/06/2021,10063222012,1006322
1480,05/08/2021,1626,61,1398,82,228,01/07/2021,"Gaja, Barbaresco",Piedmont,2017,06/08/2021,10996052017,1099605
487,03/08/2021,592,25,388,99,204,29/09/2020,"Tua Rita, Giusto di Notri, Toscana",Tuscany,2015,06/08/2021,11058072015,1105807
4450,03/08/2021,4739,16,4400,50,339,29/09/2020,"Chateau Margaux Premier Cru Classe, Margaux",Bordeaux,2001,03/08/2021,10127812001,1012781
3820,02/08/2021,4616,223,3950,-130,666,30/06/2021,"Chateau Margaux Premier Cru Classe, Margaux",Bordeaux,2017,03/08/2021,10127812017,1012781
5100,03/08/2021,5598,19,4650,450,948,21/06/2021,"Chateau Margaux Premier Cru Classe, Margaux",Bordeaux,2003,03/08/2021,10127812003,1012781
1280,02/08/2021,1416,61,1220,60,196,14/07/2021,"Tignanello, Toscana",Tuscany,2016,03/08/2021,10953912016,1095391
1000,14/07/2021,1239,52,1026,-26,213,24/06/2021,"Chateau Calon Segur 3eme Cru Classe, Saint-Estephe",Bordeaux,2009,15/07/2021,10074752009,1007475
6600,14/07/2021,6451,1,5360,1240,1091,18/09/2020,"Domaine Leflaive, Chevalier-Montrachet Grand Cru",Burgundy,2009,15/07/2021,10734012009,1073401
1850,14/07/2021,1831,1,1180,670,651,10/03/2017,"Gaja, Barbaresco",Piedmont,2005,15/07/2021,10996052005,1099605
3800,02/08/2021,4531,57,3525,275,1006,18/06/2021,"Chateau Margaux Premier Cru Classe, Margaux",Bordeaux,2007,03/08/2021,10127812007,1012781
3700,03/08/2021,4171,46,3520,180,651,07/04/2021,"Chateau Margaux Premier Cru Classe, Margaux",Bordeaux,2013,03/08/2021,10127812013,1012781
790,03/08/2021,868,17,801,-11,67,31/05/2021,"Chateau Calon Segur 3eme Cru Classe, Saint-Estephe",Bordeaux,2014,03/08/2021,10074752014,1007475
3950,03/08/2021,4469,108,3780,170,689,23/07/2021,"Chateau Margaux Premier Cru Classe, Margaux",Bordeaux,2008,03/08/2021,10127812008,1012781
2710,16/07/2021,3080,14,2530,180,550,10/07/2021,"Chateau Angelus Premier Grand Cru Classe B, Saint-Emilion Grand Cru",Bordeaux,2008,18/07/2021,10060452008,1006045
1800,14/07/2021,1700,1,1300,500,400,30/05/2019,"Gaja, Barbaresco",Piedmont,2007,15/07/2021,10996052007,1099605
2500,14/07/2021,2632,3,2220,280,412,14/06/2021,"Gaja, Barbaresco",Piedmont,2001,15/07/2021,10996052001,1099605
2386,14/07/2021,2397,3,2190,196,207,01/05/2021,"Gaja, Barbaresco",Piedmont,2004,15/07/2021,10996052004,1099605
520,14/07/2021,563,3,460,60,103,05/05/2020,"Tua Rita, Giusto di Notri, Toscana",Tuscany,2008,15/07/2021,11058072008,1105807
660,14/07/2021,727,5,390,270,337,18/08/2017,"Tua Rita, Giusto di Notri, Toscana",Tuscany,2006,15/07/2021,11058072006,1105807
1300,08/07/2021,1389,2,1200,100,189,06/03/2021,"Tignanello, Toscana",Tuscany,2007,15/07/2021,10953912007,1095391
6400,14/07/2021,7538,48,6190,210,1348,08/07/2021,"Chateau Margaux Premier Cru Classe, Margaux",Bordeaux,2010,15/07/2021,10127812010,1012781
300,04/06/2021,301,105,304,-4,-3,10/01/2021,"Chateau Batailley 5eme Cru Classe, Pauillac",Bordeaux,2013,05/06/2021,10063222013,1006322
990,14/07/2021,1137,16,990,0,147,16/06/2021,"Chateau Calon Segur 3eme Cru Classe, Saint-Estephe",Bordeaux,2010,15/07/2021,10074752010,1007475
8400,02/08/2021,8400,2,5700,2700,2700,10/09/2020,"Domaine Leflaive, Chevalier-Montrachet Grand Cru",Burgundy,2007,03/08/2021,10734012007,1073401
2710,16/07/2021,3080,14,2530,180,550,10/07/2021,"Chateau Angelus Premier Grand Cru Classe B, Saint-Emilion Grand Cru",Bordeaux,2008,18/07/2021,10060452008,1006045
8300,02/08/2021,9343,17,8200,100,1143,26/07/2021,"Chateau Margaux Premier Cru Classe, Margaux",Bordeaux,2000,03/08/2021,10127812000,1012781
990,03/08/2021,1119,10,880,110,239,22/06/2021,"Tignanello, Toscana",Tuscany,2011,03/08/2021,10953912011,1095391
1408,03/08/2021,1389,2,1238,170,151,02/11/2020,"Tignanello, Toscana",Tuscany,2006,03/08/2021,10953912006,1095391
350,04/06/2021,368,89,324,26,44,09/06/2021,"Chateau Batailley 5eme Cru Classe, Pauillac",Bordeaux,2014,10/06/2021,10063222014,1006322
900,02/08/2021,1111,20,800,100,311,21/11/2019,"Chateau Calon Segur 3eme Cru Classe, Saint-Estephe",Bordeaux,2003,03/08/2021,10074752003,1007475
10620,03/08/2021,11831,47,9800,820,2031,11/06/2021,"Chateau Margaux Premier Cru Classe, Margaux",Bordeaux,2015,03/08/2021,10127812015,1012781
788,14/07/2021,990,36,790,-2,200,01/06/2020,"Chateau Calon Segur 3eme Cru Classe, Saint-Estephe",Bordeaux,2011,15/07/2021,10074752011,1007475
1180,14/07/2021,1378,3,1072,108,306,20/01/2021,"Tignanello, Toscana",Tuscany,2009,15/07/2021,10953912009,1095391
1326,14/07/2021,1559,4,1170,156,389,24/06/2021,"Tignanello, Toscana",Tuscany,2010,15/07/2021,10953912010,1095391
3758,14/07/2021,4333,73,3690,68,643,13/04/2021,"Chateau Margaux Premier Cru Classe, Margaux",Bordeaux,2011,15/07/2021,10127812011,1012781
2710,14/07/2021,3064,15,2530,180,534,10/07/2021,"Chateau Angelus Premier Grand Cru Classe B, Saint-Emilion Grand Cru",Bordeaux,2008,15/07/2021,10060452008,1006045
350,04/06/2021,368,89,324,26,44,20/04/2021,"Chateau Batailley 5eme Cru Classe, Pauillac",Bordeaux,2014,07/06/2021,10063222014,1006322
660,03/08/2021,727,5,390,270,337,18/08/2017,"Tua Rita, Giusto di Notri, Toscana",Tuscany,2006,03/08/2021,11058072006,1105807
487,03/08/2021,612,52,320,167,292,24/03/2021,"Tua Rita, Giusto di Notri, Toscana",Tuscany,2017,03/08/2021,11058072017,1105807
2199,14/07/2021,2229,1,1340,859,889,13/03/2020,"Gaja, Barbaresco",Piedmont,2009,15/07/2021,10996052009,1099605
1050,14/07/2021,1117,9,880,170,237,22/06/2021,"Tignanello, Toscana",Tuscany,2011,15/07/2021,10953912011,1095391
487,03/08/2021,591,25,388,99,203,29/09/2020,"Tua Rita, Giusto di Notri, Toscana",Tuscany,2015,03/08/2021,11058072015,1105807
2710,14/07/2021,3058,15,2530,180,528,10/07/2021,"Chateau Angelus Premier Grand Cru Classe B, Saint-Emilion Grand Cru",Bordeaux,2008,16/07/2021,10060452008,1006045
2710,14/07/2021,3064,15,2530,180,534,10/07/2021,"Chateau Angelus Premier Grand Cru Classe B, Saint-Emilion Grand Cru",Bordeaux,2008,15/07/2021,10060452008,1006045
1570,03/08/2021,1454,6,1352,218,102,23/09/2020,"Gaja, Barbaresco",Piedmont,2011,03/08/2021,10996052011,1099605
2710,14/07/2021,3058,15,2530,180,528,10/07/2021,"Chateau Angelus Premier Grand Cru Classe B, Saint-Emilion Grand Cru",Bordeaux,2008,16/07/2021,10060452008,1006045
950,25/06/2021,1019,52,863,87,156,10/05/2021,"Chateau Calon Segur 3eme Cru Classe, Saint-Estephe",Bordeaux,2006,26/06/2021,10074752006,1007475
3750,24/06/2021,4213,40,3560,190,653,20/11/2020,"Chateau Margaux Premier Cru Classe, Margaux",Bordeaux,2012,26/06/2021,10127812012,1012781
2710,12/07/2021,3064,15,2530,180,534,10/07/2021,"Chateau Angelus Premier Grand Cru Classe B, Saint-Emilion Grand Cru",Bordeaux,2008,13/07/2021,10060452008,1006045
1000,24/06/2021,1265,45,1026,-26,239,24/06/2021,"Chateau Calon Segur 3eme Cru Classe, Saint-Estephe",Bordeaux,2009,26/06/2021,10074752009,1007475
2710,12/07/2021,3064,15,2530,180,534,10/07/2021,"Chateau Angelus Premier Grand Cru Classe B, Saint-Emilion Grand Cru",Bordeaux,2008,13/07/2021,10060452008,1006045
2710,09/07/2021,3048,13,2520,190,528,04/05/2021,"Chateau Angelus Premier Grand Cru Classe B, Saint-Emilion Grand Cru",Bordeaux,2008,10/07/2021,10060452008,1006045
780,05/08/2021,938,101,740,40,198,21/05/2021,"Chateau Calon Segur 3eme Cru Classe, Saint-Estephe",Bordeaux,2017,06/08/2021,10074752017,1007475
820,05/08/2021,925,4,735,85,190,09/09/2020,"Chateau Calon Segur 3eme Cru Classe, Saint-Estephe",Bordeaux,2012,06/08/2021,10074752012,1007475
1624,05/08/2021,1748,18,1663,-39,85,01/08/2021,"Gaja, Barbaresco",Piedmont,2018,06/08/2021,10996052018,1099605
2710,09/07/2021,3048,13,2520,190,528,04/05/2021,"Chateau Angelus Premier Grand Cru Classe B, Saint-Emilion Grand Cru",Bordeaux,2008,10/07/2021,10060452008,1006045
350,04/06/2021,368,90,324,26,44,20/04/2021,"Chateau Batailley 5eme Cru Classe, Pauillac",Bordeaux,2014,05/06/2021,10063222014,1006322
820,14/07/2021,937,6,735,85,202,09/09/2020,"Chateau Calon Segur 3eme Cru Classe, Saint-Estephe",Bordeaux,2012,15/07/2021,10074752012,1007475
3750,05/07/2021,4288,40,3560,190,728,20/11/2020,"Chateau Margaux Premier Cru Classe, Margaux",Bordeaux,2012,15/07/2021,10127812012,1012781
13200,14/07/2021,12867,1,12850,350,17,30/11/2020,"Jacques-Frederic Mugnier, Chambolle-Musigny Premier Cru, Les Amoureuses",Burgundy,2011,15/07/2021,10496422011,1049642
900,25/06/2021,1054,22,800,100,254,21/11/2019,"Chateau Calon Segur 3eme Cru Classe, Saint-Estephe",Bordeaux,2003,26/06/2021,10074752003,1007475
2710,09/07/2021,3048,13,2530,180,518,10/07/2021,"Chateau Angelus Premier Grand Cru Classe B, Saint-Emilion Grand Cru",Bordeaux,2008,11/07/2021,10060452008,1006045
1408,25/06/2021,1389,4,1238,170,151,02/11/2020,"Tignanello, Toscana",Tuscany,2006,26/06/2021,10953912006,1095391
476,04/06/2021,529,44,364,112,165,12/05/2021,"Chateau Batailley 5eme Cru Classe, Pauillac",Bordeaux,2016,05/06/2021,10063222016,1006322
6400,25/06/2021,7446,55,5950,450,1496,23/06/2021,"Chateau Margaux Premier Cru Classe, Margaux",Bordeaux,2010,26/06/2021,10127812010,1012781
686,25/06/2021,838,8,682,4,156,15/09/2020,"Chateau Calon Segur 3eme Cru Classe, Saint-Estephe",Bordeaux,2013,26/06/2021,10074752013,1007475
6000,23/07/2021,6106,1,6500,-500,-394,26/05/2021,"Domaine Leflaive, Chevalier-Montrachet Grand Cru",Burgundy,2011,03/08/2021,10734012011,1073401
840,17/06/2021,1092,76,860,-20,232,19/04/2021,"Chateau Calon Segur 3eme Cru Classe, Saint-Estephe",Bordeaux,2015,26/06/2021,10074752015,1007475
3740,25/06/2021,4026,63,3520,220,506,07/04/2021,"Chateau Margaux Premier Cru Classe, Margaux",Bordeaux,2013,26/06/2021,10127812013,1012781
2710,09/07/2021,3048,13,2530,180,518,10/07/2021,"Chateau Angelus Premier Grand Cru Classe B, Saint-Emilion Grand Cru",Bordeaux,2008,11/07/2021,10060452008,1006045
408,04/06/2021,418,19,357,51,61,06/05/2021,"Chateau Batailley 5eme Cru Classe, Pauillac",Bordeaux,2018,05/06/2021,10063222018,1006322
995,02/08/2021,1113,18,993,2,120,27/07/2021,"Chateau Calon Segur 3eme Cru Classe, Saint-Estephe",Bordeaux,2010,03/08/2021,10074752010,1007475
907,25/06/2021,953,23,805,102,148,20/11/2019,"Chateau Calon Segur 3eme Cru Classe, Saint-Estephe",Bordeaux,2001,26/06/2021,10074752001,1007475
3826,25/06/2021,4499,55,4116,-290,383,25/02/2021,"Chateau Margaux Premier Cru Classe, Margaux",Bordeaux,2004,26/06/2021,10127812004,1012781
6400,25/06/2021,7417,41,6776,-376,641,10/06/2021,"Chateau Margaux Premier Cru Classe, Margaux",Bordeaux,2005,26/06/2021,10127812005,1012781
1040,23/06/2021,1204,23,940,100,264,18/03/2021,"Chateau Calon Segur 3eme Cru Classe, Saint-Estephe",Bordeaux,2000,26/06/2021,10074752000,1007475
4850,25/06/2021,5660,29,4650,200,1010,21/06/2021,"Chateau Margaux Premier Cru Classe, Margaux",Bordeaux,2003,26/06/2021,10127812003,1012781
3826,04/08/2021,4624,44,4116,-290,508,25/02/2021,"Chateau Margaux Premier Cru Classe, Margaux",Bordeaux,2004,05/08/2021,10127812004,1012781
895,04/08/2021,950,9,781,114,169,16/11/2020,"Chateau Calon Segur 3eme Cru Classe, Saint-Estephe",Bordeaux,2008,05/08/2021,10074752008,1007475
990,04/08/2021,1119,10,880,110,239,22/06/2021,"Tignanello, Toscana",Tuscany,2011,05/08/2021,10953912011,1095391
870,25/06/2021,954,4,705,165,249,01/02/2021,"Chateau Calon Segur 3eme Cru Classe, Saint-Estephe",Bordeaux,2002,26/06/2021,10074752002,1007475
468,07/06/2021,586,2,465,3,121,04/05/2020,"Chateau Batailley 5eme Cru Classe, Pauillac",Bordeaux,2001,06/07/2021,10063222001,1006322
880,25/06/2021,967,9,725,155,242,13/04/2021,"Chateau Calon Segur 3eme Cru Classe, Saint-Estephe",Bordeaux,2007,26/06/2021,10074752007,1007475
6830,23/06/2021,7717,50,7086,-256,631,11/06/2021,"Chateau Margaux Premier Cru Classe, Margaux",Bordeaux,2009,26/06/2021,10127812009,1012781
10500,25/06/2021,11863,51,9800,700,2063,11/06/2021,"Chateau Margaux Premier Cru Classe, Margaux",Bordeaux,2015,26/06/2021,10127812015,1012781
3900,25/06/2021,4260,78,3700,200,560,07/06/2021,"Chateau Margaux Premier Cru Classe, Margaux",Bordeaux,2008,26/06/2021,10127812008,1012781
1028,23/07/2021,1227,49,1058,-30,169,14/07/2021,"Chateau Calon Segur 3eme Cru Classe, Saint-Estephe",Bordeaux,2018,03/08/2021,10074752018,1007475
468,07/06/2021,566,3,465,3,101,04/05/2020,"Chateau Batailley 5eme Cru Classe, Pauillac",Bordeaux,2001,13/06/2021,10063222001,1006322
2710,07/07/2021,3048,13,2520,190,528,04/05/2021,"Chateau Angelus Premier Grand Cru Classe B, Saint-Emilion Grand Cru",Bordeaux,2008,08/07/2021,10060452008,1006045
790,25/06/2021,904,22,801,-11,103,31/05/2021,"Chateau Calon Segur 3eme Cru Classe, Saint-Estephe",Bordeaux,2014,26/06/2021,10074752014,1007475
2710,07/07/2021,3048,13,2520,190,528,04/05/2021,"Chateau Angelus Premier Grand Cru Classe B, Saint-Emilion Grand Cru",Bordeaux,2008,08/07/2021,10060452008,1006045
990,25/06/2021,1116,15,990,0,126,16/06/2021,"Chateau Calon Segur 3eme Cru Classe, Saint-Estephe",Bordeaux,2010,26/06/2021,10074752010,1007475
3720,25/06/2021,4312,146,3480,240,832,17/06/2021,"Chateau Margaux Premier Cru Classe, Margaux",Bordeaux,2014,26/06/2021,10127812014,1012781
2710,05/07/2021,3048,13,2520,190,528,04/05/2021,"Chateau Angelus Premier Grand Cru Classe B, Saint-Emilion Grand Cru",Bordeaux,2008,06/07/2021,10060452008,1006045
6930,04/08/2021,7719,70,7086,-156,633,11/06/2021,"Chateau Margaux Premier Cru Classe, Margaux",Bordeaux,2009,05/08/2021,10127812009,1012781
7800,04/08/2021,8910,2,6974,826,1936,14/03/2021,"Domaine Leflaive, Chevalier-Montrachet Grand Cru",Burgundy,2017,05/08/2021,10734012017,1073401
2710,05/07/2021,3048,13,2520,190,528,04/05/2021,"Chateau Angelus Premier Grand Cru Classe B, Saint-Emilion Grand Cru",Bordeaux,2008,06/07/2021,10060452008,1006045
920,04/08/2021,954,24,842,78,112,22/08/2020,"Chateau Calon Segur 3eme Cru Classe, Saint-Estephe",Bordeaux,2019,05/08/2021,10074752019,1007475
2710,02/07/2021,3048,13,2520,190,528,04/05/2021,"Chateau Angelus Premier Grand Cru Classe B, Saint-Emilion Grand Cru",Bordeaux,2008,04/07/2021,10060452008,1006045
2710,02/07/2021,3052,14,2520,190,532,04/05/2021,"Chateau Angelus Premier Grand Cru Classe B, Saint-Emilion Grand Cru",Bordeaux,2008,03/07/2021,10060452008,1006045
3560,25/06/2021,4171,44,3525,35,646,18/06/2021,"Chateau Margaux Premier Cru Classe, Margaux",Bordeaux,2007,26/06/2021,10127812007,1012781
1050,17/06/2021,1143,6,860,190,283,08/03/2021,"Tignanello, Toscana",Tuscany,2013,26/06/2021,10953912013,1095391
2098,25/06/2021,2300,4,2190,-92,110,01/05/2021,"Gaja, Barbaresco",Piedmont,2004,26/06/2021,10996052004,1099605
2710,02/07/2021,3052,14,2520,190,532,04/05/2021,"Chateau Angelus Premier Grand Cru Classe B, Saint-Emilion Grand Cru",Bordeaux,2008,03/07/2021,10060452008,1006045
6400,03/08/2021,7596,65,6188,212,1408,16/07/2021,"Chateau Margaux Premier Cru Classe, Margaux",Bordeaux,2010,03/08/2021,10127812010,1012781
2710,02/07/2021,3048,13,2520,190,528,04/05/2021,"Chateau Angelus Premier Grand Cru Classe B, Saint-Emilion Grand Cru",Bordeaux,2008,04/07/2021,10060452008,1006045
468,07/06/2021,565,3,465,3,100,04/05/2020,"Chateau Batailley 5eme Cru Classe, Pauillac",Bordeaux,2001,08/06/2021,10063222001,1006322
2710,30/06/2021,3045,13,2520,190,525,04/05/2021,"Chateau Angelus Premier Grand Cru Classe B, Saint-Emilion Grand Cru",Bordeaux,2008,01/07/2021,10060452008,1006045
530,07/06/2021,675,93,450,80,225,04/05/2021,"Chateau Batailley 5eme Cru Classe, Pauillac",Bordeaux,2005,08/06/2021,10063222005,1006322
1000,25/06/2021,1157,92,988,12,169,28/05/2021,"Chateau Calon Segur 3eme Cru Classe, Saint-Estephe",Bordeaux,2005,26/06/2021,10074752005,1007475
2710,30/06/2021,3045,13,2520,190,525,04/05/2021,"Chateau Angelus Premier Grand Cru Classe B, Saint-Emilion Grand Cru",Bordeaux,2008,01/07/2021,10060452008,1006045
2710,30/06/2021,3042,14,2520,190,522,04/05/2021,"Chateau Angelus Premier Grand Cru Classe B, Saint-Emilion Grand Cru",Bordeaux,2008,02/07/2021,10060452008,1006045
3900,25/06/2021,4630,95,3822,78,808,20/06/2021,"Chateau Margaux Premier Cru Classe, Margaux",Bordeaux,2006,26/06/2021,10127812006,1012781
1408,29/06/2021,1436,1,1150,258,286,21/04/2019,"Tignanello, Toscana",Tuscany,2005,30/06/2021,10953912005,1095391
2500,29/06/2021,2636,2,2220,280,416,14/06/2021,"Gaja, Barbaresco",Piedmont,2001,30/06/2021,10996052001,1099605
2098,29/06/2021,2300,4,2190,-92,110,01/05/2021,"Gaja, Barbaresco",Piedmont,2004,30/06/2021,10996052004,1099605
1700,28/06/2021,1847,4,1378,322,469,29/07/2020,"Tignanello, Toscana",Tuscany,2001,30/06/2021,10953912001,1095391
1299,29/06/2021,1555,5,1010,289,545,18/12/2020,"Tignanello, Toscana",Tuscany,2008,30/06/2021,10953912008,1095391
1245,29/06/2021,1615,2,882,363,733,26/04/2019,"Tignanello, Toscana",Tuscany,2003,30/06/2021,10953912003,1095391
1408,29/06/2021,1389,4,1238,170,151,02/11/2020,"Tignanello, Toscana",Tuscany,2006,30/06/2021,10953912006,1095391
1678,29/06/2021,1683,4,1420,258,263,29/06/2021,"Tignanello, Toscana",Tuscany,2004,30/06/2021,10953912004,1095391
1570,29/06/2021,1385,2,1200,370,185,06/03/2021,"Tignanello, Toscana",Tuscany,2007,30/06/2021,10953912007,1095391
6400,29/06/2021,7572,51,5950,450,1622,23/06/2021,"Chateau Margaux Premier Cru Classe, Margaux",Bordeaux,2010,30/06/2021,10127812010,1012781
530,07/06/2021,675,93,450,80,225,04/05/2021,"Chateau Batailley 5eme Cru Classe, Pauillac",Bordeaux,2005,08/06/2021,10063222005,1006322
2500,25/06/2021,2636,2,2220,280,416,14/06/2021,"Gaja, Barbaresco",Piedmont,2001,26/06/2021,10996052001,1099605
1024,25/06/2021,1232,5,1072,-48,160,20/01/2021,"Tignanello, Toscana",Tuscany,2009,26/06/2021,10953912009,1095391
3900,25/06/2021,4496,25,3684,216,812,10/06/2020,"Chateau Margaux Premier Cru Classe, Margaux",Bordeaux,2002,26/06/2021,10127812002,1012781
420,07/06/2021,521,5,400,20,121,11/05/2021,"Chateau Batailley 5eme Cru Classe, Pauillac",Bordeaux,2006,08/06/2021,10063222006,1006322
5290,24/06/2021,5097,7,4160,1130,937,19/03/2021,"Chateau Margaux Premier Cru Classe, Margaux",Bordeaux,2019,27/06/2021,10127812019,1012781
1304,23/06/2021,1438,3,1170,134,268,24/06/2021,"Tignanello, Toscana",Tuscany,2010,27/06/2021,10953912010,1095391
3900,04/08/2021,4639,96,3822,78,817,20/06/2021,"Chateau Margaux Premier Cru Classe, Margaux",Bordeaux,2006,05/08/2021,10127812006,1012781
995,04/08/2021,1113,18,993,2,120,27/07/2021,"Chateau Calon Segur 3eme Cru Classe, Saint-Estephe",Bordeaux,2010,05/08/2021,10074752010,1007475
1008,29/07/2021,1164,78,998,10,166,28/07/2021,"Tignanello, Toscana",Tuscany,2018,05/08/2021,10953912018,1095391
3900,04/08/2021,4432,22,3684,216,748,10/06/2020,"Chateau Margaux Premier Cru Classe, Margaux",Bordeaux,2002,05/08/2021,10127812002,1012781
5100,04/08/2021,5598,19,4650,450,948,21/06/2021,"Chateau Margaux Premier Cru Classe, Margaux",Bordeaux,2003,05/08/2021,10127812003,1012781
3740,14/07/2021,4095,25,3520,220,575,07/04/2021,"Chateau Margaux Premier Cru Classe, Margaux",Bordeaux,2013,15/07/2021,10127812013,1012781
2710,30/06/2021,3042,14,2520,190,522,04/05/2021,"Chateau Angelus Premier Grand Cru Classe B, Saint-Emilion Grand Cru",Bordeaux,2008,02/07/2021,10060452008,1006045
420,07/06/2021,521,5,400,20,121,11/05/2021,"Chateau Batailley 5eme Cru Classe, Pauillac",Bordeaux,2006,08/06/2021,10063222006,1006322
686,14/07/2021,809,7,682,4,127,15/09/2020,"Chateau Calon Segur 3eme Cru Classe, Saint-Estephe",Bordeaux,2013,15/07/2021,10074752013,1007475
520,04/08/2021,563,3,460,60,103,05/05/2020,"Tua Rita, Giusto di Notri, Toscana",Tuscany,2008,05/08/2021,11058072008,1105807
840,04/08/2021,1050,21,745,95,305,16/11/2020,"Chateau Calon Segur 3eme Cru Classe, Saint-Estephe",Bordeaux,2004,05/08/2021,10074752004,1007475
5415,30/07/2021,5876,143,5500,-85,376,06/07/2021,"Chateau Margaux Premier Cru Classe, Margaux",Bordeaux,2016,05/08/2021,10127812016,1012781
2710,28/06/2021,3015,11,2520,190,495,04/05/2021,"Chateau Angelus Premier Grand Cru Classe B, Saint-Emilion Grand Cru",Bordeaux,2008,29/06/2021,10060452008,1006045
2710,28/06/2021,3015,11,2520,190,495,04/05/2021,"Chateau Angelus Premier Grand Cru Classe B, Saint-Emilion Grand Cru",Bordeaux,2008,29/06/2021,10060452008,1006045
2386,04/08/2021,2281,3,2190,196,91,01/05/2021,"Gaja, Barbaresco",Piedmont,2004,05/08/2021,10996052004,1099605
6500,04/08/2021,7571,28,6400,100,1171,22/07/2021,"Chateau Margaux Premier Cru Classe, Margaux",Bordeaux,2005,05/08/2021,10127812005,1012781
750,04/08/2021,947,47,790,-40,157,01/06/2020,"Chateau Calon Segur 3eme Cru Classe, Saint-Estephe",Bordeaux,2011,05/08/2021,10074752011,1007475
450,07/06/2021,450,1,340,110,110,31/08/2018,"Chateau Batailley 5eme Cru Classe, Pauillac",Bordeaux,2007,08/06/2021,10063222007,1006322
2710,28/06/2021,3045,13,2520,190,525,04/05/2021,"Chateau Angelus Premier Grand Cru Classe B, Saint-Emilion Grand Cru",Bordeaux,2008,30/06/2021,10060452008,1006045
2710,28/06/2021,3045,13,2520,190,525,04/05/2021,"Chateau Angelus Premier Grand Cru Classe B, Saint-Emilion Grand Cru",Bordeaux,2008,30/06/2021,10060452008,1006045
1040,04/08/2021,1377,69,940,100,437,18/03/2021,"Chateau Calon Segur 3eme Cru Classe, Saint-Estephe",Bordeaux,2000,05/08/2021,10074752000,1007475
1550,04/08/2021,1550,1,1300,250,250,27/04/2021,"Gaja, Barbaresco",Piedmont,2012,05/08/2021,10996052012,1099605
490,07/06/2021,570,26,450,40,120,25/05/2021,"Chateau Batailley 5eme Cru Classe, Pauillac",Bordeaux,2009,08/06/2021,10063222009,1006322
2710,23/06/2021,3015,11,2520,190,495,04/05/2021,"Chateau Angelus Premier Grand Cru Classe B, Saint-Emilion Grand Cru",Bordeaux,2008,24/06/2021,10060452008,1006045
5600,04/08/2021,6016,51,5254,346,762,26/05/2021,"Chateau Margaux Premier Cru Classe, Margaux",Bordeaux,2018,05/08/2021,10127812018,1012781
8568,04/08/2021,8730,4,7330,1238,1400,02/06/2021,"Domaine Leflaive, Chevalier-Montrachet Grand Cru",Burgundy,2018,05/08/2021,10734012018,1073401
1584,04/08/2021,1670,4,1378,206,292,29/07/2020,"Tignanello, Toscana",Tuscany,2001,05/08/2021,10953912001,1095391
3700,04/08/2021,4171,46,3520,180,651,07/04/2021,"Chateau Margaux Premier Cru Classe, Margaux",Bordeaux,2013,05/08/2021,10127812013,1012781
780,04/08/2021,940,88,740,40,200,21/05/2021,"Chateau Calon Segur 3eme Cru Classe, Saint-Estephe",Bordeaux,2017,05/08/2021,10074752017,1007475
930,29/07/2021,1062,66,908,22,154,04/08/2021,"Tignanello, Toscana",Tuscany,2017,05/08/2021,10953912017,1095391
5600,10/05/2021,6623,0,4400,1200,2223,06/11/2017,"Domaine Leflaive, Chevalier-Montrachet Grand Cru",Burgundy,2013,15/07/2021,10734012013,1073401
490,07/06/2021,570,26,450,40,120,25/05/2021,"Chateau Batailley 5eme Cru Classe, Pauillac",Bordeaux,2009,08/06/2021,10063222009,1006322
2710,23/06/2021,3015,11,2520,190,495,04/05/2021,"Chateau Angelus Premier Grand Cru Classe B, Saint-Emilion Grand Cru",Bordeaux,2008,24/06/2021,10060452008,1006045
880,04/08/2021,967,9,725,155,242,13/04/2021,"Chateau Calon Segur 3eme Cru Classe, Saint-Estephe",Bordeaux,2007,05/08/2021,10074752007,1007475
2710,21/06/2021,3015,11,2520,190,495,04/05/2021,"Chateau Angelus Premier Grand Cru Classe B, Saint-Emilion Grand Cru",Bordeaux,2008,22/06/2021,10060452008,1006045
940,04/08/2021,1072,77,866,74,206,20/07/2021,"Chateau Calon Segur 3eme Cru Classe, Saint-Estephe",Bordeaux,2015,05/08/2021,10074752015,1007475
1100,04/08/2021,1217,80,1036,64,181,27/05/2021,"Chateau Calon Segur 3eme Cru Classe, Saint-Estephe",Bordeaux,2016,05/08/2021,10074752016,1007475
2199,04/08/2021,2229,1,1340,859,889,13/03/2020,"Gaja, Barbaresco",Piedmont,2009,05/08/2021,10996052009,1099605
16200,04/08/2021,16483,0,18750,-2550,-2267,29/08/2018,"Jacques-Frederic Mugnier, Chambolle-Musigny Premier Cru, Les Amoureuses",Burgundy,2015,05/08/2021,10496422015,1049642
8100,23/06/2021,8506,17,8100,0,406,21/06/2021,"Chateau Margaux Premier Cru Classe, Margaux",Bordeaux,2000,27/06/2021,10127812000,1012781
1570,22/06/2021,1385,2,1200,370,185,06/03/2021,"Tignanello, Toscana",Tuscany,2007,27/06/2021,10953912007,1095391
907,25/06/2021,966,18,805,102,161,20/11/2019,"Chateau Calon Segur 3eme Cru Classe, Saint-Estephe",Bordeaux,2001,27/06/2021,10074752001,1007475
1304,23/06/2021,1438,3,1170,134,268,24/06/2021,"Tignanello, Toscana",Tuscany,2010,27/06/2021,10953912010,1095391
3750,24/06/2021,4214,39,3560,190,654,20/11/2020,"Chateau Margaux Premier Cru Classe, Margaux",Bordeaux,2012,27/06/2021,10127812012,1012781
1100,17/06/2021,1265,45,1026,74,239,24/06/2021,"Chateau Calon Segur 3eme Cru Classe, Saint-Estephe",Bordeaux,2009,27/06/2021,10074752009,1007475
2710,21/06/2021,3015,11,2520,190,495,04/05/2021,"Chateau Angelus Premier Grand Cru Classe B, Saint-Emilion Grand Cru",Bordeaux,2008,22/06/2021,10060452008,1006045
960,14/07/2021,1346,11,850,110,496,28/01/2021,"Tignanello, Toscana",Tuscany,2012,15/07/2021,10953912012,1095391
2710,17/06/2021,2928,11,2520,190,408,04/05/2021,"Chateau Angelus Premier Grand Cru Classe B, Saint-Emilion Grand Cru",Bordeaux,2008,18/06/2021,10060452008,1006045
3800,14/07/2021,4342,123,3480,320,862,17/06/2021,"Chateau Margaux Premier Cru Classe, Margaux",Bordeaux,2014,15/07/2021,10127812014,1012781
400,07/06/2021,427,8,355,45,72,15/04/2021,"Chateau Batailley 5eme Cru Classe, Pauillac",Bordeaux,2012,08/06/2021,10063222012,1006322
1550,14/07/2021,1557,1,1300,250,257,27/04/2021,"Gaja, Barbaresco",Piedmont,2012,15/07/2021,10996052012,1099605
1060,14/07/2021,1135,8,860,200,275,08/03/2021,"Tignanello, Toscana",Tuscany,2013,15/07/2021,10953912013,1095391
984,14/07/2021,1106,45,830,154,276,22/06/2021,"Tignanello, Toscana",Tuscany,2014,15/07/2021,10953912014,1095391
10620,04/08/2021,11831,47,9800,820,2031,11/06/2021,"Chateau Margaux Premier Cru Classe, Margaux",Bordeaux,2015,05/08/2021,10127812015,1012781
400,07/06/2021,427,8,355,45,72,15/04/2021,"Chateau Batailley 5eme Cru Classe, Pauillac",Bordeaux,2012,08/06/2021,10063222012,1006322
900,04/08/2021,1103,23,800,100,303,21/11/2019,"Chateau Calon Segur 3eme Cru Classe, Saint-Estephe",Bordeaux,2003,05/08/2021,10074752003,1007475
790,04/08/2021,868,17,801,-11,67,31/05/2021,"Chateau Calon Segur 3eme Cru Classe, Saint-Estephe",Bordeaux,2014,05/08/2021,10074752014,1007475
300,07/06/2021,301,105,304,-4,-3,10/01/2021,"Chateau Batailley 5eme Cru Classe, Pauillac",Bordeaux,2013,08/06/2021,10063222013,1006322
476,07/06/2021,529,44,364,112,165,12/05/2021,"Chateau Batailley 5eme Cru Classe, Pauillac",Bordeaux,2016,08/06/2021,10063222016,1006322
1408,27/05/2021,1411,1,996,412,415,14/06/2019,"Tignanello, Toscana",Tuscany,2000,28/06/2021,10953912000,1095391
1304,23/06/2021,1461,3,1170,134,291,24/06/2021,"Tignanello, Toscana",Tuscany,2010,28/06/2021,10953912010,1095391
1299,22/06/2021,1555,5,1010,289,545,18/12/2020,"Tignanello, Toscana",Tuscany,2008,28/06/2021,10953912008,1095391
4850,25/06/2021,5841,20,4650,200,1191,21/06/2021,"Chateau Margaux Premier Cru Classe, Margaux",Bordeaux,2003,28/06/2021,10127812003,1012781
1050,17/06/2021,1150,6,860,190,290,08/03/2021,"Tignanello, Toscana",Tuscany,2013,28/06/2021,10953912013,1095391
820,04/08/2021,925,4,735,85,190,09/09/2020,"Chateau Calon Segur 3eme Cru Classe, Saint-Estephe",Bordeaux,2012,05/08/2021,10074752012,1007475
1120,26/07/2021,1140,7,952,168,188,04/08/2021,"Tignanello, Toscana",Tuscany,2013,05/08/2021,10953912013,1095391
408,07/06/2021,418,19,357,51,61,06/05/2021,"Chateau Batailley 5eme Cru Classe, Pauillac",Bordeaux,2018,08/06/2021,10063222018,1006322
990,29/06/2021,1116,15,990,0,126,16/06/2021,"Chateau Calon Segur 3eme Cru Classe, Saint-Estephe",Bordeaux,2010,30/06/2021,10074752010,1007475
2710,17/06/2021,3020,11,2520,190,500,04/05/2021,"Chateau Angelus Premier Grand Cru Classe B, Saint-Emilion Grand Cru",Bordeaux,2008,19/06/2021,10060452008,1006045
9000,04/08/2021,8799,1,5400,3600,3399,13/08/2020,"Domaine Leflaive, Chevalier-Montrachet Grand Cru",Burgundy,2008,05/08/2021,10734012008,1073401
2710,17/06/2021,2928,11,2520,190,408,04/05/2021,"Chateau Angelus Premier Grand Cru Classe B, Saint-Emilion Grand Cru",Bordeaux,2008,18/06/2021,10060452008,1006045
8040,18/05/2021,8315,20,7950,90,365,12/03/2021,"Chateau Margaux Premier Cru Classe, Margaux",Bordeaux,2000,19/05/2021,10127812000,1012781
950,18/05/2021,1015,62,863,87,152,10/05/2021,"Chateau Calon Segur 3eme Cru Classe, Saint-Estephe",Bordeaux,2006,19/05/2021,10074752006,1007475
15600,04/08/2021,15110,3,13000,2600,2110,29/04/2021,"Jacques-Frederic Mugnier, Chambolle-Musigny Premier Cru, Les Amoureuses",Burgundy,2017,05/08/2021,10496422017,1049642
990,04/08/2021,1177,63,1029,-39,148,21/07/2021,"Chateau Calon Segur 3eme Cru Classe, Saint-Estephe",Bordeaux,2005,05/08/2021,10074752005,1007475
840,18/05/2021,1095,98,860,-20,235,19/04/2021,"Chateau Calon Segur 3eme Cru Classe, Saint-Estephe",Bordeaux,2015,19/05/2021,10074752015,1007475
6650,18/05/2021,8031,69,6500,150,1531,12/05/2021,"Chateau Margaux Premier Cru Classe, Margaux",Bordeaux,2009,19/05/2021,10127812009,1012781
1280,04/08/2021,1416,61,1220,60,196,14/07/2021,"Tignanello, Toscana",Tuscany,2016,05/08/2021,10953912016,1095391
2710,17/06/2021,3020,11,2520,190,500,04/05/2021,"Chateau Angelus Premier Grand Cru Classe B, Saint-Emilion Grand Cru",Bordeaux,2008,19/06/2021,10060452008,1006045
450,08/06/2021,450,1,340,110,110,31/08/2018,"Chateau Batailley 5eme Cru Classe, Pauillac",Bordeaux,2007,09/06/2021,10063222007,1006322
750,17/05/2021,1024,46,790,-40,234,01/06/2020,"Chateau Calon Segur 3eme Cru Classe, Saint-Estephe",Bordeaux,2011,19/05/2021,10074752011,1007475
2710,15/06/2021,2935,11,2520,190,415,04/05/2021,"Chateau Angelus Premier Grand Cru Classe B, Saint-Emilion Grand Cru",Bordeaux,2008,16/06/2021,10060452008,1006045
1050,18/05/2021,1344,48,940,110,404,18/03/2021,"Chateau Calon Segur 3eme Cru Classe, Saint-Estephe",Bordeaux,2000,19/05/2021,10074752000,1007475
1573,14/07/2021,1579,15,1300,273,279,10/07/2021,"Gaja, Barbaresco",Piedmont,2014,15/07/2021,10996052014,1099605
880,18/05/2021,986,13,725,155,261,13/04/2021,"Chateau Calon Segur 3eme Cru Classe, Saint-Estephe",Bordeaux,2007,19/05/2021,10074752007,1007475
1120,13/05/2021,1341,8,1172,-52,169,07/04/2021,"Tignanello, Toscana",Tuscany,2010,19/05/2021,10953912010,1095391
1000,18/05/2021,1264,24,1047,-47,217,27/04/2021,"Chateau Calon Segur 3eme Cru Classe, Saint-Estephe",Bordeaux,2009,19/05/2021,10074752009,1007475
3850,18/05/2021,4180,41,3560,290,620,20/11/2020,"Chateau Margaux Premier Cru Classe, Margaux",Bordeaux,2012,19/05/2021,10127812012,1012781
3720,18/05/2021,4107,49,3480,240,627,10/04/2021,"Chateau Margaux Premier Cru Classe, Margaux",Bordeaux,2014,19/05/2021,10127812014,1012781
6250,18/05/2021,7088,42,6116,134,972,07/05/2021,"Chateau Margaux Premier Cru Classe, Margaux",Bordeaux,2005,19/05/2021,10127812005,1012781
2710,15/06/2021,2935,11,2520,190,415,04/05/2021,"Chateau Angelus Premier Grand Cru Classe B, Saint-Emilion Grand Cru",Bordeaux,2008,16/06/2021,10060452008,1006045
2710,11/06/2021,2964,11,2520,190,444,04/05/2021,"Chateau Angelus Premier Grand Cru Classe B, Saint-Emilion Grand Cru",Bordeaux,2008,15/06/2021,10060452008,1006045
4400,18/05/2021,4883,27,4400,0,483,29/09/2020,"Chateau Margaux Premier Cru Classe, Margaux",Bordeaux,2001,19/05/2021,10127812001,1012781
1050,18/05/2021,1213,12,860,190,353,08/03/2021,"Tignanello, Toscana",Tuscany,2013,19/05/2021,10953912013,1095391
490,08/06/2021,584,18,450,40,134,25/05/2021,"Chateau Batailley 5eme Cru Classe, Pauillac",Bordeaux,2009,09/06/2021,10063222009,1006322
14520,04/08/2021,14520,1,12000,2520,2520,28/05/2020,"Jacques-Frederic Mugnier, Chambolle-Musigny Premier Cru, Les Amoureuses",Burgundy,2014,05/08/2021,10496422014,1049642
1030,04/08/2021,1101,7,854,176,247,15/07/2021,"Tignanello, Toscana",Tuscany,2014,05/08/2021,10953912014,1095391
960,04/08/2021,1163,11,910,50,253,04/08/2021,"Tignanello, Toscana",Tuscany,2012,05/08/2021,10953912012,1095391
490,08/06/2021,584,18,450,40,134,25/05/2021,"Chateau Batailley 5eme Cru Classe, Pauillac",Bordeaux,2009,09/06/2021,10063222009,1006322
1800,04/08/2021,1700,1,1300,500,400,30/05/2019,"Gaja, Barbaresco",Piedmont,2007,05/08/2021,10996052007,1099605
995,18/05/2021,1129,19,1000,-5,129,12/04/2021,"Chateau Calon Segur 3eme Cru Classe, Saint-Estephe",Bordeaux,2010,19/05/2021,10074752010,1007475
2710,11/06/2021,2986,10,2520,190,466,04/05/2021,"Chateau Angelus Premier Grand Cru Classe B, Saint-Emilion Grand Cru",Bordeaux,2008,12/06/2021,10060452008,1006045
2710,11/06/2021,2986,10,2520,190,466,04/05/2021,"Chateau Angelus Premier Grand Cru Classe B, Saint-Emilion Grand Cru",Bordeaux,2008,12/06/2021,10060452008,1006045
1100,18/05/2021,1536,7,1010,90,526,18/12/2020,"Tignanello, Toscana",Tuscany,2008,19/05/2021,10953912008,1095391
300,08/06/2021,301,105,304,-4,-3,10/01/2021,"Chateau Batailley 5eme Cru Classe, Pauillac",Bordeaux,2013,09/06/2021,10063222013,1006322
800,04/08/2021,792,19,682,118,110,15/09/2020,"Chateau Calon Segur 3eme Cru Classe, Saint-Estephe",Bordeaux,2013,05/08/2021,10074752013,1007475
4450,04/08/2021,4739,16,4400,50,339,29/09/2020,"Chateau Margaux Premier Cru Classe, Margaux",Bordeaux,2001,05/08/2021,10127812001,1012781
1010,18/05/2021,1048,11,860,150,188,08/03/2021,"Tignanello, Toscana",Tuscany,2011,19/05/2021,10953912011,1095391
1350,04/08/2021,1480,55,1260,90,220,18/02/2021,"Gaja, Barbaresco",Piedmont,2015,05/08/2021,10996052015,1099605
6400,04/08/2021,7596,65,6188,212,1408,16/07/2021,"Chateau Margaux Premier Cru Classe, Margaux",Bordeaux,2010,05/08/2021,10127812010,1012781
1180,04/08/2021,1353,4,1140,40,213,21/07/2021,"Tignanello, Toscana",Tuscany,2009,05/08/2021,10953912009,1095391
476,08/06/2021,529,44,364,112,165,12/05/2021,"Chateau Batailley 5eme Cru Classe, Pauillac",Bordeaux,2016,09/06/2021,10063222016,1006322
1624,04/08/2021,1748,18,1663,-39,85,01/08/2021,"Gaja, Barbaresco",Piedmont,2018,05/08/2021,10996052018,1099605
2710,11/06/2021,2964,11,2520,190,444,04/05/2021,"Chateau Angelus Premier Grand Cru Classe B, Saint-Emilion Grand Cru",Bordeaux,2008,15/06/2021,10060452008,1006045
1000,18/05/2021,1172,83,975,25,197,12/04/2021,"Chateau Calon Segur 3eme Cru Classe, Saint-Estephe",Bordeaux,2005,19/05/2021,10074752005,1007475
940,14/07/2021,1090,75,822,118,268,28/06/2021,"Chateau Calon Segur 3eme Cru Classe, Saint-Estephe",Bordeaux,2015,15/07/2021,10074752015,1007475
10400,14/07/2021,11825,50,9800,600,2025,11/06/2021,"Chateau Margaux Premier Cru Classe, Margaux",Bordeaux,2015,15/07/2021,10127812015,1012781
10500,18/05/2021,12538,67,9844,656,2694,29/03/2021,"Chateau Margaux Premier Cru Classe, Margaux",Bordeaux,2015,19/05/2021,10127812015,1012781
2710,09/06/2021,3025,12,2520,190,505,04/05/2021,"Chateau Angelus Premier Grand Cru Classe B, Saint-Emilion Grand Cru",Bordeaux,2008,10/06/2021,10060452008,1006045
709,13/05/2021,818,9,682,27,136,15/09/2020,"Chateau Calon Segur 3eme Cru Classe, Saint-Estephe",Bordeaux,2013,19/05/2021,10074752013,1007475
3827,18/05/2021,4519,71,4116,-289,403,25/02/2021,"Chateau Margaux Premier Cru Classe, Margaux",Bordeaux,2004,19/05/2021,10127812004,1012781
840,14/05/2021,927,16,781,59,146,16/11/2020,"Chateau Calon Segur 3eme Cru Classe, Saint-Estephe",Bordeaux,2008,19/05/2021,10074752008,1007475
1700,18/05/2021,1674,3,1378,322,296,29/07/2020,"Tignanello, Toscana",Tuscany,2001,19/05/2021,10953912001,1095391
1024,17/05/2021,1126,10,1072,-48,54,20/01/2021,"Tignanello, Toscana",Tuscany,2009,19/05/2021,10953912009,1095391
14520,14/07/2021,14520,1,12000,2520,2520,28/05/2020,"Jacques-Frederic Mugnier, Chambolle-Musigny Premier Cru, Les Amoureuses",Burgundy,2014,15/07/2021,10496422014,1049642
1130,14/07/2021,1165,13,1012,118,153,02/07/2021,"Tignanello, Toscana",Tuscany,2015,15/07/2021,10953912015,1095391
1130,04/08/2021,1287,14,1012,118,275,02/07/2021,"Tignanello, Toscana",Tuscany,2015,05/08/2021,10953912015,1095391
8000,04/08/2021,7964,1,7900,100,64,29/04/2019,"Domaine Leflaive, Chevalier-Montrachet Grand Cru",Burgundy,2015,05/08/2021,10734012015,1073401
3900,04/08/2021,4228,49,3690,210,538,13/04/2021,"Chateau Margaux Premier Cru Classe, Margaux",Bordeaux,2011,05/08/2021,10127812011,1012781
1326,04/08/2021,1413,5,1170,156,243,24/06/2021,"Tignanello, Toscana",Tuscany,2010,05/08/2021,10953912010,1095391
907,04/08/2021,953,23,805,102,148,20/11/2019,"Chateau Calon Segur 3eme Cru Classe, Saint-Estephe",Bordeaux,2001,05/08/2021,10074752001,1007475
8300,04/08/2021,9401,16,8200,100,1201,26/07/2021,"Chateau Margaux Premier Cru Classe, Margaux",Bordeaux,2000,05/08/2021,10127812000,1012781
354,08/06/2021,415,20,357,-3,58,06/05/2021,"Chateau Batailley 5eme Cru Classe, Pauillac",Bordeaux,2018,09/06/2021,10063222018,1006322
790,18/05/2021,974,17,745,45,229,16/11/2020,"Chateau Calon Segur 3eme Cru Classe, Saint-Estephe",Bordeaux,2004,19/05/2021,10074752004,1007475
1280,18/05/2021,1318,5,1200,80,118,06/03/2021,"Tignanello, Toscana",Tuscany,2007,19/05/2021,10953912007,1095391
6300,18/05/2021,7632,52,5922,378,1710,13/04/2021,"Chateau Margaux Premier Cru Classe, Margaux",Bordeaux,2010,19/05/2021,10127812010,1012781
2710,09/06/2021,2986,10,2520,190,466,04/05/2021,"Chateau Angelus Premier Grand Cru Classe B, Saint-Emilion Grand Cru",Bordeaux,2008,11/06/2021,10060452008,1006045
354,08/06/2021,415,19,357,-3,58,06/05/2021,"Chateau Batailley 5eme Cru Classe, Pauillac",Bordeaux,2018,18/06/2021,10063222018,1006322
3800,04/08/2021,4349,127,3600,200,749,02/08/2021,"Chateau Margaux Premier Cru Classe, Margaux",Bordeaux,2014,05/08/2021,10127812014,1012781
3800,04/08/2021,4532,56,3525,275,1007,18/06/2021,"Chateau Margaux Premier Cru Classe, Margaux",Bordeaux,2007,05/08/2021,10127812007,1012781
2710,09/06/2021,3025,12,2520,190,505,04/05/2021,"Chateau Angelus Premier Grand Cru Classe B, Saint-Emilion Grand Cru",Bordeaux,2008,10/06/2021,10060452008,1006045
3820,04/08/2021,4614,220,3950,-130,664,30/06/2021,"Chateau Margaux Premier Cru Classe, Margaux",Bordeaux,2017,05/08/2021,10127812017,1012781
1400,04/08/2021,1427,9,1360,40,67,18/07/2021,"Gaja, Barbaresco",Piedmont,2013,05/08/2021,10996052013,1099605
2710,09/06/2021,2986,10,2520,190,466,04/05/2021,"Chateau Angelus Premier Grand Cru Classe B, Saint-Emilion Grand Cru",Bordeaux,2008,11/06/2021,10060452008,1006045
2710,07/06/2021,3025,12,2520,190,505,04/05/2021,"Chateau Angelus Premier Grand Cru Classe B, Saint-Emilion Grand Cru",Bordeaux,2008,08/06/2021,10060452008,1006045
3600,18/05/2021,4398,124,3690,-90,708,13/04/2021,"Chateau Margaux Premier Cru Classe, Margaux",Bordeaux,2011,19/05/2021,10127812011,1012781
3950,18/05/2021,4461,89,3800,150,661,12/05/2021,"Chateau Margaux Premier Cru Classe, Margaux",Bordeaux,2008,19/05/2021,10127812008,1012781
2260,18/05/2021,2305,4,2190,70,115,01/05/2021,"Gaja, Barbaresco",Piedmont,2004,19/05/2021,10996052004,1099605
3860,10/05/2021,4823,76,3800,60,1023,07/04/2021,"Chateau Margaux Premier Cru Classe, Margaux",Bordeaux,2006,19/05/2021,10127812006,1012781
1440,04/08/2021,1679,31,1510,-70,169,18/07/2021,"Gaja, Barbaresco",Piedmont,2016,05/08/2021,10996052016,1099605
6930,04/08/2021,7719,70,7086,-156,633,11/06/2021,"Chateau Margaux Premier Cru Classe, Margaux",Bordeaux,2009,05/08/2021,10127812009,1012781
354,08/06/2021,418,19,357,-3,61,06/05/2021,"Chateau Batailley 5eme Cru Classe, Pauillac",Bordeaux,2018,22/06/2021,10063222018,1006322
2710,07/06/2021,3025,12,2520,190,505,04/05/2021,"Chateau Angelus Premier Grand Cru Classe B, Saint-Emilion Grand Cru",Bordeaux,2008,08/06/2021,10060452008,1006045
900,18/05/2021,1080,20,850,50,230,28/01/2021,"Tignanello, Toscana",Tuscany,2012,19/05/2021,10953912012,1095391
750,28/06/2021,995,35,790,-40,205,01/06/2020,"Chateau Calon Segur 3eme Cru Classe, Saint-Estephe",Bordeaux,2011,30/06/2021,10074752011,1007475
480,09/06/2021,526,4,420,60,106,09/07/2019,"Chateau Batailley 5eme Cru Classe, Pauillac",Bordeaux,2003,10/06/2021,10063222003,1006322
2710,03/06/2021,3044,10,2520,190,524,04/05/2021,"Chateau Angelus Premier Grand Cru Classe B, Saint-Emilion Grand Cru",Bordeaux,2008,04/06/2021,10060452008,1006045
790,13/05/2021,929,41,794,-4,135,20/04/2021,"Chateau Calon Segur 3eme Cru Classe, Saint-Estephe",Bordeaux,2014,19/05/2021,10074752014,1007475
3740,18/05/2021,3972,48,3520,220,452,07/04/2021,"Chateau Margaux Premier Cru Classe, Margaux",Bordeaux,2013,19/05/2021,10127812013,1012781
2710,03/06/2021,3025,12,2520,190,505,04/05/2021,"Chateau Angelus Premier Grand Cru Classe B, Saint-Emilion Grand Cru",Bordeaux,2008,05/06/2021,10060452008,1006045
2710,03/06/2021,3044,10,2520,190,524,04/05/2021,"Chateau Angelus Premier Grand Cru Classe B, Saint-Emilion Grand Cru",Bordeaux,2008,04/06/2021,10060452008,1006045
5600,05/08/2021,6014,50,5254,346,760,26/05/2021,"Chateau Margaux Premier Cru Classe, Margaux",Bordeaux,2018,06/08/2021,10127812018,1012781
768,14/05/2021,926,13,705,63,221,01/02/2021,"Chateau Calon Segur 3eme Cru Classe, Saint-Estephe",Bordeaux,2002,19/05/2021,10074752002,1007475
2710,03/06/2021,3025,12,2520,190,505,04/05/2021,"Chateau Angelus Premier Grand Cru Classe B, Saint-Emilion Grand Cru",Bordeaux,2008,05/06/2021,10060452008,1006045
530,09/06/2021,675,93,450,80,225,04/05/2021,"Chateau Batailley 5eme Cru Classe, Pauillac",Bordeaux,2005,10/06/2021,10063222005,1006322
1240,14/07/2021,1281,82,1220,20,61,14/07/2021,"Tignanello, Toscana",Tuscany,2016,15/07/2021,10953912016,1095391
4850,13/05/2021,5822,27,4800,50,1022,11/03/2021,"Chateau Margaux Premier Cru Classe, Margaux",Bordeaux,2003,19/05/2021,10127812003,1012781
3750,18/05/2021,4096,29,3592,158,504,06/05/2021,"Chateau Margaux Premier Cru Classe, Margaux",Bordeaux,2007,19/05/2021,10127812007,1012781
950,18/05/2021,1098,45,830,120,268,18/04/2021,"Tignanello, Toscana",Tuscany,2014,19/05/2021,10953912014,1095391
811,13/05/2021,973,6,735,76,238,09/09/2020,"Chateau Calon Segur 3eme Cru Classe, Saint-Estephe",Bordeaux,2012,19/05/2021,10074752012,1007475
1500,14/07/2021,1675,42,1400,100,275,08/07/2021,"Gaja, Barbaresco",Piedmont,2016,15/07/2021,10996052016,1099605
8568,05/08/2021,8730,4,7330,1238,1400,02/06/2021,"Domaine Leflaive, Chevalier-Montrachet Grand Cru",Burgundy,2018,06/08/2021,10734012018,1073401
8000,05/08/2021,7964,1,7900,100,64,29/04/2019,"Domaine Leflaive, Chevalier-Montrachet Grand Cru",Burgundy,2015,06/08/2021,10734012015,1073401
1028,23/07/2021,1229,48,1058,-30,171,14/07/2021,"Chateau Calon Segur 3eme Cru Classe, Saint-Estephe",Bordeaux,2018,06/08/2021,10074752018,1007475
3700,09/08/2021,4177,57,3520,180,657,07/04/2021,"Chateau Margaux Premier Cru Classe, Margaux",Bordeaux,2013,10/08/2021,10127812013,1012781
880,09/08/2021,967,9,725,155,242,13/04/2021,"Chateau Calon Segur 3eme Cru Classe, Saint-Estephe",Bordeaux,2007,10/08/2021,10074752007,1007475
8300,09/08/2021,9314,18,8200,100,1114,26/07/2021,"Chateau Margaux Premier Cru Classe, Margaux",Bordeaux,2000,10/08/2021,10127812000,1012781
6930,09/08/2021,7721,59,7086,-156,635,11/06/2021,"Chateau Margaux Premier Cru Classe, Margaux",Bordeaux,2009,10/08/2021,10127812009,1012781
790,05/08/2021,868,17,801,-11,67,31/05/2021,"Chateau Calon Segur 3eme Cru Classe, Saint-Estephe",Bordeaux,2014,06/08/2021,10074752014,1007475
2655,31/05/2021,2996,10,2520,135,476,04/05/2021,"Chateau Angelus Premier Grand Cru Classe B, Saint-Emilion Grand Cru",Bordeaux,2008,01/06/2021,10060452008,1006045
2199,04/08/2021,2153,1,1340,859,813,13/03/2020,"Gaja, Barbaresco",Piedmont,2009,06/08/2021,10996052009,1099605
530,09/06/2021,675,93,450,80,225,04/05/2021,"Chateau Batailley 5eme Cru Classe, Pauillac",Bordeaux,2005,10/06/2021,10063222005,1006322
780,14/07/2021,935,77,740,40,195,21/05/2021,"Chateau Calon Segur 3eme Cru Classe, Saint-Estephe",Bordeaux,2017,15/07/2021,10074752017,1007475
3800,14/07/2021,4483,144,3950,-150,533,30/06/2021,"Chateau Margaux Premier Cru Classe, Margaux",Bordeaux,2017,15/07/2021,10127812017,1012781
1350,14/07/2021,1480,56,1260,90,220,18/02/2021,"Gaja, Barbaresco",Piedmont,2015,15/07/2021,10996052015,1099605
460,14/07/2021,487,154,420,40,67,28/05/2021,"Tua Rita, Giusto di Notri, Toscana",Tuscany,2016,15/07/2021,11058072016,1105807
8000,14/07/2021,8676,4,6974,1026,1702,14/03/2021,"Domaine Leflaive, Chevalier-Montrachet Grand Cru",Burgundy,2017,15/07/2021,10734012017,1073401
420,09/06/2021,521,5,400,20,121,11/05/2021,"Chateau Batailley 5eme Cru Classe, Pauillac",Bordeaux,2006,10/06/2021,10063222006,1006322
1150,05/08/2021,1140,7,952,198,188,04/08/2021,"Tignanello, Toscana",Tuscany,2013,06/08/2021,10953912013,1095391
420,09/06/2021,521,5,400,20,121,11/05/2021,"Chateau Batailley 5eme Cru Classe, Pauillac",Bordeaux,2006,10/06/2021,10063222006,1006322
3700,05/08/2021,4167,47,3520,180,647,07/04/2021,"Chateau Margaux Premier Cru Classe, Margaux",Bordeaux,2013,06/08/2021,10127812013,1012781
1320,28/06/2021,1472,3,1170,150,302,24/06/2021,"Tignanello, Toscana",Tuscany,2010,30/06/2021,10953912010,1095391
895,05/08/2021,966,53,863,32,103,10/05/2021,"Chateau Calon Segur 3eme Cru Classe, Saint-Estephe",Bordeaux,2006,06/08/2021,10074752006,1007475
3758,29/06/2021,4043,74,3690,68,353,13/04/2021,"Chateau Margaux Premier Cru Classe, Margaux",Bordeaux,2011,30/06/2021,10127812011,1012781
2655,31/05/2021,3041,10,2520,135,521,04/05/2021,"Chateau Angelus Premier Grand Cru Classe B, Saint-Emilion Grand Cru",Bordeaux,2008,02/06/2021,10060452008,1006045
2655,31/05/2021,2996,10,2520,135,476,04/05/2021,"Chateau Angelus Premier Grand Cru Classe B, Saint-Emilion Grand Cru",Bordeaux,2008,01/06/2021,10060452008,1006045
5100,30/07/2021,5919,25,4650,450,1269,21/06/2021,"Chateau Margaux Premier Cru Classe, Margaux",Bordeaux,2003,31/07/2021,10127812003,1012781
2655,31/05/2021,3041,10,2520,135,521,04/05/2021,"Chateau Angelus Premier Grand Cru Classe B, Saint-Emilion Grand Cru",Bordeaux,2008,02/06/2021,10060452008,1006045
840,30/07/2021,1060,20,745,95,315,16/11/2020,"Chateau Calon Segur 3eme Cru Classe, Saint-Estephe",Bordeaux,2004,31/07/2021,10074752004,1007475
2710,28/05/2021,3038,11,2520,190,518,04/05/2021,"Chateau Angelus Premier Grand Cru Classe B, Saint-Emilion Grand Cru",Bordeaux,2008,29/05/2021,10060452008,1006045
907,30/07/2021,953,23,805,102,148,20/11/2019,"Chateau Calon Segur 3eme Cru Classe, Saint-Estephe",Bordeaux,2001,31/07/2021,10074752001,1007475
450,09/06/2021,450,1,340,110,110,31/08/2018,"Chateau Batailley 5eme Cru Classe, Pauillac",Bordeaux,2007,10/06/2021,10063222007,1006322
2710,28/05/2021,3038,11,2520,190,518,04/05/2021,"Chateau Angelus Premier Grand Cru Classe B, Saint-Emilion Grand Cru",Bordeaux,2008,29/05/2021,10060452008,1006045
400,09/06/2021,427,8,355,45,72,15/04/2021,"Chateau Batailley 5eme Cru Classe, Pauillac",Bordeaux,2012,10/06/2021,10063222012,1006322
6500,30/07/2021,7565,28,6400,100,1165,22/07/2021,"Chateau Margaux Premier Cru Classe, Margaux",Bordeaux,2005,31/07/2021,10127812005,1012781
2710,26/05/2021,3038,11,2520,190,518,04/05/2021,"Chateau Angelus Premier Grand Cru Classe B, Saint-Emilion Grand Cru",Bordeaux,2008,27/05/2021,10060452008,1006045
990,30/07/2021,1179,63,1029,-39,150,21/07/2021,"Chateau Calon Segur 3eme Cru Classe, Saint-Estephe",Bordeaux,2005,31/07/2021,10074752005,1007475
400,09/06/2021,427,8,355,45,72,15/04/2021,"Chateau Batailley 5eme Cru Classe, Pauillac",Bordeaux,2012,10/06/2021,10063222012,1006322
300,09/06/2021,301,105,304,-4,-3,10/01/2021,"Chateau Batailley 5eme Cru Classe, Pauillac",Bordeaux,2013,10/06/2021,10063222013,1006322
3900,05/08/2021,4228,49,3690,210,538,13/04/2021,"Chateau Margaux Premier Cru Classe, Margaux",Bordeaux,2011,06/08/2021,10127812011,1012781
895,05/08/2021,950,9,781,114,169,16/11/2020,"Chateau Calon Segur 3eme Cru Classe, Saint-Estephe",Bordeaux,2008,06/08/2021,10074752008,1007475
476,09/06/2021,524,46,364,112,160,12/05/2021,"Chateau Batailley 5eme Cru Classe, Pauillac",Bordeaux,2016,10/06/2021,10063222016,1006322
1022,28/06/2021,1051,8,880,142,171,22/06/2021,"Tignanello, Toscana",Tuscany,2011,30/06/2021,10953912011,1095391
2710,26/05/2021,3038,11,2520,190,518,04/05/2021,"Chateau Angelus Premier Grand Cru Classe B, Saint-Emilion Grand Cru",Bordeaux,2008,27/05/2021,10060452008,1006045
1570,03/08/2021,1495,4,1352,218,143,23/09/2020,"Gaja, Barbaresco",Piedmont,2011,06/08/2021,10996052011,1099605
686,05/08/2021,773,23,682,4,91,15/09/2020,"Chateau Calon Segur 3eme Cru Classe, Saint-Estephe",Bordeaux,2013,06/08/2021,10074752013,1007475
3900,04/08/2021,4442,22,3684,216,758,10/06/2020,"Chateau Margaux Premier Cru Classe, Margaux",Bordeaux,2002,06/08/2021,10127812002,1012781
8100,15/06/2021,8469,19,7950,150,519,12/03/2021,"Chateau Margaux Premier Cru Classe, Margaux",Bordeaux,2000,16/06/2021,10127812000,1012781
1050,15/06/2021,1212,23,940,110,272,18/03/2021,"Chateau Calon Segur 3eme Cru Classe, Saint-Estephe",Bordeaux,2000,16/06/2021,10074752000,1007475
6250,15/06/2021,7421,48,6776,-526,645,10/06/2021,"Chateau Margaux Premier Cru Classe, Margaux",Bordeaux,2005,16/06/2021,10127812005,1012781
900,15/06/2021,1090,29,800,100,290,21/11/2019,"Chateau Calon Segur 3eme Cru Classe, Saint-Estephe",Bordeaux,2003,16/06/2021,10074752003,1007475
870,15/06/2021,948,10,705,165,243,01/02/2021,"Chateau Calon Segur 3eme Cru Classe, Saint-Estephe",Bordeaux,2002,16/06/2021,10074752002,1007475
1000,15/06/2021,1147,82,988,12,159,28/05/2021,"Chateau Calon Segur 3eme Cru Classe, Saint-Estephe",Bordeaux,2005,16/06/2021,10074752005,1007475
1678,15/06/2021,1648,4,1180,498,468,25/06/2020,"Tignanello, Toscana",Tuscany,2004,16/06/2021,10953912004,1095391
3758,15/06/2021,4049,97,3690,68,359,13/04/2021,"Chateau Margaux Premier Cru Classe, Margaux",Bordeaux,2011,16/06/2021,10127812011,1012781
686,15/06/2021,844,13,682,4,162,15/09/2020,"Chateau Calon Segur 3eme Cru Classe, Saint-Estephe",Bordeaux,2013,16/06/2021,10074752013,1007475
1260,15/06/2021,1375,7,1172,88,203,07/04/2021,"Tignanello, Toscana",Tuscany,2010,16/06/2021,10953912010,1095391
750,15/06/2021,1002,51,790,-40,212,01/06/2020,"Chateau Calon Segur 3eme Cru Classe, Saint-Estephe",Bordeaux,2011,16/06/2021,10074752011,1007475
2098,15/06/2021,2331,5,2190,-92,141,01/05/2021,"Gaja, Barbaresco",Piedmont,2004,16/06/2021,10996052004,1099605
3900,15/06/2021,4472,28,3684,216,788,10/06/2020,"Chateau Margaux Premier Cru Classe, Margaux",Bordeaux,2002,16/06/2021,10127812002,1012781
1024,15/06/2021,1213,6,1072,-48,141,20/01/2021,"Tignanello, Toscana",Tuscany,2009,16/06/2021,10953912009,1095391
900,11/06/2021,1259,12,850,50,409,28/01/2021,"Tignanello, Toscana",Tuscany,2012,16/06/2021,10953912012,1095391
640,10/06/2021,674,9,470,170,204,29/03/2018,"Chateau Batailley 5eme Cru Classe, Pauillac",Bordeaux,2000,11/06/2021,10063222000,1006322
6830,15/06/2021,7692,49,7086,-256,606,11/06/2021,"Chateau Margaux Premier Cru Classe, Margaux",Bordeaux,2009,16/06/2021,10127812009,1012781
790,03/06/2021,1088,79,860,-70,228,19/04/2021,"Chateau Calon Segur 3eme Cru Classe, Saint-Estephe",Bordeaux,2015,16/06/2021,10074752015,1007475
6300,15/06/2021,7464,63,6190,110,1274,23/05/2021,"Chateau Margaux Premier Cru Classe, Margaux",Bordeaux,2010,16/06/2021,10127812010,1012781
3720,15/06/2021,4290,146,3480,240,810,10/04/2021,"Chateau Margaux Premier Cru Classe, Margaux",Bordeaux,2014,16/06/2021,10127812014,1012781
3826,15/06/2021,4525,55,4116,-290,409,25/02/2021,"Chateau Margaux Premier Cru Classe, Margaux",Bordeaux,2004,16/06/2021,10127812004,1012781
990,15/06/2021,1109,20,1000,-10,109,12/04/2021,"Chateau Calon Segur 3eme Cru Classe, Saint-Estephe",Bordeaux,2010,16/06/2021,10074752010,1007475
3560,15/06/2021,4062,33,3592,-32,470,06/05/2021,"Chateau Margaux Premier Cru Classe, Margaux",Bordeaux,2007,16/06/2021,10127812007,1012781
10100,11/06/2021,12006,54,9800,300,2206,11/06/2021,"Chateau Margaux Premier Cru Classe, Margaux",Bordeaux,2015,16/06/2021,10127812015,1012781
1000,15/06/2021,1177,44,1030,-30,147,25/05/2021,"Chateau Calon Segur 3eme Cru Classe, Saint-Estephe",Bordeaux,2009,16/06/2021,10074752009,1007475
2710,24/05/2021,3038,11,2520,190,518,04/05/2021,"Chateau Angelus Premier Grand Cru Classe B, Saint-Emilion Grand Cru",Bordeaux,2008,25/05/2021,10060452008,1006045
3800,05/08/2021,4349,128,3600,200,749,02/08/2021,"Chateau Margaux Premier Cru Classe, Margaux",Bordeaux,2014,06/08/2021,10127812014,1012781
1700,15/06/2021,1658,4,1378,322,280,29/07/2020,"Tignanello, Toscana",Tuscany,2001,16/06/2021,10953912001,1095391
2710,24/05/2021,3038,11,2520,190,518,04/05/2021,"Chateau Angelus Premier Grand Cru Classe B, Saint-Emilion Grand Cru",Bordeaux,2008,25/05/2021,10060452008,1006045
830,03/06/2021,989,6,735,95,254,09/09/2020,"Chateau Calon Segur 3eme Cru Classe, Saint-Estephe",Bordeaux,2012,16/06/2021,10074752012,1007475
2710,20/05/2021,3038,11,2520,190,518,04/05/2021,"Chateau Angelus Premier Grand Cru Classe B, Saint-Emilion Grand Cru",Bordeaux,2008,22/05/2021,10060452008,1006045
3900,15/06/2021,4428,110,3700,200,728,07/06/2021,"Chateau Margaux Premier Cru Classe, Margaux",Bordeaux,2008,16/06/2021,10127812008,1012781
1299,15/06/2021,1493,7,1010,289,483,18/12/2020,"Tignanello, Toscana",Tuscany,2008,16/06/2021,10953912008,1095391
3826,05/08/2021,4631,44,4116,-290,515,25/02/2021,"Chateau Margaux Premier Cru Classe, Margaux",Bordeaux,2004,06/08/2021,10127812004,1012781
990,05/08/2021,1177,63,1029,-39,148,21/07/2021,"Chateau Calon Segur 3eme Cru Classe, Saint-Estephe",Bordeaux,2005,06/08/2021,10074752005,1007475
4850,11/06/2021,5653,30,4842,8,811,19/05/2021,"Chateau Margaux Premier Cru Classe, Margaux",Bordeaux,2003,16/06/2021,10127812003,1012781
9600,15/06/2021,9798,2,8000,1600,1798,30/01/2020,"Domaine Leflaive, Chevalier-Montrachet Grand Cru",Burgundy,2014,16/06/2021,10734012014,1073401
880,15/06/2021,986,13,725,155,261,13/04/2021,"Chateau Calon Segur 3eme Cru Classe, Saint-Estephe",Bordeaux,2007,16/06/2021,10074752007,1007475
3740,15/06/2021,3977,53,3520,220,457,07/04/2021,"Chateau Margaux Premier Cru Classe, Margaux",Bordeaux,2013,16/06/2021,10127812013,1012781
950,15/06/2021,1020,53,863,87,157,10/05/2021,"Chateau Calon Segur 3eme Cru Classe, Saint-Estephe",Bordeaux,2006,16/06/2021,10074752006,1007475
1245,15/06/2021,1545,3,882,363,663,26/04/2019,"Tignanello, Toscana",Tuscany,2003,16/06/2021,10953912003,1095391
870,14/06/2021,948,10,705,165,243,01/02/2021,"Chateau Calon Segur 3eme Cru Classe, Saint-Estephe",Bordeaux,2002,15/06/2021,10074752002,1007475
2710,20/05/2021,3041,10,2520,190,521,04/05/2021,"Chateau Angelus Premier Grand Cru Classe B, Saint-Emilion Grand Cru",Bordeaux,2008,21/05/2021,10060452008,1006045
3750,14/06/2021,4206,41,3560,190,646,20/11/2020,"Chateau Margaux Premier Cru Classe, Margaux",Bordeaux,2012,15/06/2021,10127812012,1012781
1408,15/06/2021,1368,1,1150,258,218,21/04/2019,"Tignanello, Toscana",Tuscany,2005,16/06/2021,10953912005,1095391
8100,11/06/2021,8469,19,7950,150,519,12/03/2021,"Chateau Margaux Premier Cru Classe, Margaux",Bordeaux,2000,15/06/2021,10127812000,1012781
1408,15/06/2021,1386,5,1238,170,148,02/11/2020,"Tignanello, Toscana",Tuscany,2006,16/06/2021,10953912006,1095391
2430,14/06/2021,3208,4,2220,210,988,14/06/2021,"Gaja, Barbaresco",Piedmont,2001,15/06/2021,10996052001,1099605
2232,10/06/2021,2343,5,2190,42,153,01/05/2021,"Gaja, Barbaresco",Piedmont,2004,15/06/2021,10996052004,1099605
2710,20/05/2021,3041,10,2520,190,521,04/05/2021,"Chateau Angelus Premier Grand Cru Classe B, Saint-Emilion Grand Cru",Bordeaux,2008,21/05/2021,10060452008,1006045
2710,20/05/2021,3038,11,2520,190,518,04/05/2021,"Chateau Angelus Premier Grand Cru Classe B, Saint-Emilion Grand Cru",Bordeaux,2008,22/05/2021,10060452008,1006045
2710,18/05/2021,3053,9,2520,190,533,04/05/2021,"Chateau Angelus Premier Grand Cru Classe B, Saint-Emilion Grand Cru",Bordeaux,2008,19/05/2021,10060452008,1006045
9600,14/06/2021,9798,2,8000,1600,1798,30/01/2020,"Domaine Leflaive, Chevalier-Montrachet Grand Cru",Burgundy,2014,15/06/2021,10734012014,1073401
6250,14/06/2021,7420,48,6776,-526,644,10/06/2021,"Chateau Margaux Premier Cru Classe, Margaux",Bordeaux,2005,15/06/2021,10127812005,1012781
1300,11/06/2021,1353,4,1200,100,153,06/03/2021,"Tignanello, Toscana",Tuscany,2007,15/06/2021,10953912007,1095391
880,14/06/2021,986,13,725,155,261,13/04/2021,"Chateau Calon Segur 3eme Cru Classe, Saint-Estephe",Bordeaux,2007,15/06/2021,10074752007,1007475
6830,11/06/2021,7692,49,7086,-256,606,11/06/2021,"Chateau Margaux Premier Cru Classe, Margaux",Bordeaux,2009,15/06/2021,10127812009,1012781
2710,18/05/2021,3041,10,2520,190,521,04/05/2021,"Chateau Angelus Premier Grand Cru Classe B, Saint-Emilion Grand Cru",Bordeaux,2008,20/05/2021,10060452008,1006045
3900,14/06/2021,4616,93,3861,39,755,28/05/2021,"Chateau Margaux Premier Cru Classe, Margaux",Bordeaux,2006,15/06/2021,10127812006,1012781
3720,14/06/2021,4292,146,3480,240,812,10/04/2021,"Chateau Margaux Premier Cru Classe, Margaux",Bordeaux,2014,15/06/2021,10127812014,1012781
950,14/06/2021,1020,53,863,87,157,10/05/2021,"Chateau Calon Segur 3eme Cru Classe, Saint-Estephe",Bordeaux,2006,15/06/2021,10074752006,1007475
3758,14/06/2021,4050,97,3690,68,360,13/04/2021,"Chateau Margaux Premier Cru Classe, Margaux",Bordeaux,2011,15/06/2021,10127812011,1012781
640,10/06/2021,674,9,470,170,204,29/03/2018,"Chateau Batailley 5eme Cru Classe, Pauillac",Bordeaux,2000,11/06/2021,10063222000,1006322
3560,09/06/2021,4071,32,3592,-32,479,06/05/2021,"Chateau Margaux Premier Cru Classe, Margaux",Bordeaux,2007,15/06/2021,10127812007,1012781
2710,18/05/2021,3053,9,2520,190,533,04/05/2021,"Chateau Angelus Premier Grand Cru Classe B, Saint-Emilion Grand Cru",Bordeaux,2008,19/05/2021,10060452008,1006045
1260,14/06/2021,1375,7,1172,88,203,07/04/2021,"Tignanello, Toscana",Tuscany,2010,15/06/2021,10953912010,1095391
4386,02/06/2021,4731,27,4400,-14,331,29/09/2020,"Chateau Margaux Premier Cru Classe, Margaux",Bordeaux,2001,15/06/2021,10127812001,1012781
480,10/06/2021,526,4,420,60,106,09/07/2019,"Chateau Batailley 5eme Cru Classe, Pauillac",Bordeaux,2003,11/06/2021,10063222003,1006322
900,11/06/2021,1223,14,850,50,373,28/01/2021,"Tignanello, Toscana",Tuscany,2012,15/06/2021,10953912012,1095391
2710,18/05/2021,3041,10,2520,190,521,04/05/2021,"Chateau Angelus Premier Grand Cru Classe B, Saint-Emilion Grand Cru",Bordeaux,2008,20/05/2021,10060452008,1006045
2710,14/05/2021,3051,9,2520,190,531,04/05/2021,"Chateau Angelus Premier Grand Cru Classe B, Saint-Emilion Grand Cru",Bordeaux,2008,18/05/2021,10060452008,1006045
2710,14/05/2021,3051,9,2520,190,531,04/05/2021,"Chateau Angelus Premier Grand Cru Classe B, Saint-Emilion Grand Cru",Bordeaux,2008,18/05/2021,10060452008,1006045
2710,14/05/2021,2958,12,2520,190,438,04/05/2021,"Chateau Angelus Premier Grand Cru Classe B, Saint-Emilion Grand Cru",Bordeaux,2008,15/05/2021,10060452008,1006045
2710,14/05/2021,2958,12,2520,190,438,04/05/2021,"Chateau Angelus Premier Grand Cru Classe B, Saint-Emilion Grand Cru",Bordeaux,2008,15/05/2021,10060452008,1006045
3900,14/06/2021,4428,110,3700,200,728,07/06/2021,"Chateau Margaux Premier Cru Classe, Margaux",Bordeaux,2008,15/06/2021,10127812008,1012781
10100,11/06/2021,11967,52,9800,300,2167,11/06/2021,"Chateau Margaux Premier Cru Classe, Margaux",Bordeaux,2015,15/06/2021,10127812015,1012781
2710,12/05/2021,2958,12,2520,190,438,04/05/2021,"Chateau Angelus Premier Grand Cru Classe B, Saint-Emilion Grand Cru",Bordeaux,2008,13/05/2021,10060452008,1006045
6300,14/06/2021,7464,63,6190,110,1274,23/05/2021,"Chateau Margaux Premier Cru Classe, Margaux",Bordeaux,2010,15/06/2021,10127812010,1012781
907,14/06/2021,957,24,805,102,152,20/11/2019,"Chateau Calon Segur 3eme Cru Classe, Saint-Estephe",Bordeaux,2001,15/06/2021,10074752001,1007475
686,14/06/2021,838,12,682,4,156,15/09/2020,"Chateau Calon Segur 3eme Cru Classe, Saint-Estephe",Bordeaux,2013,15/06/2021,10074752013,1007475
990,14/06/2021,1109,20,1000,-10,109,12/04/2021,"Chateau Calon Segur 3eme Cru Classe, Saint-Estephe",Bordeaux,2010,15/06/2021,10074752010,1007475
6930,06/08/2021,7722,59,7086,-156,636,11/06/2021,"Chateau Margaux Premier Cru Classe, Margaux",Bordeaux,2009,08/08/2021,10127812009,1012781
450,10/06/2021,450,1,340,110,110,31/08/2018,"Chateau Batailley 5eme Cru Classe, Pauillac",Bordeaux,2007,11/06/2021,10063222007,1006322
1024,09/06/2021,1240,7,1072,-48,168,20/01/2021,"Tignanello, Toscana",Tuscany,2009,15/06/2021,10953912009,1095391
3740,14/06/2021,3977,53,3520,220,457,07/04/2021,"Chateau Margaux Premier Cru Classe, Margaux",Bordeaux,2013,15/06/2021,10127812013,1012781
1000,15/06/2021,1177,44,1030,-30,147,25/05/2021,"Chateau Calon Segur 3eme Cru Classe, Saint-Estephe",Bordeaux,2009,16/06/2021,10074752009,1007475
2710,12/05/2021,2958,12,2520,190,438,04/05/2021,"Chateau Angelus Premier Grand Cru Classe B, Saint-Emilion Grand Cru",Bordeaux,2008,13/05/2021,10060452008,1006045
490,10/06/2021,584,18,450,40,134,25/05/2021,"Chateau Batailley 5eme Cru Classe, Pauillac",Bordeaux,2009,11/06/2021,10063222009,1006322
820,29/06/2021,939,6,735,85,204,09/09/2020,"Chateau Calon Segur 3eme Cru Classe, Saint-Estephe",Bordeaux,2012,30/06/2021,10074752012,1007475
3750,24/06/2021,4160,41,3560,190,600,20/11/2020,"Chateau Margaux Premier Cru Classe, Margaux",Bordeaux,2012,30/06/2021,10127812012,1012781
3740,29/06/2021,4016,53,3520,220,496,07/04/2021,"Chateau Margaux Premier Cru Classe, Margaux",Bordeaux,2013,30/06/2021,10127812013,1012781
2710,10/05/2021,2958,12,2520,190,438,04/05/2021,"Chateau Angelus Premier Grand Cru Classe B, Saint-Emilion Grand Cru",Bordeaux,2008,11/05/2021,10060452008,1006045
686,29/06/2021,826,7,682,4,144,15/09/2020,"Chateau Calon Segur 3eme Cru Classe, Saint-Estephe",Bordeaux,2013,30/06/2021,10074752013,1007475
3720,29/06/2021,4320,146,3480,240,840,17/06/2021,"Chateau Margaux Premier Cru Classe, Margaux",Bordeaux,2014,30/06/2021,10127812014,1012781
790,25/06/2021,903,23,801,-11,102,31/05/2021,"Chateau Calon Segur 3eme Cru Classe, Saint-Estephe",Bordeaux,2014,30/06/2021,10074752014,1007475
1080,28/06/2021,1164,6,860,220,304,08/03/2021,"Tignanello, Toscana",Tuscany,2013,30/06/2021,10953912013,1095391
970,28/06/2021,1106,42,830,140,276,22/06/2021,"Tignanello, Toscana",Tuscany,2014,30/06/2021,10953912014,1095391
850,29/06/2021,1078,85,822,28,256,28/06/2021,"Chateau Calon Segur 3eme Cru Classe, Saint-Estephe",Bordeaux,2015,30/06/2021,10074752015,1007475
750,09/08/2021,950,47,790,-40,160,01/06/2020,"Chateau Calon Segur 3eme Cru Classe, Saint-Estephe",Bordeaux,2011,10/08/2021,10074752011,1007475
10400,29/06/2021,11947,51,9800,600,2147,11/06/2021,"Chateau Margaux Premier Cru Classe, Margaux",Bordeaux,2015,30/06/2021,10127812015,1012781
7812,02/07/2021,7812,0,8540,-728,-728,02/12/2019,"Domaine Leflaive, Chevalier-Montrachet Grand Cru",Burgundy,2001,03/07/2021,10734012001,1073401
1040,30/06/2021,1204,23,940,100,264,18/03/2021,"Chateau Calon Segur 3eme Cru Classe, Saint-Estephe",Bordeaux,2000,01/07/2021,10074752000,1007475
870,30/06/2021,954,4,705,165,249,01/02/2021,"Chateau Calon Segur 3eme Cru Classe, Saint-Estephe",Bordeaux,2002,01/07/2021,10074752002,1007475
8100,30/06/2021,8354,14,8100,0,254,21/06/2021,"Chateau Margaux Premier Cru Classe, Margaux",Bordeaux,2000,01/07/2021,10127812000,1012781
900,30/06/2021,1055,23,800,100,255,21/11/2019,"Chateau Calon Segur 3eme Cru Classe, Saint-Estephe",Bordeaux,2003,01/07/2021,10074752003,1007475
1050,09/08/2021,1103,7,1160,-110,-57,09/08/2021,"Tignanello, Toscana",Tuscany,2014,10/08/2021,10953912014,1095391
895,09/08/2021,963,53,863,32,100,10/05/2021,"Chateau Calon Segur 3eme Cru Classe, Saint-Estephe",Bordeaux,2006,10/08/2021,10074752006,1007475
995,09/08/2021,1113,18,993,2,120,27/07/2021,"Chateau Calon Segur 3eme Cru Classe, Saint-Estephe",Bordeaux,2010,10/08/2021,10074752010,1007475
940,09/08/2021,1076,76,866,74,210,20/07/2021,"Chateau Calon Segur 3eme Cru Classe, Saint-Estephe",Bordeaux,2015,10/08/2021,10074752015,1007475
3900,09/08/2021,4229,46,3690,210,539,13/04/2021,"Chateau Margaux Premier Cru Classe, Margaux",Bordeaux,2011,10/08/2021,10127812011,1012781
990,09/08/2021,1177,63,1029,-39,148,21/07/2021,"Chateau Calon Segur 3eme Cru Classe, Saint-Estephe",Bordeaux,2005,10/08/2021,10074752005,1007475
1010,12/05/2021,1048,9,860,150,188,08/03/2021,"Tignanello, Toscana",Tuscany,2011,14/05/2021,10953912011,1095391
830,12/05/2021,927,16,781,49,146,16/11/2020,"Chateau Calon Segur 3eme Cru Classe, Saint-Estephe",Bordeaux,2008,14/05/2021,10074752008,1007475
709,13/05/2021,819,7,682,27,137,15/09/2020,"Chateau Calon Segur 3eme Cru Classe, Saint-Estephe",Bordeaux,2013,14/05/2021,10074752013,1007475
1300,13/05/2021,1342,3,1200,100,142,06/03/2021,"Tignanello, Toscana",Tuscany,2007,14/05/2021,10953912007,1095391
1000,13/05/2021,1167,79,975,25,192,12/04/2021,"Chateau Calon Segur 3eme Cru Classe, Saint-Estephe",Bordeaux,2005,14/05/2021,10074752005,1007475
1100,13/05/2021,1536,7,1010,90,526,18/12/2020,"Tignanello, Toscana",Tuscany,2008,14/05/2021,10953912008,1095391
490,10/06/2021,584,18,450,40,134,25/05/2021,"Chateau Batailley 5eme Cru Classe, Pauillac",Bordeaux,2009,11/06/2021,10063222009,1006322
920,04/05/2021,1096,46,830,90,266,18/04/2021,"Tignanello, Toscana",Tuscany,2014,14/05/2021,10953912014,1095391
880,13/05/2021,967,9,725,155,242,13/04/2021,"Chateau Calon Segur 3eme Cru Classe, Saint-Estephe",Bordeaux,2007,14/05/2021,10074752007,1007475
2710,10/05/2021,2958,12,2520,190,438,04/05/2021,"Chateau Angelus Premier Grand Cru Classe B, Saint-Emilion Grand Cru",Bordeaux,2008,11/05/2021,10060452008,1006045
1408,13/05/2021,1442,5,1238,170,204,02/11/2020,"Tignanello, Toscana",Tuscany,2006,14/05/2021,10953912006,1095391
3800,13/05/2021,4070,50,3480,320,590,10/04/2021,"Chateau Margaux Premier Cru Classe, Margaux",Bordeaux,2014,14/05/2021,10127812014,1012781
8040,13/05/2021,8232,20,7950,90,282,12/03/2021,"Chateau Margaux Premier Cru Classe, Margaux",Bordeaux,2000,14/05/2021,10127812000,1012781
950,13/05/2021,1014,61,863,87,151,10/05/2021,"Chateau Calon Segur 3eme Cru Classe, Saint-Estephe",Bordeaux,2006,14/05/2021,10074752006,1007475
995,13/05/2021,1116,19,1000,-5,116,12/04/2021,"Chateau Calon Segur 3eme Cru Classe, Saint-Estephe",Bordeaux,2010,14/05/2021,10074752010,1007475
2710,07/05/2021,2958,12,2520,190,438,04/05/2021,"Chateau Angelus Premier Grand Cru Classe B, Saint-Emilion Grand Cru",Bordeaux,2008,08/05/2021,10060452008,1006045
2710,07/05/2021,2958,12,2520,190,438,04/05/2021,"Chateau Angelus Premier Grand Cru Classe B, Saint-Emilion Grand Cru",Bordeaux,2008,08/05/2021,10060452008,1006045
400,10/06/2021,427,8,355,45,72,15/04/2021,"Chateau Batailley 5eme Cru Classe, Pauillac",Bordeaux,2012,11/06/2021,10063222012,1006322
1050,11/05/2021,1344,48,940,110,404,18/03/2021,"Chateau Calon Segur 3eme Cru Classe, Saint-Estephe",Bordeaux,2000,14/05/2021,10074752000,1007475
3740,13/05/2021,3962,48,3520,220,442,07/04/2021,"Chateau Margaux Premier Cru Classe, Margaux",Bordeaux,2013,14/05/2021,10127812013,1012781
6300,13/05/2021,7468,55,5922,378,1546,13/04/2021,"Chateau Margaux Premier Cru Classe, Margaux",Bordeaux,2010,14/05/2021,10127812010,1012781
2710,05/05/2021,2935,14,2520,190,415,04/05/2021,"Chateau Angelus Premier Grand Cru Classe B, Saint-Emilion Grand Cru",Bordeaux,2008,07/05/2021,10060452008,1006045
2710,05/05/2021,2932,13,2520,190,412,04/05/2021,"Chateau Angelus Premier Grand Cru Classe B, Saint-Emilion Grand Cru",Bordeaux,2008,06/05/2021,10060452008,1006045
4400,13/05/2021,4902,27,4400,0,502,29/09/2020,"Chateau Margaux Premier Cru Classe, Margaux",Bordeaux,2001,14/05/2021,10127812001,1012781
1120,13/05/2021,1223,12,1172,-52,51,07/04/2021,"Tignanello, Toscana",Tuscany,2010,14/05/2021,10953912010,1095391
4800,12/05/2021,5738,26,4800,0,938,11/03/2021,"Chateau Margaux Premier Cru Classe, Margaux",Bordeaux,2003,14/05/2021,10127812003,1012781
1404,13/05/2021,1407,1,996,408,411,14/06/2019,"Tignanello, Toscana",Tuscany,2000,14/05/2021,10953912000,1095391
2710,05/05/2021,2932,13,2520,190,412,04/05/2021,"Chateau Angelus Premier Grand Cru Classe B, Saint-Emilion Grand Cru",Bordeaux,2008,06/05/2021,10060452008,1006045
2710,05/05/2021,2935,14,2520,190,415,04/05/2021,"Chateau Angelus Premier Grand Cru Classe B, Saint-Emilion Grand Cru",Bordeaux,2008,07/05/2021,10060452008,1006045
3920,13/05/2021,4455,88,3800,120,655,12/05/2021,"Chateau Margaux Premier Cru Classe, Margaux",Bordeaux,2008,14/05/2021,10127812008,1012781
1244,13/05/2021,1578,3,882,362,696,26/04/2019,"Tignanello, Toscana",Tuscany,2003,14/05/2021,10953912003,1095391
3827,13/05/2021,4522,69,4116,-289,406,25/02/2021,"Chateau Margaux Premier Cru Classe, Margaux",Bordeaux,2004,14/05/2021,10127812004,1012781
3750,13/05/2021,4070,27,3592,158,478,06/05/2021,"Chateau Margaux Premier Cru Classe, Margaux",Bordeaux,2007,14/05/2021,10127812007,1012781
1000,13/05/2021,1237,17,1047,-47,190,27/04/2021,"Chateau Calon Segur 3eme Cru Classe, Saint-Estephe",Bordeaux,2009,14/05/2021,10074752009,1007475
2710,03/05/2021,2940,14,2474,236,466,26/03/2021,"Chateau Angelus Premier Grand Cru Classe B, Saint-Emilion Grand Cru",Bordeaux,2008,04/05/2021,10060452008,1006045
400,10/06/2021,427,8,355,45,72,15/04/2021,"Chateau Batailley 5eme Cru Classe, Pauillac",Bordeaux,2012,11/06/2021,10063222012,1006322
3860,10/05/2021,4792,77,3800,60,992,07/04/2021,"Chateau Margaux Premier Cru Classe, Margaux",Bordeaux,2006,14/05/2021,10127812006,1012781
850,13/05/2021,1098,97,860,-10,238,19/04/2021,"Chateau Calon Segur 3eme Cru Classe, Saint-Estephe",Bordeaux,2015,14/05/2021,10074752015,1007475
3850,13/05/2021,4163,43,3560,290,603,20/11/2020,"Chateau Margaux Premier Cru Classe, Margaux",Bordeaux,2012,14/05/2021,10127812012,1012781
6500,06/08/2021,7571,28,6400,100,1171,22/07/2021,"Chateau Margaux Premier Cru Classe, Margaux",Bordeaux,2005,07/08/2021,10127812005,1012781
6750,13/05/2021,7939,80,6500,250,1439,12/05/2021,"Chateau Margaux Premier Cru Classe, Margaux",Bordeaux,2009,14/05/2021,10127812009,1012781
300,10/06/2021,301,104,304,-4,-3,10/01/2021,"Chateau Batailley 5eme Cru Classe, Pauillac",Bordeaux,2013,11/06/2021,10063222013,1006322
790,13/05/2021,927,41,794,-4,133,20/04/2021,"Chateau Calon Segur 3eme Cru Classe, Saint-Estephe",Bordeaux,2014,14/05/2021,10074752014,1007475
476,10/06/2021,524,46,364,112,160,12/05/2021,"Chateau Batailley 5eme Cru Classe, Pauillac",Bordeaux,2016,11/06/2021,10063222016,1006322
2710,03/05/2021,2932,13,2520,190,412,04/05/2021,"Chateau Angelus Premier Grand Cru Classe B, Saint-Emilion Grand Cru",Bordeaux,2008,05/05/2021,10060452008,1006045
1408,13/05/2021,1518,1,1150,258,368,21/04/2019,"Tignanello, Toscana",Tuscany,2005,14/05/2021,10953912005,1095391
907,13/05/2021,1072,33,805,102,267,20/11/2019,"Chateau Calon Segur 3eme Cru Classe, Saint-Estephe",Bordeaux,2001,14/05/2021,10074752001,1007475
10500,13/05/2021,12365,75,9844,656,2521,29/03/2021,"Chateau Margaux Premier Cru Classe, Margaux",Bordeaux,2015,14/05/2021,10127812015,1012781
2710,03/05/2021,2940,14,2474,236,466,26/03/2021,"Chateau Angelus Premier Grand Cru Classe B, Saint-Emilion Grand Cru",Bordeaux,2008,04/05/2021,10060452008,1006045
3758,13/05/2021,4375,127,3690,68,685,13/04/2021,"Chateau Margaux Premier Cru Classe, Margaux",Bordeaux,2011,14/05/2021,10127812011,1012781
2260,13/05/2021,2305,4,2190,70,115,01/05/2021,"Gaja, Barbaresco",Piedmont,2004,14/05/2021,10996052004,1099605
1678,13/05/2021,1702,4,1180,498,522,25/06/2020,"Tignanello, Toscana",Tuscany,2004,14/05/2021,10953912004,1095391
811,13/05/2021,944,5,735,76,209,09/09/2020,"Chateau Calon Segur 3eme Cru Classe, Saint-Estephe",Bordeaux,2012,14/05/2021,10074752012,1007475
768,14/05/2021,902,9,705,63,197,01/02/2021,"Chateau Calon Segur 3eme Cru Classe, Saint-Estephe",Bordeaux,2002,15/05/2021,10074752002,1007475
480,11/06/2021,526,4,420,60,106,09/07/2019,"Chateau Batailley 5eme Cru Classe, Pauillac",Bordeaux,2003,12/06/2021,10063222003,1006322
990,09/08/2021,1132,10,880,110,252,22/06/2021,"Tignanello, Toscana",Tuscany,2011,10/08/2021,10953912011,1095391
870,30/07/2021,963,7,705,165,258,01/02/2021,"Chateau Calon Segur 3eme Cru Classe, Saint-Estephe",Bordeaux,2002,31/07/2021,10074752002,1007475
8200,27/07/2021,8983,17,8200,0,783,26/07/2021,"Chateau Margaux Premier Cru Classe, Margaux",Bordeaux,2000,31/07/2021,10127812000,1012781
900,30/07/2021,1105,24,800,100,305,21/11/2019,"Chateau Calon Segur 3eme Cru Classe, Saint-Estephe",Bordeaux,2003,31/07/2021,10074752003,1007475
4450,30/07/2021,4693,16,4400,50,293,29/09/2020,"Chateau Margaux Premier Cru Classe, Margaux",Bordeaux,2001,31/07/2021,10127812001,1012781
3900,30/07/2021,4434,21,3684,216,750,10/06/2020,"Chateau Margaux Premier Cru Classe, Margaux",Bordeaux,2002,31/07/2021,10127812002,1012781
3826,30/07/2021,4621,46,4116,-290,505,25/02/2021,"Chateau Margaux Premier Cru Classe, Margaux",Bordeaux,2004,31/07/2021,10127812004,1012781
5100,30/07/2021,5919,25,4650,450,1269,21/06/2021,"Chateau Margaux Premier Cru Classe, Margaux",Bordeaux,2003,31/07/2021,10127812003,1012781
2710,03/05/2021,2932,13,2520,190,412,04/05/2021,"Chateau Angelus Premier Grand Cru Classe B, Saint-Emilion Grand Cru",Bordeaux,2008,05/05/2021,10060452008,1006045
3295,10/08/2021,3710,32,3000,295,710,04/08/2021,"Chateau Angelus Premier Grand Cru Classe B, Saint-Emilion Grand Cru",Bordeaux,2009,11/08/2021,10060452009,1006045
840,30/07/2021,1060,20,745,95,315,16/11/2020,"Chateau Calon Segur 3eme Cru Classe, Saint-Estephe",Bordeaux,2004,31/07/2021,10074752004,1007475
3295,10/08/2021,3710,32,3000,295,710,04/08/2021,"Chateau Angelus Premier Grand Cru Classe B, Saint-Emilion Grand Cru",Bordeaux,2009,11/08/2021,10060452009,1006045
907,30/07/2021,953,23,805,102,148,20/11/2019,"Chateau Calon Segur 3eme Cru Classe, Saint-Estephe",Bordeaux,2001,31/07/2021,10074752001,1007475
450,11/06/2021,450,1,340,110,110,31/08/2018,"Chateau Batailley 5eme Cru Classe, Pauillac",Bordeaux,2007,12/06/2021,10063222007,1006322
3295,09/08/2021,3706,32,3000,295,706,04/08/2021,"Chateau Angelus Premier Grand Cru Classe B, Saint-Emilion Grand Cru",Bordeaux,2009,10/08/2021,10060452009,1006045
489,11/06/2021,510,9,450,39,60,25/05/2021,"Chateau Batailley 5eme Cru Classe, Pauillac",Bordeaux,2009,21/06/2021,10063222009,1006322
6500,30/07/2021,7565,28,6400,100,1165,22/07/2021,"Chateau Margaux Premier Cru Classe, Margaux",Bordeaux,2005,31/07/2021,10127812005,1012781
3295,09/08/2021,3706,32,3000,295,706,04/08/2021,"Chateau Angelus Premier Grand Cru Classe B, Saint-Emilion Grand Cru",Bordeaux,2009,10/08/2021,10060452009,1006045
990,30/07/2021,1179,63,1029,-39,150,21/07/2021,"Chateau Calon Segur 3eme Cru Classe, Saint-Estephe",Bordeaux,2005,31/07/2021,10074752005,1007475
3295,06/08/2021,3705,33,3000,295,705,04/08/2021,"Chateau Angelus Premier Grand Cru Classe B, Saint-Emilion Grand Cru",Bordeaux,2009,07/08/2021,10060452009,1006045
875,22/07/2021,934,46,863,12,71,10/05/2021,"Chateau Calon Segur 3eme Cru Classe, Saint-Estephe",Bordeaux,2006,31/07/2021,10074752006,1007475
3900,30/07/2021,4649,99,3822,78,827,20/06/2021,"Chateau Margaux Premier Cru Classe, Margaux",Bordeaux,2006,31/07/2021,10127812006,1012781
489,11/06/2021,574,20,450,39,124,25/05/2021,"Chateau Batailley 5eme Cru Classe, Pauillac",Bordeaux,2009,12/06/2021,10063222009,1006322
3800,30/07/2021,4246,44,3525,275,721,18/06/2021,"Chateau Margaux Premier Cru Classe, Margaux",Bordeaux,2007,31/07/2021,10127812007,1012781
880,30/07/2021,967,9,725,155,242,13/04/2021,"Chateau Calon Segur 3eme Cru Classe, Saint-Estephe",Bordeaux,2007,31/07/2021,10074752007,1007475
3295,06/08/2021,3705,33,3000,295,705,04/08/2021,"Chateau Angelus Premier Grand Cru Classe B, Saint-Emilion Grand Cru",Bordeaux,2009,07/08/2021,10060452009,1006045
3295,05/08/2021,3708,32,3000,295,708,04/08/2021,"Chateau Angelus Premier Grand Cru Classe B, Saint-Emilion Grand Cru",Bordeaux,2009,06/08/2021,10060452009,1006045
3950,30/07/2021,4402,98,3780,170,622,23/07/2021,"Chateau Margaux Premier Cru Classe, Margaux",Bordeaux,2008,31/07/2021,10127812008,1012781
895,30/07/2021,950,9,781,114,169,16/11/2020,"Chateau Calon Segur 3eme Cru Classe, Saint-Estephe",Bordeaux,2008,31/07/2021,10074752008,1007475
6930,30/07/2021,7681,74,7086,-156,595,11/06/2021,"Chateau Margaux Premier Cru Classe, Margaux",Bordeaux,2009,31/07/2021,10127812009,1012781
996,30/07/2021,1205,53,1026,-30,179,24/06/2021,"Chateau Calon Segur 3eme Cru Classe, Saint-Estephe",Bordeaux,2009,31/07/2021,10074752009,1007475
489,11/06/2021,578,19,450,39,128,25/05/2021,"Chateau Batailley 5eme Cru Classe, Pauillac",Bordeaux,2009,14/06/2021,10063222009,1006322
3295,05/08/2021,3708,32,3000,295,708,04/08/2021,"Chateau Angelus Premier Grand Cru Classe B, Saint-Emilion Grand Cru",Bordeaux,2009,06/08/2021,10060452009,1006045
2386,30/07/2021,2397,3,2190,196,207,01/05/2021,"Gaja, Barbaresco",Piedmont,2004,31/07/2021,10996052004,1099605
1584,30/07/2021,1704,3,1378,206,326,29/07/2020,"Tignanello, Toscana",Tuscany,2001,31/07/2021,10953912001,1095391
1299,06/07/2021,1580,4,1150,149,430,27/07/2021,"Tignanello, Toscana",Tuscany,2008,31/07/2021,10953912008,1095391
1680,30/07/2021,1693,2,1420,260,273,29/06/2021,"Tignanello, Toscana",Tuscany,2004,31/07/2021,10953912004,1095391
6400,30/07/2021,7570,67,6188,212,1382,16/07/2021,"Chateau Margaux Premier Cru Classe, Margaux",Bordeaux,2010,31/07/2021,10127812010,1012781
489,11/06/2021,508,11,450,39,58,25/05/2021,"Chateau Batailley 5eme Cru Classe, Pauillac",Bordeaux,2009,08/07/2021,10063222009,1006322
990,30/07/2021,1119,17,993,-3,126,27/07/2021,"Chateau Calon Segur 3eme Cru Classe, Saint-Estephe",Bordeaux,2010,31/07/2021,10074752010,1007475
3295,04/08/2021,3708,32,3000,295,708,04/08/2021,"Chateau Angelus Premier Grand Cru Classe B, Saint-Emilion Grand Cru",Bordeaux,2009,05/08/2021,10060452009,1006045
750,30/07/2021,899,29,790,-40,109,01/06/2020,"Chateau Calon Segur 3eme Cru Classe, Saint-Estephe",Bordeaux,2011,31/07/2021,10074752011,1007475
1180,30/07/2021,1353,4,1140,40,213,21/07/2021,"Tignanello, Toscana",Tuscany,2009,31/07/2021,10953912009,1095391
1326,30/07/2021,1452,3,1170,156,282,24/06/2021,"Tignanello, Toscana",Tuscany,2010,31/07/2021,10953912010,1095391
3800,28/07/2021,4365,81,3690,110,675,13/04/2021,"Chateau Margaux Premier Cru Classe, Margaux",Bordeaux,2011,31/07/2021,10127812011,1012781
3295,04/08/2021,3708,32,3000,295,708,04/08/2021,"Chateau Angelus Premier Grand Cru Classe B, Saint-Emilion Grand Cru",Bordeaux,2009,05/08/2021,10060452009,1006045
489,11/06/2021,576,19,450,39,126,25/05/2021,"Chateau Batailley 5eme Cru Classe, Pauillac",Bordeaux,2009,18/06/2021,10063222009,1006322
489,11/06/2021,509,10,450,39,59,25/05/2021,"Chateau Batailley 5eme Cru Classe, Pauillac",Bordeaux,2009,20/06/2021,10063222009,1006322
3900,09/08/2021,4644,97,3822,78,822,20/06/2021,"Chateau Margaux Premier Cru Classe, Margaux",Bordeaux,2006,10/08/2021,10127812006,1012781
895,06/08/2021,950,9,781,114,169,16/11/2020,"Chateau Calon Segur 3eme Cru Classe, Saint-Estephe",Bordeaux,2008,07/08/2021,10074752008,1007475
1040,14/07/2021,1135,14,940,100,195,18/03/2021,"Chateau Calon Segur 3eme Cru Classe, Saint-Estephe",Bordeaux,2000,15/07/2021,10074752000,1007475
870,14/07/2021,966,5,705,165,261,01/02/2021,"Chateau Calon Segur 3eme Cru Classe, Saint-Estephe",Bordeaux,2002,15/07/2021,10074752002,1007475
8200,12/07/2021,8969,13,8100,100,869,21/06/2021,"Chateau Margaux Premier Cru Classe, Margaux",Bordeaux,2000,15/07/2021,10127812000,1012781
945,14/07/2021,1128,23,800,145,328,21/11/2019,"Chateau Calon Segur 3eme Cru Classe, Saint-Estephe",Bordeaux,2003,15/07/2021,10074752003,1007475
4450,14/07/2021,4805,24,4400,50,405,29/09/2020,"Chateau Margaux Premier Cru Classe, Margaux",Bordeaux,2001,15/07/2021,10127812001,1012781
3939,14/07/2021,4425,22,3684,255,741,10/06/2020,"Chateau Margaux Premier Cru Classe, Margaux",Bordeaux,2002,15/07/2021,10127812002,1012781
3826,14/07/2021,4583,48,4116,-290,467,25/02/2021,"Chateau Margaux Premier Cru Classe, Margaux",Bordeaux,2004,15/07/2021,10127812004,1012781
3295,03/08/2021,3709,32,3000,295,709,29/07/2021,"Chateau Angelus Premier Grand Cru Classe B, Saint-Emilion Grand Cru",Bordeaux,2009,03/08/2021,10060452009,1006045
840,14/07/2021,977,16,745,95,232,16/11/2020,"Chateau Calon Segur 3eme Cru Classe, Saint-Estephe",Bordeaux,2004,15/07/2021,10074752004,1007475
3295,03/08/2021,3709,32,3000,295,709,29/07/2021,"Chateau Angelus Premier Grand Cru Classe B, Saint-Emilion Grand Cru",Bordeaux,2009,04/08/2021,10060452009,1006045
907,14/07/2021,926,18,805,102,121,20/11/2019,"Chateau Calon Segur 3eme Cru Classe, Saint-Estephe",Bordeaux,2001,15/07/2021,10074752001,1007475
489,11/06/2021,510,9,450,39,60,25/05/2021,"Chateau Batailley 5eme Cru Classe, Pauillac",Bordeaux,2009,21/06/2021,10063222009,1006322
3295,02/08/2021,3686,29,3000,295,686,29/07/2021,"Chateau Angelus Premier Grand Cru Classe B, Saint-Emilion Grand Cru",Bordeaux,2009,03/08/2021,10060452009,1006045
489,11/06/2021,574,20,450,39,124,25/05/2021,"Chateau Batailley 5eme Cru Classe, Pauillac",Bordeaux,2009,12/06/2021,10063222009,1006322
6500,14/07/2021,7284,27,6776,-276,508,10/06/2021,"Chateau Margaux Premier Cru Classe, Margaux",Bordeaux,2005,15/07/2021,10127812005,1012781
3295,02/08/2021,3686,29,3000,295,686,29/07/2021,"Chateau Angelus Premier Grand Cru Classe B, Saint-Emilion Grand Cru",Bordeaux,2009,03/08/2021,10060452009,1006045
1028,13/07/2021,1166,82,988,40,178,28/05/2021,"Chateau Calon Segur 3eme Cru Classe, Saint-Estephe",Bordeaux,2005,15/07/2021,10074752005,1007475
3295,30/07/2021,3686,29,3000,295,686,29/07/2021,"Chateau Angelus Premier Grand Cru Classe B, Saint-Emilion Grand Cru",Bordeaux,2009,31/07/2021,10060452009,1006045
895,14/07/2021,921,39,863,32,58,10/05/2021,"Chateau Calon Segur 3eme Cru Classe, Saint-Estephe",Bordeaux,2006,15/07/2021,10074752006,1007475
3900,14/07/2021,4698,82,3822,78,876,20/06/2021,"Chateau Margaux Premier Cru Classe, Margaux",Bordeaux,2006,15/07/2021,10127812006,1012781
1040,30/06/2021,1204,23,940,100,264,18/03/2021,"Chateau Calon Segur 3eme Cru Classe, Saint-Estephe",Bordeaux,2000,01/07/2021,10074752000,1007475
870,30/06/2021,954,4,705,165,249,01/02/2021,"Chateau Calon Segur 3eme Cru Classe, Saint-Estephe",Bordeaux,2002,01/07/2021,10074752002,1007475
8100,30/06/2021,8354,14,8100,0,254,21/06/2021,"Chateau Margaux Premier Cru Classe, Margaux",Bordeaux,2000,01/07/2021,10127812000,1012781
900,30/06/2021,1055,23,800,100,255,21/11/2019,"Chateau Calon Segur 3eme Cru Classe, Saint-Estephe",Bordeaux,2003,01/07/2021,10074752003,1007475
4450,30/06/2021,4688,22,4400,50,288,29/09/2020,"Chateau Margaux Premier Cru Classe, Margaux",Bordeaux,2001,01/07/2021,10127812001,1012781
3900,30/06/2021,4495,25,3684,216,811,10/06/2020,"Chateau Margaux Premier Cru Classe, Margaux",Bordeaux,2002,01/07/2021,10127812002,1012781
3826,30/06/2021,4482,60,4116,-290,366,25/02/2021,"Chateau Margaux Premier Cru Classe, Margaux",Bordeaux,2004,01/07/2021,10127812004,1012781
4850,25/06/2021,5859,21,4650,200,1209,21/06/2021,"Chateau Margaux Premier Cru Classe, Margaux",Bordeaux,2003,01/07/2021,10127812003,1012781
3295,30/07/2021,3686,29,3000,295,686,29/07/2021,"Chateau Angelus Premier Grand Cru Classe B, Saint-Emilion Grand Cru",Bordeaux,2009,31/07/2021,10060452009,1006045
3295,29/07/2021,3698,28,3000,295,698,29/07/2021,"Chateau Angelus Premier Grand Cru Classe B, Saint-Emilion Grand Cru",Bordeaux,2009,30/07/2021,10060452009,1006045
800,30/06/2021,921,19,745,55,176,16/11/2020,"Chateau Calon Segur 3eme Cru Classe, Saint-Estephe",Bordeaux,2004,01/07/2021,10074752004,1007475
907,30/06/2021,953,23,805,102,148,20/11/2019,"Chateau Calon Segur 3eme Cru Classe, Saint-Estephe",Bordeaux,2001,01/07/2021,10074752001,1007475
489,11/06/2021,578,19,450,39,128,25/05/2021,"Chateau Batailley 5eme Cru Classe, Pauillac",Bordeaux,2009,14/06/2021,10063222009,1006322
1440,09/08/2021,1687,31,1510,-70,177,18/07/2021,"Gaja, Barbaresco",Piedmont,2016,11/08/2021,10996052016,1099605
3295,29/07/2021,3698,28,3000,295,698,29/07/2021,"Chateau Angelus Premier Grand Cru Classe B, Saint-Emilion Grand Cru",Bordeaux,2009,30/07/2021,10060452009,1006045
995,06/08/2021,1113,18,993,2,120,27/07/2021,"Chateau Calon Segur 3eme Cru Classe, Saint-Estephe",Bordeaux,2010,07/08/2021,10074752010,1007475
1299,06/07/2021,1695,4,1150,149,545,27/07/2021,"Tignanello, Toscana",Tuscany,2008,07/08/2021,10953912008,1095391
900,06/08/2021,1099,25,800,100,299,21/11/2019,"Chateau Calon Segur 3eme Cru Classe, Saint-Estephe",Bordeaux,2003,07/08/2021,10074752003,1007475
3800,05/08/2021,4349,128,3600,200,749,02/08/2021,"Chateau Margaux Premier Cru Classe, Margaux",Bordeaux,2014,06/08/2021,10127812014,1012781
489,11/06/2021,513,8,450,39,63,25/05/2021,"Chateau Batailley 5eme Cru Classe, Pauillac",Bordeaux,2009,30/06/2021,10063222009,1006322
6400,30/06/2021,7230,26,6776,-376,454,10/06/2021,"Chateau Margaux Premier Cru Classe, Margaux",Bordeaux,2005,01/07/2021,10127812005,1012781
3295,26/07/2021,3681,28,3120,175,561,27/07/2021,"Chateau Angelus Premier Grand Cru Classe B, Saint-Emilion Grand Cru",Bordeaux,2009,28/07/2021,10060452009,1006045
1000,30/06/2021,1157,92,988,12,169,28/05/2021,"Chateau Calon Segur 3eme Cru Classe, Saint-Estephe",Bordeaux,2005,01/07/2021,10074752005,1007475
3295,26/07/2021,3681,28,3179,116,502,20/07/2021,"Chateau Angelus Premier Grand Cru Classe B, Saint-Emilion Grand Cru",Bordeaux,2009,27/07/2021,10060452009,1006045
1280,05/05/2021,1225,11,1172,108,53,07/04/2021,"Tignanello, Toscana",Tuscany,2010,06/05/2021,10953912010,1095391
3295,26/07/2021,3681,28,3179,116,502,20/07/2021,"Chateau Angelus Premier Grand Cru Classe B, Saint-Emilion Grand Cru",Bordeaux,2009,27/07/2021,10060452009,1006045
1800,05/05/2021,1840,2,1300,500,540,30/05/2019,"Gaja, Barbaresco",Piedmont,2007,06/05/2021,10996052007,1099605
3295,26/07/2021,3681,28,3120,175,561,27/07/2021,"Chateau Angelus Premier Grand Cru Classe B, Saint-Emilion Grand Cru",Bordeaux,2009,28/07/2021,10060452009,1006045
7000,05/05/2021,6735,1,5360,1640,1375,18/09/2020,"Domaine Leflaive, Chevalier-Montrachet Grand Cru",Burgundy,2009,06/05/2021,10734012009,1073401
3295,22/07/2021,3696,30,3179,116,517,20/07/2021,"Chateau Angelus Premier Grand Cru Classe B, Saint-Emilion Grand Cru",Bordeaux,2009,23/07/2021,10060452009,1006045
3800,05/05/2021,4170,32,3560,240,610,20/11/2020,"Chateau Margaux Premier Cru Classe, Margaux",Bordeaux,2012,06/05/2021,10127812012,1012781
540,05/05/2021,540,1,300,240,240,03/11/2011,"Tua Rita, Giusto di Notri, Toscana",Tuscany,2007,06/05/2021,11058072007,1105807
520,05/05/2021,575,4,460,60,115,05/05/2020,"Tua Rita, Giusto di Notri, Toscana",Tuscany,2008,06/05/2021,11058072008,1105807
5632,04/05/2021,5481,61,5288,344,193,03/05/2021,"Chateau Margaux Premier Cru Classe, Margaux",Bordeaux,2016,06/05/2021,10127812016,1012781
1380,05/05/2021,1448,8,1352,28,96,23/09/2020,"Gaja, Barbaresco",Piedmont,2011,06/05/2021,10996052011,1099605
660,05/05/2021,724,4,390,270,334,18/08/2017,"Tua Rita, Giusto di Notri, Toscana",Tuscany,2006,06/05/2021,11058072006,1105807
3295,22/07/2021,3696,30,3179,116,517,20/07/2021,"Chateau Angelus Premier Grand Cru Classe B, Saint-Emilion Grand Cru",Bordeaux,2009,23/07/2021,10060452009,1006045
5490,05/05/2021,5658,138,5150,340,508,03/05/2021,"Chateau Margaux Premier Cru Classe, Margaux",Bordeaux,2018,06/05/2021,10127812018,1012781
1592,05/05/2021,1512,13,1300,292,212,28/09/2020,"Gaja, Barbaresco",Piedmont,2014,06/05/2021,10996052014,1099605
3700,04/05/2021,4215,165,3670,30,545,19/03/2021,"Chateau Margaux Premier Cru Classe, Margaux",Bordeaux,2017,06/05/2021,10127812017,1012781
6250,04/05/2021,7051,45,6400,-150,651,15/04/2021,"Chateau Margaux Premier Cru Classe, Margaux",Bordeaux,2005,06/05/2021,10127812005,1012781
489,11/06/2021,576,19,450,39,126,25/05/2021,"Chateau Batailley 5eme Cru Classe, Pauillac",Bordeaux,2009,18/06/2021,10063222009,1006322
9950,05/05/2021,9718,3,8000,1950,1718,30/01/2020,"Domaine Leflaive, Chevalier-Montrachet Grand Cru",Burgundy,2014,06/05/2021,10734012014,1073401
6750,05/05/2021,7944,99,6412,338,1532,25/03/2021,"Chateau Margaux Premier Cru Classe, Margaux",Bordeaux,2009,06/05/2021,10127812009,1012781
1000,05/05/2021,1181,69,975,25,206,12/04/2021,"Chateau Calon Segur 3eme Cru Classe, Saint-Estephe",Bordeaux,2005,06/05/2021,10074752005,1007475
3800,05/05/2021,4362,134,3690,110,672,13/04/2021,"Chateau Margaux Premier Cru Classe, Margaux",Bordeaux,2011,06/05/2021,10127812011,1012781
489,11/06/2021,509,10,450,39,59,25/05/2021,"Chateau Batailley 5eme Cru Classe, Pauillac",Bordeaux,2009,20/06/2021,10063222009,1006322
9460,05/05/2021,9824,3,7290,2170,2534,21/08/2020,"Domaine Denis Mortet, Chambertin Grand Cru",Burgundy,2017,06/05/2021,10490202017,1049020
489,11/06/2021,513,8,450,39,63,25/05/2021,"Chateau Batailley 5eme Cru Classe, Pauillac",Bordeaux,2009,30/06/2021,10063222009,1006322
489,11/06/2021,516,8,450,39,66,25/05/2021,"Chateau Batailley 5eme Cru Classe, Pauillac",Bordeaux,2009,02/07/2021,10063222009,1006322
790,05/05/2021,914,40,794,-4,120,20/04/2021,"Chateau Calon Segur 3eme Cru Classe, Saint-Estephe",Bordeaux,2014,06/05/2021,10074752014,1007475
3295,22/07/2021,3681,28,3179,116,502,20/07/2021,"Chateau Angelus Premier Grand Cru Classe B, Saint-Emilion Grand Cru",Bordeaux,2009,26/07/2021,10060452009,1006045
489,11/06/2021,516,8,450,39,66,25/05/2021,"Chateau Batailley 5eme Cru Classe, Pauillac",Bordeaux,2009,02/07/2021,10063222009,1006322
958,05/05/2021,1057,9,860,98,197,08/03/2021,"Tignanello, Toscana",Tuscany,2011,06/05/2021,10953912011,1095391
1400,05/05/2021,1436,9,1276,124,160,05/03/2021,"Gaja, Barbaresco",Piedmont,2013,06/05/2021,10996052013,1099605
1700,05/05/2021,1654,3,1378,322,276,29/07/2020,"Tignanello, Toscana",Tuscany,2001,06/05/2021,10953912001,1095391
3295,22/07/2021,3681,28,3179,116,502,20/07/2021,"Chateau Angelus Premier Grand Cru Classe B, Saint-Emilion Grand Cru",Bordeaux,2009,26/07/2021,10060452009,1006045
489,11/06/2021,508,11,450,39,58,25/05/2021,"Chateau Batailley 5eme Cru Classe, Pauillac",Bordeaux,2009,08/07/2021,10063222009,1006322
1408,05/05/2021,1487,2,1150,258,337,21/04/2019,"Tignanello, Toscana",Tuscany,2005,06/05/2021,10953912005,1095391
3720,05/05/2021,4074,51,3480,240,594,10/04/2021,"Chateau Margaux Premier Cru Classe, Margaux",Bordeaux,2014,06/05/2021,10127812014,1012781
860,05/05/2021,1037,66,950,-90,87,03/05/2021,"Tignanello, Toscana",Tuscany,2018,06/05/2021,10953912018,1095391
1110,04/05/2021,1175,13,1204,-94,-29,03/05/2021,"Tignanello, Toscana",Tuscany,2015,06/05/2021,10953912015,1095391
1100,05/05/2021,1460,9,1010,90,450,18/12/2020,"Tignanello, Toscana",Tuscany,2008,06/05/2021,10953912008,1095391
3295,19/07/2021,3683,31,3179,116,504,20/07/2021,"Chateau Angelus Premier Grand Cru Classe B, Saint-Emilion Grand Cru",Bordeaux,2009,21/07/2021,10060452009,1006045
1678,05/05/2021,1702,4,1180,498,522,25/06/2020,"Tignanello, Toscana",Tuscany,2004,06/05/2021,10953912004,1095391
1500,05/05/2021,1707,40,1408,92,299,09/04/2021,"Gaja, Barbaresco",Piedmont,2016,06/05/2021,10996052016,1099605
3560,05/05/2021,4093,28,3450,110,643,11/11/2020,"Chateau Margaux Premier Cru Classe, Margaux",Bordeaux,2007,06/05/2021,10127812007,1012781
1244,05/05/2021,1578,3,882,362,696,26/04/2019,"Tignanello, Toscana",Tuscany,2003,06/05/2021,10953912003,1095391
8400,05/05/2021,8400,0,7200,1200,1200,06/11/2019,"Domaine Denis Mortet, Chambertin Grand Cru",Burgundy,2014,06/05/2021,10490202014,1049020
1408,05/05/2021,1434,5,1238,170,196,02/11/2020,"Tignanello, Toscana",Tuscany,2006,06/05/2021,10953912006,1095391
1040,04/05/2021,1196,51,950,90,246,03/05/2021,"Chateau Calon Segur 3eme Cru Classe, Saint-Estephe",Bordeaux,2018,06/05/2021,10074752018,1007475
750,05/05/2021,1008,37,790,-40,218,01/06/2020,"Chateau Calon Segur 3eme Cru Classe, Saint-Estephe",Bordeaux,2011,06/05/2021,10074752011,1007475
8000,05/05/2021,8449,7,6974,1026,1475,14/03/2021,"Domaine Leflaive, Chevalier-Montrachet Grand Cru",Burgundy,2017,06/05/2021,10734012017,1073401
3827,04/05/2021,4605,56,4116,-289,489,25/02/2021,"Chateau Margaux Premier Cru Classe, Margaux",Bordeaux,2004,06/05/2021,10127812004,1012781
3295,19/07/2021,3683,31,3020,275,663,03/06/2021,"Chateau Angelus Premier Grand Cru Classe B, Saint-Emilion Grand Cru",Bordeaux,2009,20/07/2021,10060452009,1006045
2872,05/05/2021,2872,2,2554,318,318,22/05/2020,"Gaja, Barbaresco",Piedmont,2006,06/05/2021,10996052006,1099605
900,05/05/2021,1062,21,800,100,262,21/11/2019,"Chateau Calon Segur 3eme Cru Classe, Saint-Estephe",Bordeaux,2003,06/05/2021,10074752003,1007475
2260,05/05/2021,2305,4,2190,70,115,01/05/2021,"Gaja, Barbaresco",Piedmont,2004,06/05/2021,10996052004,1099605
738,03/05/2021,885,108,760,-22,125,29/04/2021,"Chateau Calon Segur 3eme Cru Classe, Saint-Estephe",Bordeaux,2017,06/05/2021,10074752017,1007475
3295,19/07/2021,3696,30,3179,116,517,20/07/2021,"Chateau Angelus Premier Grand Cru Classe B, Saint-Emilion Grand Cru",Bordeaux,2009,22/07/2021,10060452009,1006045
1060,05/05/2021,1109,201,1082,-22,27,27/04/2021,"Tignanello, Toscana",Tuscany,2016,06/05/2021,10953912016,1095391
3910,05/05/2021,4764,81,3800,110,964,07/04/2021,"Chateau Margaux Premier Cru Classe, Margaux",Bordeaux,2006,06/05/2021,10127812006,1012781
3700,05/05/2021,4010,24,3520,180,490,07/04/2021,"Chateau Margaux Premier Cru Classe, Margaux",Bordeaux,2013,06/05/2021,10127812013,1012781
7600,05/05/2021,7852,2,7124,476,728,15/02/2019,"Domaine Leflaive, Chevalier-Montrachet Grand Cru",Burgundy,2016,06/05/2021,10734012016,1073401
4400,05/05/2021,4898,27,4400,0,498,29/09/2020,"Chateau Margaux Premier Cru Classe, Margaux",Bordeaux,2001,06/05/2021,10127812001,1012781
1404,05/05/2021,1407,1,996,408,411,14/06/2019,"Tignanello, Toscana",Tuscany,2000,06/05/2021,10953912000,1095391
880,05/05/2021,948,10,725,155,223,13/04/2021,"Chateau Calon Segur 3eme Cru Classe, Saint-Estephe",Bordeaux,2007,06/05/2021,10074752007,1007475
7800,03/05/2021,8204,7,7000,800,1204,26/04/2021,"Domaine Leflaive, Chevalier-Montrachet Grand Cru",Burgundy,2018,06/05/2021,10734012018,1073401
17000,05/05/2021,15217,7,13000,4000,2217,29/04/2021,"Jacques-Frederic Mugnier, Chambolle-Musigny Premier Cru, Les Amoureuses",Burgundy,2017,06/05/2021,10496422017,1049642
6100,03/05/2021,7488,51,5922,178,1566,13/04/2021,"Chateau Margaux Premier Cru Classe, Margaux",Bordeaux,2010,06/05/2021,10127812010,1012781
907,05/05/2021,1099,29,805,102,294,20/11/2019,"Chateau Calon Segur 3eme Cru Classe, Saint-Estephe",Bordeaux,2001,06/05/2021,10074752001,1007475
780,05/05/2021,837,6,682,98,155,15/09/2020,"Chateau Calon Segur 3eme Cru Classe, Saint-Estephe",Bordeaux,2013,06/05/2021,10074752013,1007475
3295,19/07/2021,3696,30,3179,116,517,20/07/2021,"Chateau Angelus Premier Grand Cru Classe B, Saint-Emilion Grand Cru",Bordeaux,2009,22/07/2021,10060452009,1006045
12402,05/05/2021,12557,2,12850,-448,-293,30/11/2020,"Jacques-Frederic Mugnier, Chambolle-Musigny Premier Cru, Les Amoureuses",Burgundy,2011,06/05/2021,10496422011,1049642
548,05/05/2021,560,3,544,4,16,18/09/2020,"Tua Rita, Giusto di Notri, Toscana",Tuscany,2013,06/05/2021,11058072013,1105807
489,11/06/2021,507,11,450,39,57,25/05/2021,"Chateau Batailley 5eme Cru Classe, Pauillac",Bordeaux,2009,11/07/2021,10063222009,1006322
1300,05/05/2021,1342,3,1200,100,142,06/03/2021,"Tignanello, Toscana",Tuscany,2007,06/05/2021,10953912007,1095391
3295,19/07/2021,3683,31,3020,275,663,03/06/2021,"Chateau Angelus Premier Grand Cru Classe B, Saint-Emilion Grand Cru",Bordeaux,2009,20/07/2021,10060452009,1006045
6400,05/05/2021,6935,2,7900,-1500,-965,29/04/2019,"Domaine Leflaive, Chevalier-Montrachet Grand Cru",Burgundy,2015,06/05/2021,10734012015,1073401
1000,05/05/2021,1219,17,1047,-47,172,27/04/2021,"Chateau Calon Segur 3eme Cru Classe, Saint-Estephe",Bordeaux,2009,06/05/2021,10074752009,1007475
1020,05/05/2021,1129,17,1000,20,129,12/04/2021,"Chateau Calon Segur 3eme Cru Classe, Saint-Estephe",Bordeaux,2010,06/05/2021,10074752010,1007475
489,11/06/2021,507,11,450,39,57,25/05/2021,"Chateau Batailley 5eme Cru Classe, Pauillac",Bordeaux,2009,11/07/2021,10063222009,1006322
8000,05/05/2021,8137,19,7950,50,187,12/03/2021,"Chateau Margaux Premier Cru Classe, Margaux",Bordeaux,2000,06/05/2021,10127812000,1012781
3900,05/05/2021,4447,32,3684,216,763,10/06/2020,"Chateau Margaux Premier Cru Classe, Margaux",Bordeaux,2002,06/05/2021,10127812002,1012781
3295,19/07/2021,3683,31,3179,116,504,20/07/2021,"Chateau Angelus Premier Grand Cru Classe B, Saint-Emilion Grand Cru",Bordeaux,2009,21/07/2021,10060452009,1006045
1350,05/05/2021,1474,60,1260,90,214,18/02/2021,"Gaja, Barbaresco",Piedmont,2015,06/05/2021,10996052015,1099605
6800,05/05/2021,6800,1,1730,5070,5070,31/10/2011,"Domaine Leflaive, Chevalier-Montrachet Grand Cru",Burgundy,2003,06/05/2021,10734012003,1073401
10500,05/05/2021,12468,69,9844,656,2624,29/03/2021,"Chateau Margaux Premier Cru Classe, Margaux",Bordeaux,2015,06/05/2021,10127812015,1012781
1040,28/07/2021,1377,69,940,100,437,18/03/2021,"Chateau Calon Segur 3eme Cru Classe, Saint-Estephe",Bordeaux,2000,04/08/2021,10074752000,1007475
990,03/08/2021,1177,63,1029,-39,148,21/07/2021,"Chateau Calon Segur 3eme Cru Classe, Saint-Estephe",Bordeaux,2005,04/08/2021,10074752005,1007475
1299,06/07/2021,1620,5,1150,149,470,27/07/2021,"Tignanello, Toscana",Tuscany,2008,04/08/2021,10953912008,1095391
900,02/08/2021,1111,20,800,100,311,21/11/2019,"Chateau Calon Segur 3eme Cru Classe, Saint-Estephe",Bordeaux,2003,04/08/2021,10074752003,1007475
3295,15/07/2021,3683,26,3020,275,663,03/06/2021,"Chateau Angelus Premier Grand Cru Classe B, Saint-Emilion Grand Cru",Bordeaux,2009,17/07/2021,10060452009,1006045
900,30/06/2021,1017,53,863,37,154,10/05/2021,"Chateau Calon Segur 3eme Cru Classe, Saint-Estephe",Bordeaux,2006,01/07/2021,10074752006,1007475
3900,30/06/2021,4638,94,3822,78,816,20/06/2021,"Chateau Margaux Premier Cru Classe, Margaux",Bordeaux,2006,01/07/2021,10127812006,1012781
489,11/06/2021,511,9,450,39,61,25/05/2021,"Chateau Batailley 5eme Cru Classe, Pauillac",Bordeaux,2009,13/07/2021,10063222009,1006322
895,06/08/2021,966,53,863,32,103,10/05/2021,"Chateau Calon Segur 3eme Cru Classe, Saint-Estephe",Bordeaux,2006,07/08/2021,10074752006,1007475
1326,06/08/2021,1406,5,1170,156,236,24/06/2021,"Tignanello, Toscana",Tuscany,2010,07/08/2021,10953912010,1095391
6930,06/08/2021,7720,70,7086,-156,634,11/06/2021,"Chateau Margaux Premier Cru Classe, Margaux",Bordeaux,2009,07/08/2021,10127812009,1012781
489,11/06/2021,511,9,450,39,61,25/05/2021,"Chateau Batailley 5eme Cru Classe, Pauillac",Bordeaux,2009,13/07/2021,10063222009,1006322
3560,30/06/2021,4189,40,3525,35,664,18/06/2021,"Chateau Margaux Premier Cru Classe, Margaux",Bordeaux,2007,01/07/2021,10127812007,1012781
880,30/06/2021,967,9,725,155,242,13/04/2021,"Chateau Calon Segur 3eme Cru Classe, Saint-Estephe",Bordeaux,2007,01/07/2021,10074752007,1007475
3295,15/07/2021,3664,27,3020,275,644,03/06/2021,"Chateau Angelus Premier Grand Cru Classe B, Saint-Emilion Grand Cru",Bordeaux,2009,16/07/2021,10060452009,1006045
3295,15/07/2021,3664,27,3020,275,644,03/06/2021,"Chateau Angelus Premier Grand Cru Classe B, Saint-Emilion Grand Cru",Bordeaux,2009,16/07/2021,10060452009,1006045
3900,30/06/2021,4256,79,3750,150,506,28/06/2021,"Chateau Margaux Premier Cru Classe, Margaux",Bordeaux,2008,01/07/2021,10127812008,1012781
895,30/06/2021,980,10,781,114,199,16/11/2020,"Chateau Calon Segur 3eme Cru Classe, Saint-Estephe",Bordeaux,2008,01/07/2021,10074752008,1007475
400,11/06/2021,427,8,355,45,72,15/04/2021,"Chateau Batailley 5eme Cru Classe, Pauillac",Bordeaux,2012,12/06/2021,10063222012,1006322
12456,04/05/2021,14434,2,12000,456,2434,28/05/2020,"Jacques-Frederic Mugnier, Chambolle-Musigny Premier Cru, Les Amoureuses",Burgundy,2014,05/05/2021,10496422014,1049642
3295,15/07/2021,3683,26,3020,275,663,03/06/2021,"Chateau Angelus Premier Grand Cru Classe B, Saint-Emilion Grand Cru",Bordeaux,2009,17/07/2021,10060452009,1006045
790,04/05/2021,969,19,745,45,224,16/11/2020,"Chateau Calon Segur 3eme Cru Classe, Saint-Estephe",Bordeaux,2004,05/05/2021,10074752004,1007475
2260,04/05/2021,2305,4,2190,70,115,01/05/2021,"Gaja, Barbaresco",Piedmont,2004,05/05/2021,10996052004,1099605
3702,04/05/2021,3684,2,1200,2502,2484,16/05/2012,"Gaja, Barbaresco",Piedmont,2001,05/05/2021,10996052001,1099605
3910,03/05/2021,4764,81,3800,110,964,07/04/2021,"Chateau Margaux Premier Cru Classe, Margaux",Bordeaux,2006,05/05/2021,10127812006,1012781
400,11/06/2021,427,8,355,45,72,15/04/2021,"Chateau Batailley 5eme Cru Classe, Pauillac",Bordeaux,2012,12/06/2021,10063222012,1006322
300,11/06/2021,301,104,304,-4,-3,10/01/2021,"Chateau Batailley 5eme Cru Classe, Pauillac",Bordeaux,2013,12/06/2021,10063222013,1006322
3295,12/07/2021,3664,27,3020,275,644,03/06/2021,"Chateau Angelus Premier Grand Cru Classe B, Saint-Emilion Grand Cru",Bordeaux,2009,13/07/2021,10060452009,1006045
1020,04/05/2021,1129,17,1000,20,129,12/04/2021,"Chateau Calon Segur 3eme Cru Classe, Saint-Estephe",Bordeaux,2010,05/05/2021,10074752010,1007475
18400,04/05/2021,15083,7,13000,5400,2083,29/04/2021,"Jacques-Frederic Mugnier, Chambolle-Musigny Premier Cru, Les Amoureuses",Burgundy,2017,05/05/2021,10496422017,1049642
3800,04/05/2021,4170,32,3560,240,610,20/11/2020,"Chateau Margaux Premier Cru Classe, Margaux",Bordeaux,2012,05/05/2021,10127812012,1012781
3295,12/07/2021,3664,27,3020,275,644,03/06/2021,"Chateau Angelus Premier Grand Cru Classe B, Saint-Emilion Grand Cru",Bordeaux,2009,13/07/2021,10060452009,1006045
300,11/06/2021,300,103,304,-4,-4,10/01/2021,"Chateau Batailley 5eme Cru Classe, Pauillac",Bordeaux,2013,13/06/2021,10063222013,1006322
1480,03/05/2021,1626,74,1356,124,270,20/04/2021,"Gaja, Barbaresco",Piedmont,2017,05/05/2021,10996052017,1099605
476,11/06/2021,524,46,364,112,160,12/05/2021,"Chateau Batailley 5eme Cru Classe, Pauillac",Bordeaux,2016,12/06/2021,10063222016,1006322
1110,04/05/2021,1174,13,1204,-94,-30,03/05/2021,"Tignanello, Toscana",Tuscany,2015,05/05/2021,10953912015,1095391
480,03/05/2021,477,59,380,100,97,25/03/2021,"Tua Rita, Giusto di Notri, Toscana",Tuscany,2018,05/05/2021,11058072018,1105807
6100,03/05/2021,7485,51,5922,178,1563,13/04/2021,"Chateau Margaux Premier Cru Classe, Margaux",Bordeaux,2010,05/05/2021,10127812010,1012781
7600,04/05/2021,7852,2,7124,476,728,15/02/2019,"Domaine Leflaive, Chevalier-Montrachet Grand Cru",Burgundy,2016,05/05/2021,10734012016,1073401
3700,04/05/2021,4010,24,3520,180,490,07/04/2021,"Chateau Margaux Premier Cru Classe, Margaux",Bordeaux,2013,05/05/2021,10127812013,1012781
3295,08/07/2021,3669,23,3020,275,649,03/06/2021,"Chateau Angelus Premier Grand Cru Classe B, Saint-Emilion Grand Cru",Bordeaux,2009,09/07/2021,10060452009,1006045
3295,08/07/2021,3669,23,3020,275,649,03/06/2021,"Chateau Angelus Premier Grand Cru Classe B, Saint-Emilion Grand Cru",Bordeaux,2009,09/07/2021,10060452009,1006045
3295,08/07/2021,3662,24,3020,275,642,03/06/2021,"Chateau Angelus Premier Grand Cru Classe B, Saint-Emilion Grand Cru",Bordeaux,2009,10/07/2021,10060452009,1006045
3295,08/07/2021,3662,24,3020,275,642,03/06/2021,"Chateau Angelus Premier Grand Cru Classe B, Saint-Emilion Grand Cru",Bordeaux,2009,10/07/2021,10060452009,1006045
6800,04/05/2021,6800,1,1730,5070,5070,31/10/2011,"Domaine Leflaive, Chevalier-Montrachet Grand Cru",Burgundy,2003,05/05/2021,10734012003,1073401
3295,05/07/2021,3663,23,3020,275,643,03/06/2021,"Chateau Angelus Premier Grand Cru Classe B, Saint-Emilion Grand Cru",Bordeaux,2009,06/07/2021,10060452009,1006045
460,04/05/2021,488,165,420,40,68,23/03/2021,"Tua Rita, Giusto di Notri, Toscana",Tuscany,2016,05/05/2021,11058072016,1105807
660,04/05/2021,728,6,390,270,338,18/08/2017,"Tua Rita, Giusto di Notri, Toscana",Tuscany,2006,05/05/2021,11058072006,1105807
900,04/05/2021,1187,13,850,50,337,28/01/2021,"Tignanello, Toscana",Tuscany,2012,05/05/2021,10953912012,1095391
1290,03/05/2021,1225,11,1172,118,53,07/04/2021,"Tignanello, Toscana",Tuscany,2010,05/05/2021,10953912010,1095391
6400,04/05/2021,6935,2,7900,-1500,-965,29/04/2019,"Domaine Leflaive, Chevalier-Montrachet Grand Cru",Burgundy,2015,05/05/2021,10734012015,1073401
1700,03/05/2021,1654,3,1378,322,276,29/07/2020,"Tignanello, Toscana",Tuscany,2001,05/05/2021,10953912001,1095391
790,03/05/2021,920,155,907,-117,13,03/05/2021,"Tignanello, Toscana",Tuscany,2017,05/05/2021,10953912017,1095391
12402,04/05/2021,12557,2,12850,-448,-293,30/11/2020,"Jacques-Frederic Mugnier, Chambolle-Musigny Premier Cru, Les Amoureuses",Burgundy,2011,05/05/2021,10496422011,1049642
5490,03/05/2021,5658,138,5150,340,508,03/05/2021,"Chateau Margaux Premier Cru Classe, Margaux",Bordeaux,2018,05/05/2021,10127812018,1012781
1050,03/05/2021,1340,40,940,110,400,18/03/2021,"Chateau Calon Segur 3eme Cru Classe, Saint-Estephe",Bordeaux,2000,05/05/2021,10074752000,1007475
1380,04/05/2021,1448,8,1352,28,96,23/09/2020,"Gaja, Barbaresco",Piedmont,2011,05/05/2021,10996052011,1099605
6250,04/05/2021,7043,45,6400,-150,643,15/04/2021,"Chateau Margaux Premier Cru Classe, Margaux",Bordeaux,2005,05/05/2021,10127812005,1012781
1100,04/05/2021,1440,9,1010,90,430,18/12/2020,"Tignanello, Toscana",Tuscany,2008,05/05/2021,10953912008,1095391
3827,04/05/2021,4595,57,4116,-289,479,25/02/2021,"Chateau Margaux Premier Cru Classe, Margaux",Bordeaux,2004,05/05/2021,10127812004,1012781
3295,05/07/2021,3663,23,3020,275,643,03/06/2021,"Chateau Angelus Premier Grand Cru Classe B, Saint-Emilion Grand Cru",Bordeaux,2009,06/07/2021,10060452009,1006045
548,04/05/2021,560,3,544,4,16,18/09/2020,"Tua Rita, Giusto di Notri, Toscana",Tuscany,2013,05/05/2021,11058072013,1105807
2872,04/05/2021,2872,2,2554,318,318,22/05/2020,"Gaja, Barbaresco",Piedmont,2006,05/05/2021,10996052006,1099605
860,03/05/2021,1037,65,950,-90,87,03/05/2021,"Tignanello, Toscana",Tuscany,2018,05/05/2021,10953912018,1095391
9950,04/05/2021,9718,3,8000,1950,1718,30/01/2020,"Domaine Leflaive, Chevalier-Montrachet Grand Cru",Burgundy,2014,05/05/2021,10734012014,1073401
480,14/06/2021,526,4,420,60,106,09/07/2019,"Chateau Batailley 5eme Cru Classe, Pauillac",Bordeaux,2003,15/06/2021,10063222003,1006322
1800,04/05/2021,1840,2,1300,500,540,30/05/2019,"Gaja, Barbaresco",Piedmont,2007,05/05/2021,10996052007,1099605
3800,04/05/2021,4362,134,3690,110,672,13/04/2021,"Chateau Margaux Premier Cru Classe, Margaux",Bordeaux,2011,05/05/2021,10127812011,1012781
3560,03/05/2021,4097,28,3450,110,647,11/11/2020,"Chateau Margaux Premier Cru Classe, Margaux",Bordeaux,2007,05/05/2021,10127812007,1012781
17180,04/05/2021,16861,0,6538,10642,10323,05/07/2016,"Jacques-Frederic Mugnier, Chambolle-Musigny Premier Cru, Les Amoureuses",Burgundy,2012,05/05/2021,10496422012,1049642
1040,04/05/2021,1191,52,950,90,241,03/05/2021,"Chateau Calon Segur 3eme Cru Classe, Saint-Estephe",Bordeaux,2018,05/05/2021,10074752018,1007475
830,04/05/2021,950,3,735,95,215,09/09/2020,"Chateau Calon Segur 3eme Cru Classe, Saint-Estephe",Bordeaux,2012,05/05/2021,10074752012,1007475
1550,04/05/2021,1587,2,1440,110,147,04/01/2018,"Gaja, Barbaresco",Piedmont,2010,05/05/2021,10996052010,1099605
1500,04/05/2021,1708,41,1408,92,300,09/04/2021,"Gaja, Barbaresco",Piedmont,2016,05/05/2021,10996052016,1099605
1400,04/05/2021,1436,9,1276,124,160,05/03/2021,"Gaja, Barbaresco",Piedmont,2013,05/05/2021,10996052013,1099605
1082,04/05/2021,1201,65,1048,34,153,27/04/2021,"Chateau Calon Segur 3eme Cru Classe, Saint-Estephe",Bordeaux,2016,05/05/2021,10074752016,1007475
400,14/06/2021,439,5,300,100,139,05/11/2020,"Chateau Batailley 5eme Cru Classe, Pauillac",Bordeaux,2011,15/06/2021,10063222011,1006322
400,14/06/2021,439,5,300,100,139,05/11/2020,"Chateau Batailley 5eme Cru Classe, Pauillac",Bordeaux,2011,15/06/2021,10063222011,1006322
400,14/06/2021,427,8,355,45,72,15/04/2021,"Chateau Batailley 5eme Cru Classe, Pauillac",Bordeaux,2012,15/06/2021,10063222012,1006322
3295,05/07/2021,3669,23,3020,275,649,03/06/2021,"Chateau Angelus Premier Grand Cru Classe B, Saint-Emilion Grand Cru",Bordeaux,2009,08/07/2021,10060452009,1006045
840,04/05/2021,943,15,781,59,162,16/11/2020,"Chateau Calon Segur 3eme Cru Classe, Saint-Estephe",Bordeaux,2008,05/05/2021,10074752008,1007475
8000,04/05/2021,8449,7,6974,1026,1475,14/03/2021,"Domaine Leflaive, Chevalier-Montrachet Grand Cru",Burgundy,2017,05/05/2021,10734012017,1073401
520,04/05/2021,575,4,460,60,115,05/05/2020,"Tua Rita, Giusto di Notri, Toscana",Tuscany,2008,05/05/2021,11058072008,1105807
1000,03/05/2021,1181,69,975,25,206,12/04/2021,"Chateau Calon Segur 3eme Cru Classe, Saint-Estephe",Bordeaux,2005,05/05/2021,10074752005,1007475
3295,05/07/2021,3669,23,3020,275,649,03/06/2021,"Chateau Angelus Premier Grand Cru Classe B, Saint-Emilion Grand Cru",Bordeaux,2009,08/07/2021,10060452009,1006045
3295,02/07/2021,3693,23,3020,275,673,03/06/2021,"Chateau Angelus Premier Grand Cru Classe B, Saint-Emilion Grand Cru",Bordeaux,2009,03/07/2021,10060452009,1006045
10650,04/05/2021,10047,1,4000,6650,6047,25/04/2016,"Domaine Denis Mortet, Chambertin Grand Cru",Burgundy,2013,05/05/2021,10490202013,1049020
3295,02/07/2021,3693,23,3020,275,673,03/06/2021,"Chateau Angelus Premier Grand Cru Classe B, Saint-Emilion Grand Cru",Bordeaux,2009,03/07/2021,10060452009,1006045
3700,04/05/2021,4211,165,3670,30,541,19/03/2021,"Chateau Margaux Premier Cru Classe, Margaux",Bordeaux,2017,05/05/2021,10127812017,1012781
6750,04/05/2021,7944,99,6412,338,1532,25/03/2021,"Chateau Margaux Premier Cru Classe, Margaux",Bordeaux,2009,05/05/2021,10127812009,1012781
4400,04/05/2021,4898,27,4400,0,498,29/09/2020,"Chateau Margaux Premier Cru Classe, Margaux",Bordeaux,2001,05/05/2021,10127812001,1012781
3295,28/06/2021,3680,23,3020,275,660,03/06/2021,"Chateau Angelus Premier Grand Cru Classe B, Saint-Emilion Grand Cru",Bordeaux,2009,30/06/2021,10060452009,1006045
7000,04/05/2021,6735,1,5360,1640,1375,18/09/2020,"Domaine Leflaive, Chevalier-Montrachet Grand Cru",Burgundy,2009,05/05/2021,10734012009,1073401
908,04/05/2021,1101,94,860,48,241,19/04/2021,"Chateau Calon Segur 3eme Cru Classe, Saint-Estephe",Bordeaux,2015,05/05/2021,10074752015,1007475
920,04/05/2021,1098,45,830,90,268,18/04/2021,"Tignanello, Toscana",Tuscany,2014,05/05/2021,10953912014,1095391
1408,03/05/2021,1434,5,1238,170,196,02/11/2020,"Tignanello, Toscana",Tuscany,2006,05/05/2021,10953912006,1095391
3295,28/06/2021,3691,24,3020,275,671,03/06/2021,"Chateau Angelus Premier Grand Cru Classe B, Saint-Emilion Grand Cru",Bordeaux,2009,01/07/2021,10060452009,1006045
840,04/05/2021,1028,46,800,40,228,30/12/2020,"Chateau Calon Segur 3eme Cru Classe, Saint-Estephe",Bordeaux,2006,05/05/2021,10074752006,1007475
3295,28/06/2021,3680,23,3020,275,660,03/06/2021,"Chateau Angelus Premier Grand Cru Classe B, Saint-Emilion Grand Cru",Bordeaux,2009,30/06/2021,10060452009,1006045
8400,04/05/2021,8400,0,7200,1200,1200,06/11/2019,"Domaine Denis Mortet, Chambertin Grand Cru",Burgundy,2014,05/05/2021,10490202014,1049020
1000,04/05/2021,1057,9,860,140,197,08/03/2021,"Tignanello, Toscana",Tuscany,2011,05/05/2021,10953912011,1095391
900,03/05/2021,1062,21,800,100,262,21/11/2019,"Chateau Calon Segur 3eme Cru Classe, Saint-Estephe",Bordeaux,2003,05/05/2021,10074752003,1007475
3720,04/05/2021,4056,50,3480,240,576,10/04/2021,"Chateau Margaux Premier Cru Classe, Margaux",Bordeaux,2014,05/05/2021,10127812014,1012781
780,04/05/2021,837,6,682,98,155,15/09/2020,"Chateau Calon Segur 3eme Cru Classe, Saint-Estephe",Bordeaux,2013,05/05/2021,10074752013,1007475
5440,03/05/2021,5481,61,5288,152,193,03/05/2021,"Chateau Margaux Premier Cru Classe, Margaux",Bordeaux,2016,05/05/2021,10127812016,1012781
1050,04/05/2021,1219,17,1047,3,172,27/04/2021,"Chateau Calon Segur 3eme Cru Classe, Saint-Estephe",Bordeaux,2009,05/05/2021,10074752009,1007475
10500,04/05/2021,12466,69,9844,656,2622,29/03/2021,"Chateau Margaux Premier Cru Classe, Margaux",Bordeaux,2015,05/05/2021,10127812015,1012781
750,04/05/2021,1008,37,790,-40,218,01/06/2020,"Chateau Calon Segur 3eme Cru Classe, Saint-Estephe",Bordeaux,2011,05/05/2021,10074752011,1007475
738,03/05/2021,885,107,760,-22,125,29/04/2021,"Chateau Calon Segur 3eme Cru Classe, Saint-Estephe",Bordeaux,2017,05/05/2021,10074752017,1007475
3875,04/05/2021,4486,75,3880,-5,606,22/03/2021,"Chateau Margaux Premier Cru Classe, Margaux",Bordeaux,2008,05/05/2021,10127812008,1012781
3800,28/07/2021,4228,49,3690,110,538,13/04/2021,"Chateau Margaux Premier Cru Classe, Margaux",Bordeaux,2011,04/08/2021,10127812011,1012781
3295,28/06/2021,3691,24,3020,275,671,03/06/2021,"Chateau Angelus Premier Grand Cru Classe B, Saint-Emilion Grand Cru",Bordeaux,2009,01/07/2021,10060452009,1006045
6830,30/06/2021,7732,48,7086,-256,646,11/06/2021,"Chateau Margaux Premier Cru Classe, Margaux",Bordeaux,2009,01/07/2021,10127812009,1012781
3295,28/06/2021,3695,24,3020,275,675,03/06/2021,"Chateau Angelus Premier Grand Cru Classe B, Saint-Emilion Grand Cru",Bordeaux,2009,02/07/2021,10060452009,1006045
10620,05/08/2021,11970,49,9800,820,2170,11/06/2021,"Chateau Margaux Premier Cru Classe, Margaux",Bordeaux,2015,06/08/2021,10127812015,1012781
3295,28/06/2021,3695,24,3020,275,675,03/06/2021,"Chateau Angelus Premier Grand Cru Classe B, Saint-Emilion Grand Cru",Bordeaux,2009,02/07/2021,10060452009,1006045
790,06/05/2021,921,154,907,-117,14,03/05/2021,"Tignanello, Toscana",Tuscany,2017,08/05/2021,10953912017,1095391
3250,17/06/2021,3680,23,3020,230,660,03/06/2021,"Chateau Angelus Premier Grand Cru Classe B, Saint-Emilion Grand Cru",Bordeaux,2009,26/06/2021,10060452009,1006045
8000,07/05/2021,8252,20,7950,50,302,12/03/2021,"Chateau Margaux Premier Cru Classe, Margaux",Bordeaux,2000,08/05/2021,10127812000,1012781
660,07/05/2021,724,4,390,270,334,18/08/2017,"Tua Rita, Giusto di Notri, Toscana",Tuscany,2006,08/05/2021,11058072006,1105807
866,06/05/2021,897,49,842,24,55,22/08/2020,"Chateau Calon Segur 3eme Cru Classe, Saint-Estephe",Bordeaux,2019,08/05/2021,10074752019,1007475
9950,07/05/2021,9718,3,8000,1950,1718,30/01/2020,"Domaine Leflaive, Chevalier-Montrachet Grand Cru",Burgundy,2014,08/05/2021,10734012014,1073401
958,07/05/2021,1057,9,860,98,197,08/03/2021,"Tignanello, Toscana",Tuscany,2011,08/05/2021,10953912011,1095391
880,07/05/2021,958,9,725,155,233,13/04/2021,"Chateau Calon Segur 3eme Cru Classe, Saint-Estephe",Bordeaux,2007,08/05/2021,10074752007,1007475
1350,07/05/2021,1464,48,1260,90,204,18/02/2021,"Gaja, Barbaresco",Piedmont,2015,08/05/2021,10996052015,1099605
3250,17/06/2021,3638,22,3020,230,618,03/06/2021,"Chateau Angelus Premier Grand Cru Classe B, Saint-Emilion Grand Cru",Bordeaux,2009,24/06/2021,10060452009,1006045
3250,17/06/2021,3622,24,3020,230,602,03/06/2021,"Chateau Angelus Premier Grand Cru Classe B, Saint-Emilion Grand Cru",Bordeaux,2009,23/06/2021,10060452009,1006045
3250,17/06/2021,3597,22,3020,230,577,03/06/2021,"Chateau Angelus Premier Grand Cru Classe B, Saint-Emilion Grand Cru",Bordeaux,2009,22/06/2021,10060452009,1006045
3250,17/06/2021,3648,23,3020,230,628,03/06/2021,"Chateau Angelus Premier Grand Cru Classe B, Saint-Emilion Grand Cru",Bordeaux,2009,18/06/2021,10060452009,1006045
9460,07/05/2021,9840,3,7290,2170,2550,21/08/2020,"Domaine Denis Mortet, Chambertin Grand Cru",Burgundy,2017,08/05/2021,10490202017,1049020
840,07/05/2021,1015,50,800,40,215,30/12/2020,"Chateau Calon Segur 3eme Cru Classe, Saint-Estephe",Bordeaux,2006,08/05/2021,10074752006,1007475
400,14/06/2021,427,8,355,45,72,15/04/2021,"Chateau Batailley 5eme Cru Classe, Pauillac",Bordeaux,2012,15/06/2021,10063222012,1006322
1000,07/05/2021,1230,16,1047,-47,183,27/04/2021,"Chateau Calon Segur 3eme Cru Classe, Saint-Estephe",Bordeaux,2009,08/05/2021,10074752009,1007475
1400,07/05/2021,1433,10,1276,124,157,05/03/2021,"Gaja, Barbaresco",Piedmont,2013,08/05/2021,10996052013,1099605
738,03/05/2021,885,110,760,-22,125,29/04/2021,"Chateau Calon Segur 3eme Cru Classe, Saint-Estephe",Bordeaux,2017,08/05/2021,10074752017,1007475
3250,17/06/2021,3637,22,3020,230,617,03/06/2021,"Chateau Angelus Premier Grand Cru Classe B, Saint-Emilion Grand Cru",Bordeaux,2009,19/06/2021,10060452009,1006045
3250,17/06/2021,3622,24,3020,230,602,03/06/2021,"Chateau Angelus Premier Grand Cru Classe B, Saint-Emilion Grand Cru",Bordeaux,2009,23/06/2021,10060452009,1006045
1050,07/05/2021,1348,39,940,110,408,18/03/2021,"Chateau Calon Segur 3eme Cru Classe, Saint-Estephe",Bordeaux,2000,08/05/2021,10074752000,1007475
840,07/05/2021,941,15,781,59,160,16/11/2020,"Chateau Calon Segur 3eme Cru Classe, Saint-Estephe",Bordeaux,2008,08/05/2021,10074752008,1007475
3250,17/06/2021,3597,22,3020,230,577,03/06/2021,"Chateau Angelus Premier Grand Cru Classe B, Saint-Emilion Grand Cru",Bordeaux,2009,22/06/2021,10060452009,1006045
300,14/06/2021,300,103,304,-4,-4,10/01/2021,"Chateau Batailley 5eme Cru Classe, Pauillac",Bordeaux,2013,15/06/2021,10063222013,1006322
7200,07/05/2021,6997,2,7900,-700,-903,29/04/2019,"Domaine Leflaive, Chevalier-Montrachet Grand Cru",Burgundy,2015,08/05/2021,10734012015,1073401
3250,17/06/2021,3638,22,3020,230,618,03/06/2021,"Chateau Angelus Premier Grand Cru Classe B, Saint-Emilion Grand Cru",Bordeaux,2009,24/06/2021,10060452009,1006045
350,14/06/2021,368,89,324,26,44,09/06/2021,"Chateau Batailley 5eme Cru Classe, Pauillac",Bordeaux,2014,15/06/2021,10063222014,1006322
476,14/06/2021,524,46,364,112,160,12/05/2021,"Chateau Batailley 5eme Cru Classe, Pauillac",Bordeaux,2016,15/06/2021,10063222016,1006322
12402,07/05/2021,12557,2,12850,-448,-293,30/11/2020,"Jacques-Frederic Mugnier, Chambolle-Musigny Premier Cru, Les Amoureuses",Burgundy,2011,08/05/2021,10496422011,1049642
3250,17/06/2021,3660,24,3020,230,640,03/06/2021,"Chateau Angelus Premier Grand Cru Classe B, Saint-Emilion Grand Cru",Bordeaux,2009,25/06/2021,10060452009,1006045
4850,06/05/2021,5732,22,4800,50,932,11/03/2021,"Chateau Margaux Premier Cru Classe, Margaux",Bordeaux,2003,08/05/2021,10127812003,1012781
907,07/05/2021,1101,28,805,102,296,20/11/2019,"Chateau Calon Segur 3eme Cru Classe, Saint-Estephe",Bordeaux,2001,08/05/2021,10074752001,1007475
6600,07/05/2021,7959,74,6412,188,1547,25/03/2021,"Chateau Margaux Premier Cru Classe, Margaux",Bordeaux,2009,08/05/2021,10127812009,1012781
6250,07/05/2021,7441,54,5922,328,1519,13/04/2021,"Chateau Margaux Premier Cru Classe, Margaux",Bordeaux,2010,08/05/2021,10127812010,1012781
2872,07/05/2021,2872,2,2554,318,318,22/05/2020,"Gaja, Barbaresco",Piedmont,2006,08/05/2021,10996052006,1099605
850,07/05/2021,1101,94,860,-10,241,19/04/2021,"Chateau Calon Segur 3eme Cru Classe, Saint-Estephe",Bordeaux,2015,08/05/2021,10074752015,1007475
3900,07/05/2021,4435,31,3684,216,751,10/06/2020,"Chateau Margaux Premier Cru Classe, Margaux",Bordeaux,2002,08/05/2021,10127812002,1012781
564,07/05/2021,564,1,351,213,213,25/07/2016,"Tua Rita, Giusto di Notri, Toscana",Tuscany,2004,08/05/2021,11058072004,1105807
3250,17/06/2021,3680,23,3020,230,660,03/06/2021,"Chateau Angelus Premier Grand Cru Classe B, Saint-Emilion Grand Cru",Bordeaux,2009,26/06/2021,10060452009,1006045
3700,06/05/2021,4089,28,3592,108,497,06/05/2021,"Chateau Margaux Premier Cru Classe, Margaux",Bordeaux,2007,08/05/2021,10127812007,1012781
460,07/05/2021,488,159,420,40,68,23/03/2021,"Tua Rita, Giusto di Notri, Toscana",Tuscany,2016,08/05/2021,11058072016,1105807
8000,07/05/2021,8567,8,6974,1026,1593,14/03/2021,"Domaine Leflaive, Chevalier-Montrachet Grand Cru",Burgundy,2017,08/05/2021,10734012017,1073401
3720,07/05/2021,4074,51,3480,240,594,10/04/2021,"Chateau Margaux Premier Cru Classe, Margaux",Bordeaux,2014,08/05/2021,10127812014,1012781
7000,07/05/2021,6781,1,5360,1640,1421,18/09/2020,"Domaine Leflaive, Chevalier-Montrachet Grand Cru",Burgundy,2009,08/05/2021,10734012009,1073401
780,07/05/2021,837,6,682,98,155,15/09/2020,"Chateau Calon Segur 3eme Cru Classe, Saint-Estephe",Bordeaux,2013,08/05/2021,10074752013,1007475
7800,07/05/2021,8204,7,7000,800,1204,26/04/2021,"Domaine Leflaive, Chevalier-Montrachet Grand Cru",Burgundy,2018,08/05/2021,10734012018,1073401
750,07/05/2021,1007,36,790,-40,217,01/06/2020,"Chateau Calon Segur 3eme Cru Classe, Saint-Estephe",Bordeaux,2011,08/05/2021,10074752011,1007475
6800,07/05/2021,6800,1,1730,5070,5070,31/10/2011,"Domaine Leflaive, Chevalier-Montrachet Grand Cru",Burgundy,2003,08/05/2021,10734012003,1073401
2260,07/05/2021,2305,4,2190,70,115,01/05/2021,"Gaja, Barbaresco",Piedmont,2004,08/05/2021,10996052004,1099605
980,07/05/2021,1121,18,1000,-20,121,12/04/2021,"Chateau Calon Segur 3eme Cru Classe, Saint-Estephe",Bordeaux,2010,08/05/2021,10074752010,1007475
768,07/05/2021,854,7,705,63,149,01/02/2021,"Chateau Calon Segur 3eme Cru Classe, Saint-Estephe",Bordeaux,2002,08/05/2021,10074752002,1007475
7600,07/05/2021,7852,2,7124,476,728,15/02/2019,"Domaine Leflaive, Chevalier-Montrachet Grand Cru",Burgundy,2016,08/05/2021,10734012016,1073401
870,06/05/2021,1037,66,950,-80,87,03/05/2021,"Tignanello, Toscana",Tuscany,2018,08/05/2021,10953912018,1095391
5490,07/05/2021,5658,138,5150,340,508,03/05/2021,"Chateau Margaux Premier Cru Classe, Margaux",Bordeaux,2018,08/05/2021,10127812018,1012781
1380,07/05/2021,1458,7,1352,28,106,23/09/2020,"Gaja, Barbaresco",Piedmont,2011,08/05/2021,10996052011,1099605
3250,17/06/2021,3648,23,3020,230,628,03/06/2021,"Chateau Angelus Premier Grand Cru Classe B, Saint-Emilion Grand Cru",Bordeaux,2009,18/06/2021,10060452009,1006045
5530,07/05/2021,5493,59,5288,242,205,03/05/2021,"Chateau Margaux Premier Cru Classe, Margaux",Bordeaux,2016,08/05/2021,10127812016,1012781
1110,04/05/2021,1179,12,1204,-94,-25,03/05/2021,"Tignanello, Toscana",Tuscany,2015,08/05/2021,10953912015,1095391
540,07/05/2021,540,1,300,240,240,03/11/2011,"Tua Rita, Giusto di Notri, Toscana",Tuscany,2007,08/05/2021,11058072007,1105807
3250,17/06/2021,3637,22,3020,230,617,03/06/2021,"Chateau Angelus Premier Grand Cru Classe B, Saint-Emilion Grand Cru",Bordeaux,2009,19/06/2021,10060452009,1006045
3800,07/05/2021,4155,37,3560,240,595,20/11/2020,"Chateau Margaux Premier Cru Classe, Margaux",Bordeaux,2012,08/05/2021,10127812012,1012781
6250,07/05/2021,7037,46,6116,134,921,07/05/2021,"Chateau Margaux Premier Cru Classe, Margaux",Bordeaux,2005,08/05/2021,10127812005,1012781
3920,07/05/2021,4486,75,3880,40,606,22/03/2021,"Chateau Margaux Premier Cru Classe, Margaux",Bordeaux,2008,08/05/2021,10127812008,1012781
480,15/06/2021,526,4,420,60,106,09/07/2019,"Chateau Batailley 5eme Cru Classe, Pauillac",Bordeaux,2003,16/06/2021,10063222003,1006322
3800,07/05/2021,4383,125,3690,110,693,13/04/2021,"Chateau Margaux Premier Cru Classe, Margaux",Bordeaux,2011,08/05/2021,10127812011,1012781
1800,07/05/2021,1840,2,1300,500,540,30/05/2019,"Gaja, Barbaresco",Piedmont,2007,08/05/2021,10996052007,1099605
530,15/06/2021,674,94,450,80,224,04/05/2021,"Chateau Batailley 5eme Cru Classe, Pauillac",Bordeaux,2005,16/06/2021,10063222005,1006322
900,07/05/2021,1062,21,800,100,262,21/11/2019,"Chateau Calon Segur 3eme Cru Classe, Saint-Estephe",Bordeaux,2003,08/05/2021,10074752003,1007475
1024,07/05/2021,1125,10,1072,-48,53,20/01/2021,"Tignanello, Toscana",Tuscany,2009,08/05/2021,10953912009,1095391
3700,07/05/2021,3996,24,3520,180,476,07/04/2021,"Chateau Margaux Premier Cru Classe, Margaux",Bordeaux,2013,08/05/2021,10127812013,1012781
3250,17/06/2021,3660,24,3020,230,640,03/06/2021,"Chateau Angelus Premier Grand Cru Classe B, Saint-Emilion Grand Cru",Bordeaux,2009,25/06/2021,10060452009,1006045
3700,07/05/2021,4214,166,3700,0,514,06/05/2021,"Chateau Margaux Premier Cru Classe, Margaux",Bordeaux,2017,08/05/2021,10127812017,1012781
1700,07/05/2021,1656,3,1378,322,278,29/07/2020,"Tignanello, Toscana",Tuscany,2001,08/05/2021,10953912001,1095391
1280,07/05/2021,1225,11,1172,108,53,07/04/2021,"Tignanello, Toscana",Tuscany,2010,08/05/2021,10953912010,1095391
8400,07/05/2021,8400,0,7200,1200,1200,06/11/2019,"Domaine Denis Mortet, Chambertin Grand Cru",Burgundy,2014,08/05/2021,10490202014,1049020
4400,07/05/2021,4898,27,4400,0,498,29/09/2020,"Chateau Margaux Premier Cru Classe, Margaux",Bordeaux,2001,08/05/2021,10127812001,1012781
4820,06/05/2021,4893,7,4160,660,733,19/03/2021,"Chateau Margaux Premier Cru Classe, Margaux",Bordeaux,2019,08/05/2021,10127812019,1012781
530,15/06/2021,674,94,450,80,224,04/05/2021,"Chateau Batailley 5eme Cru Classe, Pauillac",Bordeaux,2005,16/06/2021,10063222005,1006322
3910,07/05/2021,4777,80,3800,110,977,07/04/2021,"Chateau Margaux Premier Cru Classe, Margaux",Bordeaux,2006,08/05/2021,10127812006,1012781
548,07/05/2021,560,3,544,4,16,18/09/2020,"Tua Rita, Giusto di Notri, Toscana",Tuscany,2013,08/05/2021,11058072013,1105807
420,15/06/2021,521,5,400,20,121,11/05/2021,"Chateau Batailley 5eme Cru Classe, Pauillac",Bordeaux,2006,16/06/2021,10063222006,1006322
1500,07/05/2021,1679,36,1408,92,271,09/04/2021,"Gaja, Barbaresco",Piedmont,2016,08/05/2021,10996052016,1099605
3827,07/05/2021,4597,57,4116,-289,481,25/02/2021,"Chateau Margaux Premier Cru Classe, Margaux",Bordeaux,2004,08/05/2021,10127812004,1012781
420,15/06/2021,521,5,400,20,121,11/05/2021,"Chateau Batailley 5eme Cru Classe, Pauillac",Bordeaux,2006,16/06/2021,10063222006,1006322
10500,07/05/2021,12398,67,9844,656,2554,29/03/2021,"Chateau Margaux Premier Cru Classe, Margaux",Bordeaux,2015,08/05/2021,10127812015,1012781
3200,15/06/2021,3673,23,3020,180,653,03/06/2021,"Chateau Angelus Premier Grand Cru Classe B, Saint-Emilion Grand Cru",Bordeaux,2009,16/06/2021,10060452009,1006045
3950,06/08/2021,4469,108,3780,170,689,23/07/2021,"Chateau Margaux Premier Cru Classe, Margaux",Bordeaux,2008,07/08/2021,10127812008,1012781
870,15/07/2021,966,5,705,165,261,01/02/2021,"Chateau Calon Segur 3eme Cru Classe, Saint-Estephe",Bordeaux,2002,16/07/2021,10074752002,1007475
8200,15/07/2021,8936,14,8100,100,836,21/06/2021,"Chateau Margaux Premier Cru Classe, Margaux",Bordeaux,2000,16/07/2021,10127812000,1012781
3200,15/06/2021,3673,23,3020,180,653,03/06/2021,"Chateau Angelus Premier Grand Cru Classe B, Saint-Emilion Grand Cru",Bordeaux,2009,16/06/2021,10060452009,1006045
945,15/07/2021,1128,23,800,145,328,21/11/2019,"Chateau Calon Segur 3eme Cru Classe, Saint-Estephe",Bordeaux,2003,16/07/2021,10074752003,1007475
4450,15/07/2021,4783,23,4400,50,383,29/09/2020,"Chateau Margaux Premier Cru Classe, Margaux",Bordeaux,2001,16/07/2021,10127812001,1012781
3939,15/07/2021,4430,22,3684,255,746,10/06/2020,"Chateau Margaux Premier Cru Classe, Margaux",Bordeaux,2002,16/07/2021,10127812002,1012781
3715,15/07/2021,4581,47,4116,-401,465,25/02/2021,"Chateau Margaux Premier Cru Classe, Margaux",Bordeaux,2004,16/07/2021,10127812004,1012781
3200,14/06/2021,3673,23,3020,180,653,03/06/2021,"Chateau Angelus Premier Grand Cru Classe B, Saint-Emilion Grand Cru",Bordeaux,2009,15/06/2021,10060452009,1006045
3200,14/06/2021,3673,23,3020,180,653,03/06/2021,"Chateau Angelus Premier Grand Cru Classe B, Saint-Emilion Grand Cru",Bordeaux,2009,15/06/2021,10060452009,1006045
840,15/07/2021,977,16,745,95,232,16/11/2020,"Chateau Calon Segur 3eme Cru Classe, Saint-Estephe",Bordeaux,2004,16/07/2021,10074752004,1007475
3200,11/06/2021,3653,24,3020,180,633,03/06/2021,"Chateau Angelus Premier Grand Cru Classe B, Saint-Emilion Grand Cru",Bordeaux,2009,12/06/2021,10060452009,1006045
450,15/06/2021,450,1,340,110,110,31/08/2018,"Chateau Batailley 5eme Cru Classe, Pauillac",Bordeaux,2007,16/06/2021,10063222007,1006322
3200,11/06/2021,3653,24,3020,180,633,03/06/2021,"Chateau Angelus Premier Grand Cru Classe B, Saint-Emilion Grand Cru",Bordeaux,2009,12/06/2021,10060452009,1006045
1408,03/05/2021,1455,6,1238,170,217,02/11/2020,"Tignanello, Toscana",Tuscany,2006,04/05/2021,10953912006,1095391
1050,03/05/2021,1343,43,940,110,403,18/03/2021,"Chateau Calon Segur 3eme Cru Classe, Saint-Estephe",Bordeaux,2000,04/05/2021,10074752000,1007475
1350,03/05/2021,1474,60,1260,90,214,18/02/2021,"Gaja, Barbaresco",Piedmont,2015,04/05/2021,10996052015,1099605
420,03/05/2021,462,10,342,78,120,21/08/2020,"Tua Rita, Giusto di Notri, Toscana",Tuscany,2011,04/05/2021,11058072011,1105807
8400,03/05/2021,8400,0,7200,1200,1200,06/11/2019,"Domaine Denis Mortet, Chambertin Grand Cru",Burgundy,2014,04/05/2021,10490202014,1049020
3200,10/06/2021,3653,24,3020,180,633,03/06/2021,"Chateau Angelus Premier Grand Cru Classe B, Saint-Emilion Grand Cru",Bordeaux,2009,11/06/2021,10060452009,1006045
890,03/05/2021,1099,29,805,85,294,20/11/2019,"Chateau Calon Segur 3eme Cru Classe, Saint-Estephe",Bordeaux,2001,04/05/2021,10074752001,1007475
2260,03/05/2021,2311,4,2190,70,121,01/05/2021,"Gaja, Barbaresco",Piedmont,2004,04/05/2021,10996052004,1099605
400,15/06/2021,427,8,355,45,72,15/04/2021,"Chateau Batailley 5eme Cru Classe, Pauillac",Bordeaux,2012,16/06/2021,10063222012,1006322
1380,03/05/2021,1448,8,1352,28,96,23/09/2020,"Gaja, Barbaresco",Piedmont,2011,04/05/2021,10996052011,1099605
400,15/06/2021,427,8,355,45,72,15/04/2021,"Chateau Batailley 5eme Cru Classe, Pauillac",Bordeaux,2012,16/06/2021,10063222012,1006322
300,15/06/2021,302,104,304,-4,-2,10/01/2021,"Chateau Batailley 5eme Cru Classe, Pauillac",Bordeaux,2013,16/06/2021,10063222013,1006322
476,15/06/2021,524,46,364,112,160,12/05/2021,"Chateau Batailley 5eme Cru Classe, Pauillac",Bordeaux,2016,16/06/2021,10063222016,1006322
6750,03/05/2021,7975,97,6412,338,1563,25/03/2021,"Chateau Margaux Premier Cru Classe, Margaux",Bordeaux,2009,04/05/2021,10127812009,1012781
1000,03/05/2021,1054,9,860,140,194,08/03/2021,"Tignanello, Toscana",Tuscany,2011,04/05/2021,10953912011,1095391
1120,03/05/2021,1177,13,1204,-84,-27,03/05/2021,"Tignanello, Toscana",Tuscany,2015,04/05/2021,10953912015,1095391
738,03/05/2021,878,90,760,-22,118,29/04/2021,"Chateau Calon Segur 3eme Cru Classe, Saint-Estephe",Bordeaux,2017,04/05/2021,10074752017,1007475
3200,10/06/2021,3653,24,3020,180,633,03/06/2021,"Chateau Angelus Premier Grand Cru Classe B, Saint-Emilion Grand Cru",Bordeaux,2009,11/06/2021,10060452009,1006045
3800,03/05/2021,4376,81,3560,240,816,20/11/2020,"Chateau Margaux Premier Cru Classe, Margaux",Bordeaux,2012,04/05/2021,10127812012,1012781
8000,03/05/2021,8246,15,7950,50,296,12/03/2021,"Chateau Margaux Premier Cru Classe, Margaux",Bordeaux,2000,04/05/2021,10127812000,1012781
3800,03/05/2021,4323,114,3690,110,633,13/04/2021,"Chateau Margaux Premier Cru Classe, Margaux",Bordeaux,2011,04/05/2021,10127812011,1012781
804,03/05/2021,958,17,745,59,213,16/11/2020,"Chateau Calon Segur 3eme Cru Classe, Saint-Estephe",Bordeaux,2004,04/05/2021,10074752004,1007475
6100,03/05/2021,7498,85,5922,178,1576,13/04/2021,"Chateau Margaux Premier Cru Classe, Margaux",Bordeaux,2010,04/05/2021,10127812010,1012781
860,03/05/2021,1033,65,950,-90,83,03/05/2021,"Tignanello, Toscana",Tuscany,2018,04/05/2021,10953912018,1095391
3700,03/05/2021,4224,135,3670,30,554,19/03/2021,"Chateau Margaux Premier Cru Classe, Margaux",Bordeaux,2017,04/05/2021,10127812017,1012781
900,03/05/2021,1054,10,800,100,254,21/11/2019,"Chateau Calon Segur 3eme Cru Classe, Saint-Estephe",Bordeaux,2003,04/05/2021,10074752003,1007475
3200,09/06/2021,3635,24,3020,180,615,03/06/2021,"Chateau Angelus Premier Grand Cru Classe B, Saint-Emilion Grand Cru",Bordeaux,2009,10/06/2021,10060452009,1006045
1800,03/05/2021,1852,2,1300,500,552,30/05/2019,"Gaja, Barbaresco",Piedmont,2007,04/05/2021,10996052007,1099605
480,16/06/2021,526,4,420,60,106,09/07/2019,"Chateau Batailley 5eme Cru Classe, Pauillac",Bordeaux,2003,17/06/2021,10063222003,1006322
780,03/05/2021,834,6,682,98,152,15/09/2020,"Chateau Calon Segur 3eme Cru Classe, Saint-Estephe",Bordeaux,2013,04/05/2021,10074752013,1007475
3900,03/05/2021,4447,32,3684,216,763,10/06/2020,"Chateau Margaux Premier Cru Classe, Margaux",Bordeaux,2002,04/05/2021,10127812002,1012781
450,16/06/2021,450,1,340,110,110,31/08/2018,"Chateau Batailley 5eme Cru Classe, Pauillac",Bordeaux,2007,17/06/2021,10063222007,1006322
3250,09/06/2021,3673,23,3020,230,653,03/06/2021,"Chateau Angelus Premier Grand Cru Classe B, Saint-Emilion Grand Cru",Bordeaux,2009,17/06/2021,10060452009,1006045
3200,09/06/2021,3635,24,3020,180,615,03/06/2021,"Chateau Angelus Premier Grand Cru Classe B, Saint-Emilion Grand Cru",Bordeaux,2009,10/06/2021,10060452009,1006045
3250,09/06/2021,3673,23,3020,230,653,03/06/2021,"Chateau Angelus Premier Grand Cru Classe B, Saint-Emilion Grand Cru",Bordeaux,2009,17/06/2021,10060452009,1006045
12402,03/05/2021,12601,2,12850,-448,-249,30/11/2020,"Jacques-Frederic Mugnier, Chambolle-Musigny Premier Cru, Les Amoureuses",Burgundy,2011,04/05/2021,10496422011,1049642
980,03/05/2021,1097,45,830,150,267,18/04/2021,"Tignanello, Toscana",Tuscany,2014,04/05/2021,10953912014,1095391
400,16/06/2021,427,8,355,45,72,15/04/2021,"Chateau Batailley 5eme Cru Classe, Pauillac",Bordeaux,2012,17/06/2021,10063222012,1006322
3200,08/06/2021,3620,25,3020,180,600,03/06/2021,"Chateau Angelus Premier Grand Cru Classe B, Saint-Emilion Grand Cru",Bordeaux,2009,09/06/2021,10060452009,1006045
1020,03/05/2021,1129,17,1000,20,129,12/04/2021,"Chateau Calon Segur 3eme Cru Classe, Saint-Estephe",Bordeaux,2010,04/05/2021,10074752010,1007475
960,03/05/2021,1197,13,850,110,347,28/01/2021,"Tignanello, Toscana",Tuscany,2012,04/05/2021,10953912012,1095391
750,03/05/2021,994,32,790,-40,204,01/06/2020,"Chateau Calon Segur 3eme Cru Classe, Saint-Estephe",Bordeaux,2011,04/05/2021,10074752011,1007475
1500,03/05/2021,1708,41,1408,92,300,09/04/2021,"Gaja, Barbaresco",Piedmont,2016,04/05/2021,10996052016,1099605
400,16/06/2021,427,8,355,45,72,15/04/2021,"Chateau Batailley 5eme Cru Classe, Pauillac",Bordeaux,2012,17/06/2021,10063222012,1006322
3827,03/05/2021,4617,61,4116,-289,501,25/02/2021,"Chateau Margaux Premier Cru Classe, Margaux",Bordeaux,2004,04/05/2021,10127812004,1012781
3200,08/06/2021,3620,25,3020,180,600,03/06/2021,"Chateau Angelus Premier Grand Cru Classe B, Saint-Emilion Grand Cru",Bordeaux,2009,09/06/2021,10060452009,1006045
3200,07/06/2021,3620,25,3020,180,600,03/06/2021,"Chateau Angelus Premier Grand Cru Classe B, Saint-Emilion Grand Cru",Bordeaux,2009,08/06/2021,10060452009,1006045
300,16/06/2021,302,104,304,-4,-2,10/01/2021,"Chateau Batailley 5eme Cru Classe, Pauillac",Bordeaux,2013,17/06/2021,10063222013,1006322
3200,07/06/2021,3620,25,3020,180,600,03/06/2021,"Chateau Angelus Premier Grand Cru Classe B, Saint-Emilion Grand Cru",Bordeaux,2009,08/06/2021,10060452009,1006045
1100,03/05/2021,1433,9,1010,90,423,18/12/2020,"Tignanello, Toscana",Tuscany,2008,04/05/2021,10953912008,1095391
7800,03/05/2021,8188,6,7000,800,1188,26/04/2021,"Domaine Leflaive, Chevalier-Montrachet Grand Cru",Burgundy,2018,04/05/2021,10734012018,1073401
476,16/06/2021,524,46,364,112,160,12/05/2021,"Chateau Batailley 5eme Cru Classe, Pauillac",Bordeaux,2016,17/06/2021,10063222016,1006322
4400,03/05/2021,4883,26,4400,0,483,29/09/2020,"Chateau Margaux Premier Cru Classe, Margaux",Bordeaux,2001,04/05/2021,10127812001,1012781
564,03/05/2021,564,1,351,213,213,25/07/2016,"Tua Rita, Giusto di Notri, Toscana",Tuscany,2004,04/05/2021,11058072004,1105807
3200,04/06/2021,3620,25,3020,180,600,03/06/2021,"Chateau Angelus Premier Grand Cru Classe B, Saint-Emilion Grand Cru",Bordeaux,2009,07/06/2021,10060452009,1006045
3560,03/05/2021,4162,29,3450,110,712,11/11/2020,"Chateau Margaux Premier Cru Classe, Margaux",Bordeaux,2007,04/05/2021,10127812007,1012781
405,16/06/2021,418,19,357,48,61,06/05/2021,"Chateau Batailley 5eme Cru Classe, Pauillac",Bordeaux,2018,23/06/2021,10063222018,1006322
840,03/05/2021,943,15,781,59,162,16/11/2020,"Chateau Calon Segur 3eme Cru Classe, Saint-Estephe",Bordeaux,2008,04/05/2021,10074752008,1007475
460,03/05/2021,487,165,420,40,67,23/03/2021,"Tua Rita, Giusto di Notri, Toscana",Tuscany,2016,04/05/2021,11058072016,1105807
540,03/05/2021,540,1,300,240,240,03/11/2011,"Tua Rita, Giusto di Notri, Toscana",Tuscany,2007,04/05/2021,11058072007,1105807
660,03/05/2021,724,4,390,270,334,18/08/2017,"Tua Rita, Giusto di Notri, Toscana",Tuscany,2006,04/05/2021,11058072006,1105807
2872,03/05/2021,2872,1,2554,318,318,22/05/2020,"Gaja, Barbaresco",Piedmont,2006,04/05/2021,10996052006,1099605
790,03/05/2021,925,153,907,-117,18,03/05/2021,"Tignanello, Toscana",Tuscany,2017,04/05/2021,10953912017,1095391
7000,03/05/2021,6735,1,5360,1640,1375,18/09/2020,"Domaine Leflaive, Chevalier-Montrachet Grand Cru",Burgundy,2009,04/05/2021,10734012009,1073401
1400,03/05/2021,1436,9,1276,124,160,05/03/2021,"Gaja, Barbaresco",Piedmont,2013,04/05/2021,10996052013,1099605
6800,03/05/2021,6800,1,1730,5070,5070,31/10/2011,"Domaine Leflaive, Chevalier-Montrachet Grand Cru",Burgundy,2003,04/05/2021,10734012003,1073401
3875,03/05/2021,4472,67,3880,-5,592,22/03/2021,"Chateau Margaux Premier Cru Classe, Margaux",Bordeaux,2008,04/05/2021,10127812008,1012781
840,03/05/2021,1029,51,800,40,229,30/12/2020,"Chateau Calon Segur 3eme Cru Classe, Saint-Estephe",Bordeaux,2006,04/05/2021,10074752006,1007475
860,03/05/2021,933,10,725,135,208,13/04/2021,"Chateau Calon Segur 3eme Cru Classe, Saint-Estephe",Bordeaux,2007,04/05/2021,10074752007,1007475
520,03/05/2021,571,3,460,60,111,05/05/2020,"Tua Rita, Giusto di Notri, Toscana",Tuscany,2008,04/05/2021,11058072008,1105807
8000,03/05/2021,8311,7,6974,1026,1337,14/03/2021,"Domaine Leflaive, Chevalier-Montrachet Grand Cru",Burgundy,2017,04/05/2021,10734012017,1073401
1480,03/05/2021,1591,58,1356,124,235,20/04/2021,"Gaja, Barbaresco",Piedmont,2017,04/05/2021,10996052017,1099605
1290,03/05/2021,1212,11,1172,118,40,07/04/2021,"Tignanello, Toscana",Tuscany,2010,04/05/2021,10953912010,1095391
1100,03/05/2021,1171,34,1048,52,123,27/04/2021,"Chateau Calon Segur 3eme Cru Classe, Saint-Estephe",Bordeaux,2016,04/05/2021,10074752016,1007475
3200,04/06/2021,3604,26,3020,180,584,03/06/2021,"Chateau Angelus Premier Grand Cru Classe B, Saint-Emilion Grand Cru",Bordeaux,2009,05/06/2021,10060452009,1006045
3200,04/06/2021,3620,25,3020,180,600,03/06/2021,"Chateau Angelus Premier Grand Cru Classe B, Saint-Emilion Grand Cru",Bordeaux,2009,07/06/2021,10060452009,1006045
7600,03/05/2021,7852,2,7124,476,728,15/02/2019,"Domaine Leflaive, Chevalier-Montrachet Grand Cru",Burgundy,2016,04/05/2021,10734012016,1073401
420,17/06/2021,430,3,220,200,210,17/06/2015,"Chateau Batailley 5eme Cru Classe, Pauillac",Bordeaux,2002,18/06/2021,10063222002,1006322
3720,03/05/2021,4054,45,3480,240,574,10/04/2021,"Chateau Margaux Premier Cru Classe, Margaux",Bordeaux,2014,04/05/2021,10127812014,1012781
1788,03/05/2021,2040,0,1768,20,272,22/05/2020,"Gaja, Barbaresco",Piedmont,2000,04/05/2021,10996052000,1099605
1000,03/05/2021,1183,72,975,25,208,12/04/2021,"Chateau Calon Segur 3eme Cru Classe, Saint-Estephe",Bordeaux,2005,04/05/2021,10074752005,1007475
525,17/06/2021,563,5,420,105,143,09/07/2019,"Chateau Batailley 5eme Cru Classe, Pauillac",Bordeaux,2003,24/06/2021,10063222003,1006322
3200,04/06/2021,3604,26,3020,180,584,03/06/2021,"Chateau Angelus Premier Grand Cru Classe B, Saint-Emilion Grand Cru",Bordeaux,2009,05/06/2021,10060452009,1006045
3200,03/06/2021,3546,19,3020,180,526,03/06/2021,"Chateau Angelus Premier Grand Cru Classe B, Saint-Emilion Grand Cru",Bordeaux,2009,04/06/2021,10060452009,1006045
3700,03/05/2021,3956,24,3520,180,436,07/04/2021,"Chateau Margaux Premier Cru Classe, Margaux",Bordeaux,2013,04/05/2021,10127812013,1012781
6200,03/05/2021,7359,44,6400,-200,959,15/04/2021,"Chateau Margaux Premier Cru Classe, Margaux",Bordeaux,2005,04/05/2021,10127812005,1012781
3200,03/06/2021,3546,19,3020,180,526,03/06/2021,"Chateau Angelus Premier Grand Cru Classe B, Saint-Emilion Grand Cru",Bordeaux,2009,04/06/2021,10060452009,1006045
1700,03/05/2021,1641,3,1378,322,263,29/07/2020,"Tignanello, Toscana",Tuscany,2001,04/05/2021,10953912001,1095391
10500,03/05/2021,12011,54,9844,656,2167,29/03/2021,"Chateau Margaux Premier Cru Classe, Margaux",Bordeaux,2015,04/05/2021,10127812015,1012781
480,17/06/2021,526,4,420,60,106,09/07/2019,"Chateau Batailley 5eme Cru Classe, Pauillac",Bordeaux,2003,18/06/2021,10063222003,1006322
3875,03/05/2021,4472,67,3880,-5,592,22/03/2021,"Chateau Margaux Premier Cru Classe, Margaux",Bordeaux,2008,04/05/2021,10127812008,1012781
3200,02/06/2021,3552,18,3100,100,452,25/05/2021,"Chateau Angelus Premier Grand Cru Classe B, Saint-Emilion Grand Cru",Bordeaux,2009,03/06/2021,10060452009,1006045
6500,15/07/2021,7413,27,6776,-276,637,10/06/2021,"Chateau Margaux Premier Cru Classe, Margaux",Bordeaux,2005,16/07/2021,10127812005,1012781
3200,02/06/2021,3552,18,3100,100,452,25/05/2021,"Chateau Angelus Premier Grand Cru Classe B, Saint-Emilion Grand Cru",Bordeaux,2009,03/06/2021,10060452009,1006045
990,15/07/2021,1165,83,988,2,177,28/05/2021,"Chateau Calon Segur 3eme Cru Classe, Saint-Estephe",Bordeaux,2005,16/07/2021,10074752005,1007475
895,15/07/2021,921,39,863,32,58,10/05/2021,"Chateau Calon Segur 3eme Cru Classe, Saint-Estephe",Bordeaux,2006,16/07/2021,10074752006,1007475
3900,15/07/2021,4698,82,3822,78,876,20/06/2021,"Chateau Margaux Premier Cru Classe, Margaux",Bordeaux,2006,16/07/2021,10127812006,1012781
3750,15/07/2021,4255,83,3525,225,730,18/06/2021,"Chateau Margaux Premier Cru Classe, Margaux",Bordeaux,2007,16/07/2021,10127812007,1012781
880,15/07/2021,980,7,725,155,255,13/04/2021,"Chateau Calon Segur 3eme Cru Classe, Saint-Estephe",Bordeaux,2007,16/07/2021,10074752007,1007475
3200,01/06/2021,3552,18,3100,100,452,25/05/2021,"Chateau Angelus Premier Grand Cru Classe B, Saint-Emilion Grand Cru",Bordeaux,2009,02/06/2021,10060452009,1006045
3200,01/06/2021,3552,18,3100,100,452,25/05/2021,"Chateau Angelus Premier Grand Cru Classe B, Saint-Emilion Grand Cru",Bordeaux,2009,02/06/2021,10060452009,1006045
3900,15/07/2021,4349,71,3870,30,479,10/07/2021,"Chateau Margaux Premier Cru Classe, Margaux",Bordeaux,2008,16/07/2021,10127812008,1012781
895,15/07/2021,978,10,781,114,197,16/11/2020,"Chateau Calon Segur 3eme Cru Classe, Saint-Estephe",Bordeaux,2008,16/07/2021,10074752008,1007475
6880,14/07/2021,7747,48,7086,-206,661,11/06/2021,"Chateau Margaux Premier Cru Classe, Margaux",Bordeaux,2009,16/07/2021,10127812009,1012781
3200,31/05/2021,3555,18,3100,100,455,25/05/2021,"Chateau Angelus Premier Grand Cru Classe B, Saint-Emilion Grand Cru",Bordeaux,2009,01/06/2021,10060452009,1006045
2500,15/07/2021,2671,3,2220,280,451,14/06/2021,"Gaja, Barbaresco",Piedmont,2001,16/07/2021,10996052001,1099605
2386,15/07/2021,2397,3,2190,196,207,01/05/2021,"Gaja, Barbaresco",Piedmont,2004,16/07/2021,10996052004,1099605
6400,15/07/2021,7572,53,6190,210,1382,08/07/2021,"Chateau Margaux Premier Cru Classe, Margaux",Bordeaux,2010,16/07/2021,10127812010,1012781
500,17/06/2021,520,2,300,200,220,15/12/2019,"Chateau Batailley 5eme Cru Classe, Pauillac",Bordeaux,2004,18/06/2021,10063222004,1006322
990,15/07/2021,1137,16,990,0,147,16/06/2021,"Chateau Calon Segur 3eme Cru Classe, Saint-Estephe",Bordeaux,2010,16/07/2021,10074752010,1007475
3200,31/05/2021,3555,18,3100,100,455,25/05/2021,"Chateau Angelus Premier Grand Cru Classe B, Saint-Emilion Grand Cru",Bordeaux,2009,01/06/2021,10060452009,1006045
788,15/07/2021,990,36,790,-2,200,01/06/2020,"Chateau Calon Segur 3eme Cru Classe, Saint-Estephe",Bordeaux,2011,16/07/2021,10074752011,1007475
1260,15/07/2021,1525,4,1170,90,355,24/06/2021,"Tignanello, Toscana",Tuscany,2010,16/07/2021,10953912010,1095391
3758,15/07/2021,4348,73,3690,68,658,13/04/2021,"Chateau Margaux Premier Cru Classe, Margaux",Bordeaux,2011,16/07/2021,10127812011,1012781
3200,28/05/2021,3555,18,3100,100,455,25/05/2021,"Chateau Angelus Premier Grand Cru Classe B, Saint-Emilion Grand Cru",Bordeaux,2009,29/05/2021,10060452009,1006045
790,06/05/2021,920,154,907,-117,13,03/05/2021,"Tignanello, Toscana",Tuscany,2017,07/05/2021,10953912017,1095391
3910,05/05/2021,4775,80,3800,110,975,07/04/2021,"Chateau Margaux Premier Cru Classe, Margaux",Bordeaux,2006,07/05/2021,10127812006,1012781
1400,06/05/2021,1436,9,1276,124,160,05/03/2021,"Gaja, Barbaresco",Piedmont,2013,07/05/2021,10996052013,1099605
6250,06/05/2021,7051,45,6400,-150,651,15/04/2021,"Chateau Margaux Premier Cru Classe, Margaux",Bordeaux,2005,07/05/2021,10127812005,1012781
500,17/06/2021,556,2,300,200,256,15/12/2019,"Chateau Batailley 5eme Cru Classe, Pauillac",Bordeaux,2004,25/06/2021,10063222004,1006322
738,03/05/2021,886,109,760,-22,126,29/04/2021,"Chateau Calon Segur 3eme Cru Classe, Saint-Estephe",Bordeaux,2017,07/05/2021,10074752017,1007475
8400,03/05/2021,8720,1,5960,2440,2760,01/08/2017,"Domaine Leflaive, Chevalier-Montrachet Grand Cru",Burgundy,2010,07/05/2021,10734012010,1073401
1110,04/05/2021,1180,13,1204,-94,-24,03/05/2021,"Tignanello, Toscana",Tuscany,2015,07/05/2021,10953912015,1095391
1350,05/05/2021,1471,62,1260,90,211,18/02/2021,"Gaja, Barbaresco",Piedmont,2015,07/05/2021,10996052015,1099605
1000,04/05/2021,1199,12,860,140,339,08/03/2021,"Tignanello, Toscana",Tuscany,2013,07/05/2021,10953912013,1095391
660,06/05/2021,724,4,390,270,334,18/08/2017,"Tua Rita, Giusto di Notri, Toscana",Tuscany,2006,07/05/2021,11058072006,1105807
3200,28/05/2021,3555,18,3100,100,455,25/05/2021,"Chateau Angelus Premier Grand Cru Classe B, Saint-Emilion Grand Cru",Bordeaux,2009,29/05/2021,10060452009,1006045
3200,27/05/2021,3553,23,3100,100,453,25/05/2021,"Chateau Angelus Premier Grand Cru Classe B, Saint-Emilion Grand Cru",Bordeaux,2009,28/05/2021,10060452009,1006045
2872,06/05/2021,2872,2,2554,318,318,22/05/2020,"Gaja, Barbaresco",Piedmont,2006,07/05/2021,10996052006,1099605
3200,27/05/2021,3553,23,3100,100,453,25/05/2021,"Chateau Angelus Premier Grand Cru Classe B, Saint-Emilion Grand Cru",Bordeaux,2009,28/05/2021,10060452009,1006045
866,06/05/2021,899,50,842,24,57,22/08/2020,"Chateau Calon Segur 3eme Cru Classe, Saint-Estephe",Bordeaux,2019,07/05/2021,10074752019,1007475
548,06/05/2021,560,3,544,4,16,18/09/2020,"Tua Rita, Giusto di Notri, Toscana",Tuscany,2013,07/05/2021,11058072013,1105807
840,06/05/2021,943,15,781,59,162,16/11/2020,"Chateau Calon Segur 3eme Cru Classe, Saint-Estephe",Bordeaux,2008,07/05/2021,10074752008,1007475
530,17/06/2021,623,49,520,10,103,17/06/2021,"Chateau Batailley 5eme Cru Classe, Pauillac",Bordeaux,2005,21/06/2021,10063222005,1006322
750,05/05/2021,1005,38,790,-40,215,01/06/2020,"Chateau Calon Segur 3eme Cru Classe, Saint-Estephe",Bordeaux,2011,07/05/2021,10074752011,1007475
840,06/05/2021,1108,201,1082,-242,26,27/04/2021,"Tignanello, Toscana",Tuscany,2016,07/05/2021,10953912016,1095391
530,17/06/2021,672,93,520,10,152,17/06/2021,"Chateau Batailley 5eme Cru Classe, Pauillac",Bordeaux,2005,18/06/2021,10063222005,1006322
3200,26/05/2021,3569,22,3100,100,469,25/05/2021,"Chateau Angelus Premier Grand Cru Classe B, Saint-Emilion Grand Cru",Bordeaux,2009,27/05/2021,10060452009,1006045
3200,26/05/2021,3569,22,3100,100,469,25/05/2021,"Chateau Angelus Premier Grand Cru Classe B, Saint-Emilion Grand Cru",Bordeaux,2009,27/05/2021,10060452009,1006045
3200,25/05/2021,3570,18,3100,100,470,25/05/2021,"Chateau Angelus Premier Grand Cru Classe B, Saint-Emilion Grand Cru",Bordeaux,2009,26/05/2021,10060452009,1006045
4850,06/05/2021,5763,20,4800,50,963,11/03/2021,"Chateau Margaux Premier Cru Classe, Margaux",Bordeaux,2003,07/05/2021,10127812003,1012781
530,17/06/2021,623,50,520,10,103,17/06/2021,"Chateau Batailley 5eme Cru Classe, Pauillac",Bordeaux,2005,20/06/2021,10063222005,1006322
3720,06/05/2021,4074,51,3480,240,594,10/04/2021,"Chateau Margaux Premier Cru Classe, Margaux",Bordeaux,2014,07/05/2021,10127812014,1012781
3700,06/05/2021,4214,166,3700,0,514,06/05/2021,"Chateau Margaux Premier Cru Classe, Margaux",Bordeaux,2017,07/05/2021,10127812017,1012781
8400,06/05/2021,8400,0,7200,1200,1200,06/11/2019,"Domaine Denis Mortet, Chambertin Grand Cru",Burgundy,2014,07/05/2021,10490202014,1049020
3200,25/05/2021,3570,18,3100,100,470,25/05/2021,"Chateau Angelus Premier Grand Cru Classe B, Saint-Emilion Grand Cru",Bordeaux,2009,26/05/2021,10060452009,1006045
980,06/05/2021,1121,18,1000,-20,121,12/04/2021,"Chateau Calon Segur 3eme Cru Classe, Saint-Estephe",Bordeaux,2010,07/05/2021,10074752010,1007475
3200,24/05/2021,3570,18,3000,200,570,17/05/2021,"Chateau Angelus Premier Grand Cru Classe B, Saint-Emilion Grand Cru",Bordeaux,2009,25/05/2021,10060452009,1006045
1000,05/05/2021,1230,16,1047,-47,183,27/04/2021,"Chateau Calon Segur 3eme Cru Classe, Saint-Estephe",Bordeaux,2009,07/05/2021,10074752009,1007475
4400,06/05/2021,4898,27,4400,0,498,29/09/2020,"Chateau Margaux Premier Cru Classe, Margaux",Bordeaux,2001,07/05/2021,10127812001,1012781
1380,06/05/2021,1458,7,1352,28,106,23/09/2020,"Gaja, Barbaresco",Piedmont,2011,07/05/2021,10996052011,1099605
6800,06/05/2021,6800,1,1730,5070,5070,31/10/2011,"Domaine Leflaive, Chevalier-Montrachet Grand Cru",Burgundy,2003,07/05/2021,10734012003,1073401
3200,24/05/2021,3570,18,3000,200,570,17/05/2021,"Chateau Angelus Premier Grand Cru Classe B, Saint-Emilion Grand Cru",Bordeaux,2009,25/05/2021,10060452009,1006045
5632,04/05/2021,5489,60,5288,344,201,03/05/2021,"Chateau Margaux Premier Cru Classe, Margaux",Bordeaux,2016,07/05/2021,10127812016,1012781
530,17/06/2021,623,49,520,10,103,17/06/2021,"Chateau Batailley 5eme Cru Classe, Pauillac",Bordeaux,2005,21/06/2021,10063222005,1006322
3200,21/05/2021,3553,21,3000,200,553,17/05/2021,"Chateau Angelus Premier Grand Cru Classe B, Saint-Emilion Grand Cru",Bordeaux,2009,22/05/2021,10060452009,1006045
460,06/05/2021,488,165,420,40,68,23/03/2021,"Tua Rita, Giusto di Notri, Toscana",Tuscany,2016,07/05/2021,11058072016,1105807
1082,04/05/2021,1200,65,1048,34,152,27/04/2021,"Chateau Calon Segur 3eme Cru Classe, Saint-Estephe",Bordeaux,2016,07/05/2021,10074752016,1007475
9460,06/05/2021,9824,3,7290,2170,2534,21/08/2020,"Domaine Denis Mortet, Chambertin Grand Cru",Burgundy,2017,07/05/2021,10490202017,1049020
3200,21/05/2021,3555,19,3000,200,555,17/05/2021,"Chateau Angelus Premier Grand Cru Classe B, Saint-Emilion Grand Cru",Bordeaux,2009,24/05/2021,10060452009,1006045
3800,06/05/2021,4383,125,3690,110,693,13/04/2021,"Chateau Margaux Premier Cru Classe, Margaux",Bordeaux,2011,07/05/2021,10127812011,1012781
3200,21/05/2021,3555,19,3000,200,555,17/05/2021,"Chateau Angelus Premier Grand Cru Classe B, Saint-Emilion Grand Cru",Bordeaux,2009,24/05/2021,10060452009,1006045
530,17/06/2021,672,93,520,10,152,17/06/2021,"Chateau Batailley 5eme Cru Classe, Pauillac",Bordeaux,2005,18/06/2021,10063222005,1006322
530,17/06/2021,623,50,520,10,103,17/06/2021,"Chateau Batailley 5eme Cru Classe, Pauillac",Bordeaux,2005,20/06/2021,10063222005,1006322
3200,21/05/2021,3553,21,3000,200,553,17/05/2021,"Chateau Angelus Premier Grand Cru Classe B, Saint-Emilion Grand Cru",Bordeaux,2009,22/05/2021,10060452009,1006045
8000,06/05/2021,8449,7,6974,1026,1475,14/03/2021,"Domaine Leflaive, Chevalier-Montrachet Grand Cru",Burgundy,2017,07/05/2021,10734012017,1073401
3560,05/05/2021,4089,28,3592,-32,497,06/05/2021,"Chateau Margaux Premier Cru Classe, Margaux",Bordeaux,2007,07/05/2021,10127812007,1012781
3700,06/05/2021,3998,23,3520,180,478,07/04/2021,"Chateau Margaux Premier Cru Classe, Margaux",Bordeaux,2013,07/05/2021,10127812013,1012781
6400,06/05/2021,6935,2,7900,-1500,-965,29/04/2019,"Domaine Leflaive, Chevalier-Montrachet Grand Cru",Burgundy,2015,07/05/2021,10734012015,1073401
12402,06/05/2021,12557,2,12850,-448,-293,30/11/2020,"Jacques-Frederic Mugnier, Chambolle-Musigny Premier Cru, Les Amoureuses",Burgundy,2011,07/05/2021,10496422011,1049642
6100,06/05/2021,7464,52,5922,178,1542,13/04/2021,"Chateau Margaux Premier Cru Classe, Margaux",Bordeaux,2010,07/05/2021,10127812010,1012781
880,06/05/2021,948,10,725,155,223,13/04/2021,"Chateau Calon Segur 3eme Cru Classe, Saint-Estephe",Bordeaux,2007,07/05/2021,10074752007,1007475
7000,06/05/2021,6735,1,5360,1640,1375,18/09/2020,"Domaine Leflaive, Chevalier-Montrachet Grand Cru",Burgundy,2009,07/05/2021,10734012009,1073401
3875,06/05/2021,4486,75,3880,-5,606,22/03/2021,"Chateau Margaux Premier Cru Classe, Margaux",Bordeaux,2008,07/05/2021,10127812008,1012781
17000,05/05/2021,15268,7,13000,4000,2268,29/04/2021,"Jacques-Frederic Mugnier, Chambolle-Musigny Premier Cru, Les Amoureuses",Burgundy,2017,07/05/2021,10496422017,1049642
2260,06/05/2021,2305,4,2190,70,115,01/05/2021,"Gaja, Barbaresco",Piedmont,2004,07/05/2021,10996052004,1099605
1280,06/05/2021,1225,11,1172,108,53,07/04/2021,"Tignanello, Toscana",Tuscany,2010,07/05/2021,10953912010,1095391
3200,20/05/2021,3554,21,3000,200,554,17/05/2021,"Chateau Angelus Premier Grand Cru Classe B, Saint-Emilion Grand Cru",Bordeaux,2009,21/05/2021,10060452009,1006045
950,06/05/2021,1026,47,800,150,226,30/12/2020,"Chateau Calon Segur 3eme Cru Classe, Saint-Estephe",Bordeaux,2006,07/05/2021,10074752006,1007475
1788,06/05/2021,2040,0,1768,20,272,22/05/2020,"Gaja, Barbaresco",Piedmont,2000,07/05/2021,10996052000,1099605
7600,06/05/2021,7852,2,7124,476,728,15/02/2019,"Domaine Leflaive, Chevalier-Montrachet Grand Cru",Burgundy,2016,07/05/2021,10734012016,1073401
8000,06/05/2021,8147,18,7950,50,197,12/03/2021,"Chateau Margaux Premier Cru Classe, Margaux",Bordeaux,2000,07/05/2021,10127812000,1012781
780,06/05/2021,837,6,682,98,155,15/09/2020,"Chateau Calon Segur 3eme Cru Classe, Saint-Estephe",Bordeaux,2013,07/05/2021,10074752013,1007475
9950,06/05/2021,9718,3,8000,1950,1718,30/01/2020,"Domaine Leflaive, Chevalier-Montrachet Grand Cru",Burgundy,2014,07/05/2021,10734012014,1073401
520,06/05/2021,575,4,460,60,115,05/05/2020,"Tua Rita, Giusto di Notri, Toscana",Tuscany,2008,07/05/2021,11058072008,1105807
420,17/06/2021,521,5,400,20,121,11/05/2021,"Chateau Batailley 5eme Cru Classe, Pauillac",Bordeaux,2006,18/06/2021,10063222006,1006322
420,17/06/2021,521,5,400,20,121,11/05/2021,"Chateau Batailley 5eme Cru Classe, Pauillac",Bordeaux,2006,18/06/2021,10063222006,1006322
420,06/05/2021,462,10,342,78,120,21/08/2020,"Tua Rita, Giusto di Notri, Toscana",Tuscany,2011,07/05/2021,11058072011,1105807
6600,06/05/2021,7945,99,6412,188,1533,25/03/2021,"Chateau Margaux Premier Cru Classe, Margaux",Bordeaux,2009,07/05/2021,10127812009,1012781
3800,06/05/2021,4170,32,3560,240,610,20/11/2020,"Chateau Margaux Premier Cru Classe, Margaux",Bordeaux,2012,07/05/2021,10127812012,1012781
1300,05/05/2021,1335,3,1200,100,135,06/03/2021,"Tignanello, Toscana",Tuscany,2007,07/05/2021,10953912007,1095391
1408,05/05/2021,1518,1,1150,258,368,21/04/2019,"Tignanello, Toscana",Tuscany,2005,07/05/2021,10953912005,1095391
1500,06/05/2021,1676,37,1408,92,268,09/04/2021,"Gaja, Barbaresco",Piedmont,2016,07/05/2021,10996052016,1099605
850,06/05/2021,1100,95,860,-10,240,19/04/2021,"Chateau Calon Segur 3eme Cru Classe, Saint-Estephe",Bordeaux,2015,07/05/2021,10074752015,1007475
3827,06/05/2021,4605,56,4116,-289,489,25/02/2021,"Chateau Margaux Premier Cru Classe, Margaux",Bordeaux,2004,07/05/2021,10127812004,1012781
10500,06/05/2021,12462,70,9844,656,2618,29/03/2021,"Chateau Margaux Premier Cru Classe, Margaux",Bordeaux,2015,07/05/2021,10127812015,1012781
4820,06/05/2021,4770,6,4160,660,610,19/03/2021,"Chateau Margaux Premier Cru Classe, Margaux",Bordeaux,2019,07/05/2021,10127812019,1012781
3200,20/05/2021,3554,21,3000,200,554,17/05/2021,"Chateau Angelus Premier Grand Cru Classe B, Saint-Emilion Grand Cru",Bordeaux,2009,21/05/2021,10060452009,1006045
400,17/06/2021,451,8,332,68,119,06/10/2020,"Chateau Batailley 5eme Cru Classe, Pauillac",Bordeaux,2008,18/06/2021,10063222008,1006322
400,17/06/2021,461,3,332,68,129,06/10/2020,"Chateau Batailley 5eme Cru Classe, Pauillac",Bordeaux,2008,20/06/2021,10063222008,1006322
500,17/06/2021,513,8,450,50,63,25/05/2021,"Chateau Batailley 5eme Cru Classe, Pauillac",Bordeaux,2009,29/06/2021,10063222009,1006322
1050,14/07/2021,1134,8,880,170,254,22/06/2021,"Tignanello, Toscana",Tuscany,2011,16/07/2021,10953912011,1095391
1040,04/08/2021,1382,69,940,100,442,18/03/2021,"Chateau Calon Segur 3eme Cru Classe, Saint-Estephe",Bordeaux,2000,06/08/2021,10074752000,1007475
895,05/08/2021,950,9,781,114,169,16/11/2020,"Chateau Calon Segur 3eme Cru Classe, Saint-Estephe",Bordeaux,2008,06/08/2021,10074752008,1007475
2500,30/06/2021,2636,2,2220,280,416,14/06/2021,"Gaja, Barbaresco",Piedmont,2001,01/07/2021,10996052001,1099605
2098,30/06/2021,2300,4,2190,-92,110,01/05/2021,"Gaja, Barbaresco",Piedmont,2004,01/07/2021,10996052004,1099605
1700,30/06/2021,1847,4,1378,322,469,29/07/2020,"Tignanello, Toscana",Tuscany,2001,01/07/2021,10953912001,1095391
1408,30/06/2021,1389,4,1238,170,151,02/11/2020,"Tignanello, Toscana",Tuscany,2006,01/07/2021,10953912006,1095391
1300,30/06/2021,1365,2,1200,100,165,06/03/2021,"Tignanello, Toscana",Tuscany,2007,01/07/2021,10953912007,1095391
6400,30/06/2021,7572,51,5950,450,1622,23/06/2021,"Chateau Margaux Premier Cru Classe, Margaux",Bordeaux,2010,01/07/2021,10127812010,1012781
500,17/06/2021,510,9,450,50,60,25/05/2021,"Chateau Batailley 5eme Cru Classe, Pauillac",Bordeaux,2009,26/06/2021,10063222009,1006322
990,30/06/2021,1116,15,990,0,126,16/06/2021,"Chateau Calon Segur 3eme Cru Classe, Saint-Estephe",Bordeaux,2010,01/07/2021,10074752010,1007475
3900,06/08/2021,4228,49,3690,210,538,13/04/2021,"Chateau Margaux Premier Cru Classe, Margaux",Bordeaux,2011,07/08/2021,10127812011,1012781
996,06/08/2021,1280,38,1026,-30,254,24/06/2021,"Chateau Calon Segur 3eme Cru Classe, Saint-Estephe",Bordeaux,2009,07/08/2021,10074752009,1007475
3250,17/05/2021,3618,22,3000,250,618,17/05/2021,"Chateau Angelus Premier Grand Cru Classe B, Saint-Emilion Grand Cru",Bordeaux,2009,19/05/2021,10060452009,1006045
1584,03/08/2021,1670,4,1378,206,292,29/07/2020,"Tignanello, Toscana",Tuscany,2001,04/08/2021,10953912001,1095391
3250,17/05/2021,3598,22,3000,250,598,17/05/2021,"Chateau Angelus Premier Grand Cru Classe B, Saint-Emilion Grand Cru",Bordeaux,2009,18/05/2021,10060452009,1006045
880,04/08/2021,967,9,725,155,242,13/04/2021,"Chateau Calon Segur 3eme Cru Classe, Saint-Estephe",Bordeaux,2007,05/08/2021,10074752007,1007475
500,17/06/2021,511,9,450,50,61,25/05/2021,"Chateau Batailley 5eme Cru Classe, Pauillac",Bordeaux,2009,28/06/2021,10063222009,1006322
3250,17/05/2021,3598,22,3000,250,598,17/05/2021,"Chateau Angelus Premier Grand Cru Classe B, Saint-Emilion Grand Cru",Bordeaux,2009,18/05/2021,10060452009,1006045
3250,17/05/2021,3573,20,3000,250,573,17/05/2021,"Chateau Angelus Premier Grand Cru Classe B, Saint-Emilion Grand Cru",Bordeaux,2009,20/05/2021,10060452009,1006045
3826,03/08/2021,4624,44,4116,-290,508,25/02/2021,"Chateau Margaux Premier Cru Classe, Margaux",Bordeaux,2004,04/08/2021,10127812004,1012781
1408,06/07/2021,1513,0,996,412,517,14/06/2019,"Tignanello, Toscana",Tuscany,2000,07/08/2021,10953912000,1095391
840,06/08/2021,1050,21,745,95,305,16/11/2020,"Chateau Calon Segur 3eme Cru Classe, Saint-Estephe",Bordeaux,2004,07/08/2021,10074752004,1007475
6500,04/08/2021,7571,28,6400,100,1171,22/07/2021,"Chateau Margaux Premier Cru Classe, Margaux",Bordeaux,2005,05/08/2021,10127812005,1012781
750,30/06/2021,995,35,790,-40,205,01/06/2020,"Chateau Calon Segur 3eme Cru Classe, Saint-Estephe",Bordeaux,2011,01/07/2021,10074752011,1007475
1408,03/08/2021,1389,2,1238,170,151,02/11/2020,"Tignanello, Toscana",Tuscany,2006,04/08/2021,10953912006,1095391
840,03/08/2021,1050,21,745,95,305,16/11/2020,"Chateau Calon Segur 3eme Cru Classe, Saint-Estephe",Bordeaux,2004,04/08/2021,10074752004,1007475
960,02/08/2021,1204,9,850,110,354,28/01/2021,"Tignanello, Toscana",Tuscany,2012,04/08/2021,10953912012,1095391
10620,04/08/2021,11831,47,9800,820,2031,11/06/2021,"Chateau Margaux Premier Cru Classe, Margaux",Bordeaux,2015,05/08/2021,10127812015,1012781
3250,17/05/2021,3618,22,3000,250,618,17/05/2021,"Chateau Angelus Premier Grand Cru Classe B, Saint-Emilion Grand Cru",Bordeaux,2009,19/05/2021,10060452009,1006045
940,06/08/2021,1074,77,866,74,208,20/07/2021,"Chateau Calon Segur 3eme Cru Classe, Saint-Estephe",Bordeaux,2015,07/08/2021,10074752015,1007475
3250,17/05/2021,3573,20,3000,250,573,17/05/2021,"Chateau Angelus Premier Grand Cru Classe B, Saint-Emilion Grand Cru",Bordeaux,2009,20/05/2021,10060452009,1006045
1326,04/08/2021,1413,5,1170,156,243,24/06/2021,"Tignanello, Toscana",Tuscany,2010,05/08/2021,10953912010,1095391
500,17/06/2021,511,9,450,50,61,25/05/2021,"Chateau Batailley 5eme Cru Classe, Pauillac",Bordeaux,2009,28/06/2021,10063222009,1006322
3250,07/05/2021,3555,18,3044,206,511,12/03/2021,"Chateau Angelus Premier Grand Cru Classe B, Saint-Emilion Grand Cru",Bordeaux,2009,08/05/2021,10060452009,1006045
3750,26/07/2021,4325,54,3650,100,675,27/07/2021,"Chateau Margaux Premier Cru Classe, Margaux",Bordeaux,2012,04/08/2021,10127812012,1012781
1024,30/06/2021,1255,4,1072,-48,183,20/01/2021,"Tignanello, Toscana",Tuscany,2009,01/07/2021,10953912009,1095391
1326,30/06/2021,1473,3,1170,156,303,24/06/2021,"Tignanello, Toscana",Tuscany,2010,01/07/2021,10953912010,1095391
3250,07/05/2021,3555,18,3044,206,511,12/03/2021,"Chateau Angelus Premier Grand Cru Classe B, Saint-Emilion Grand Cru",Bordeaux,2009,08/05/2021,10060452009,1006045
3200,06/05/2021,3555,18,3044,156,511,12/03/2021,"Chateau Angelus Premier Grand Cru Classe B, Saint-Emilion Grand Cru",Bordeaux,2009,07/05/2021,10060452009,1006045
3800,06/08/2021,4527,57,3525,275,1002,18/06/2021,"Chateau Margaux Premier Cru Classe, Margaux",Bordeaux,2007,07/08/2021,10127812007,1012781
900,04/08/2021,1099,25,800,100,299,21/11/2019,"Chateau Calon Segur 3eme Cru Classe, Saint-Estephe",Bordeaux,2003,06/08/2021,10074752003,1007475
875,22/07/2021,966,53,863,12,103,10/05/2021,"Chateau Calon Segur 3eme Cru Classe, Saint-Estephe",Bordeaux,2006,04/08/2021,10074752006,1007475
1624,03/08/2021,1810,2,882,742,928,26/04/2019,"Tignanello, Toscana",Tuscany,2003,04/08/2021,10953912003,1095391
6400,03/08/2021,7596,65,6188,212,1408,16/07/2021,"Chateau Margaux Premier Cru Classe, Margaux",Bordeaux,2010,04/08/2021,10127812010,1012781
3758,30/06/2021,4043,74,3690,68,353,13/04/2021,"Chateau Margaux Premier Cru Classe, Margaux",Bordeaux,2011,01/07/2021,10127812011,1012781
3250,06/05/2021,3599,20,3050,200,549,11/05/2021,"Chateau Angelus Premier Grand Cru Classe B, Saint-Emilion Grand Cru",Bordeaux,2009,12/05/2021,10060452009,1006045
5100,04/08/2021,5598,19,4650,450,948,21/06/2021,"Chateau Margaux Premier Cru Classe, Margaux",Bordeaux,2003,05/08/2021,10127812003,1012781
500,17/06/2021,513,8,450,50,63,25/05/2021,"Chateau Batailley 5eme Cru Classe, Pauillac",Bordeaux,2009,29/06/2021,10063222009,1006322
5100,06/08/2021,5703,19,4650,450,1053,21/06/2021,"Chateau Margaux Premier Cru Classe, Margaux",Bordeaux,2003,07/08/2021,10127812003,1012781
1584,05/08/2021,1670,4,1378,206,292,29/07/2020,"Tignanello, Toscana",Tuscany,2001,06/08/2021,10953912001,1095391
1150,05/08/2021,1140,7,952,198,188,04/08/2021,"Tignanello, Toscana",Tuscany,2013,06/08/2021,10953912013,1095391
1040,04/08/2021,1377,69,940,100,437,18/03/2021,"Chateau Calon Segur 3eme Cru Classe, Saint-Estephe",Bordeaux,2000,05/08/2021,10074752000,1007475
3250,06/05/2021,3559,20,3050,200,509,11/05/2021,"Chateau Angelus Premier Grand Cru Classe B, Saint-Emilion Grand Cru",Bordeaux,2009,17/05/2021,10060452009,1006045
3950,03/08/2021,4469,108,3780,170,689,23/07/2021,"Chateau Margaux Premier Cru Classe, Margaux",Bordeaux,2008,04/08/2021,10127812008,1012781
995,02/08/2021,1113,18,993,2,120,27/07/2021,"Chateau Calon Segur 3eme Cru Classe, Saint-Estephe",Bordeaux,2010,04/08/2021,10074752010,1007475
960,30/06/2021,1043,9,880,80,163,22/06/2021,"Tignanello, Toscana",Tuscany,2011,01/07/2021,10953912011,1095391
500,17/06/2021,510,9,450,50,60,25/05/2021,"Chateau Batailley 5eme Cru Classe, Pauillac",Bordeaux,2009,26/06/2021,10063222009,1006322
840,04/05/2021,1028,46,800,40,228,30/12/2020,"Chateau Calon Segur 3eme Cru Classe, Saint-Estephe",Bordeaux,2006,05/05/2021,10074752006,1007475
3250,06/05/2021,3557,18,3050,200,507,11/05/2021,"Chateau Angelus Premier Grand Cru Classe B, Saint-Emilion Grand Cru",Bordeaux,2009,14/05/2021,10060452009,1006045
3910,03/05/2021,4764,81,3800,110,964,07/04/2021,"Chateau Margaux Premier Cru Classe, Margaux",Bordeaux,2006,05/05/2021,10127812006,1012781
840,04/05/2021,943,15,781,59,162,16/11/2020,"Chateau Calon Segur 3eme Cru Classe, Saint-Estephe",Bordeaux,2008,05/05/2021,10074752008,1007475
3700,04/05/2021,4010,24,3520,180,490,07/04/2021,"Chateau Margaux Premier Cru Classe, Margaux",Bordeaux,2013,05/05/2021,10127812013,1012781
8000,04/05/2021,8137,19,7950,50,187,12/03/2021,"Chateau Margaux Premier Cru Classe, Margaux",Bordeaux,2000,05/05/2021,10127812000,1012781
1050,03/05/2021,1340,40,940,110,400,18/03/2021,"Chateau Calon Segur 3eme Cru Classe, Saint-Estephe",Bordeaux,2000,05/05/2021,10074752000,1007475
3800,04/05/2021,4362,134,3690,110,672,13/04/2021,"Chateau Margaux Premier Cru Classe, Margaux",Bordeaux,2011,05/05/2021,10127812011,1012781
525,17/06/2021,596,400,494,31,102,20/04/2021,"Chateau Batailley 5eme Cru Classe, Pauillac",Bordeaux,2010,18/06/2021,10063222010,1006322
3250,06/05/2021,3529,20,3050,200,479,11/05/2021,"Chateau Angelus Premier Grand Cru Classe B, Saint-Emilion Grand Cru",Bordeaux,2009,15/05/2021,10060452009,1006045
6400,05/08/2021,7596,65,6188,212,1408,16/07/2021,"Chateau Margaux Premier Cru Classe, Margaux",Bordeaux,2010,06/08/2021,10127812010,1012781
2500,19/07/2021,2548,2,2400,100,148,18/07/2021,"Gaja, Barbaresco",Piedmont,2001,06/08/2021,10996052001,1099605
3700,05/08/2021,4167,47,3520,180,647,07/04/2021,"Chateau Margaux Premier Cru Classe, Margaux",Bordeaux,2013,06/08/2021,10127812013,1012781
840,05/08/2021,1050,21,745,95,305,16/11/2020,"Chateau Calon Segur 3eme Cru Classe, Saint-Estephe",Bordeaux,2004,06/08/2021,10074752004,1007475
3900,05/08/2021,4228,49,3690,210,538,13/04/2021,"Chateau Margaux Premier Cru Classe, Margaux",Bordeaux,2011,06/08/2021,10127812011,1012781
3250,06/05/2021,3600,20,3044,206,556,12/03/2021,"Chateau Angelus Premier Grand Cru Classe B, Saint-Emilion Grand Cru",Bordeaux,2009,11/05/2021,10060452009,1006045
1050,04/05/2021,1219,17,1047,3,172,27/04/2021,"Chateau Calon Segur 3eme Cru Classe, Saint-Estephe",Bordeaux,2009,05/05/2021,10074752009,1007475
1000,03/05/2021,1181,69,975,25,206,12/04/2021,"Chateau Calon Segur 3eme Cru Classe, Saint-Estephe",Bordeaux,2005,05/05/2021,10074752005,1007475
790,04/05/2021,969,19,745,45,224,16/11/2020,"Chateau Calon Segur 3eme Cru Classe, Saint-Estephe",Bordeaux,2004,05/05/2021,10074752004,1007475
6250,04/05/2021,7043,45,6400,-150,643,15/04/2021,"Chateau Margaux Premier Cru Classe, Margaux",Bordeaux,2005,05/05/2021,10127812005,1012781
1100,04/05/2021,1440,9,1010,90,430,18/12/2020,"Tignanello, Toscana",Tuscany,2008,05/05/2021,10953912008,1095391
3560,03/05/2021,4097,28,3450,110,647,11/11/2020,"Chateau Margaux Premier Cru Classe, Margaux",Bordeaux,2007,05/05/2021,10127812007,1012781
525,17/06/2021,596,399,494,31,102,20/04/2021,"Chateau Batailley 5eme Cru Classe, Pauillac",Bordeaux,2010,19/06/2021,10063222010,1006322
2260,04/05/2021,2305,4,2190,70,115,01/05/2021,"Gaja, Barbaresco",Piedmont,2004,05/05/2021,10996052004,1099605
3800,04/05/2021,4170,32,3560,240,610,20/11/2020,"Chateau Margaux Premier Cru Classe, Margaux",Bordeaux,2012,05/05/2021,10127812012,1012781
3720,04/05/2021,4056,50,3480,240,576,10/04/2021,"Chateau Margaux Premier Cru Classe, Margaux",Bordeaux,2014,05/05/2021,10127812014,1012781
830,04/05/2021,950,3,735,95,215,09/09/2020,"Chateau Calon Segur 3eme Cru Classe, Saint-Estephe",Bordeaux,2012,05/05/2021,10074752012,1007475
3250,06/05/2021,3559,20,3050,200,509,11/05/2021,"Chateau Angelus Premier Grand Cru Classe B, Saint-Emilion Grand Cru",Bordeaux,2009,17/05/2021,10060452009,1006045
525,17/06/2021,596,397,494,31,102,20/04/2021,"Chateau Batailley 5eme Cru Classe, Pauillac",Bordeaux,2010,20/06/2021,10063222010,1006322
900,03/05/2021,1062,21,800,100,262,21/11/2019,"Chateau Calon Segur 3eme Cru Classe, Saint-Estephe",Bordeaux,2003,05/05/2021,10074752003,1007475
3827,04/05/2021,4595,57,4116,-289,479,25/02/2021,"Chateau Margaux Premier Cru Classe, Margaux",Bordeaux,2004,05/05/2021,10127812004,1012781
6100,03/05/2021,7485,51,5922,178,1563,13/04/2021,"Chateau Margaux Premier Cru Classe, Margaux",Bordeaux,2010,05/05/2021,10127812010,1012781
1000,04/05/2021,1057,9,860,140,197,08/03/2021,"Tignanello, Toscana",Tuscany,2011,05/05/2021,10953912011,1095391
3250,06/05/2021,3599,20,3050,200,549,11/05/2021,"Chateau Angelus Premier Grand Cru Classe B, Saint-Emilion Grand Cru",Bordeaux,2009,12/05/2021,10060452009,1006045
1700,03/05/2021,1654,3,1378,322,276,29/07/2020,"Tignanello, Toscana",Tuscany,2001,05/05/2021,10953912001,1095391
3702,04/05/2021,3684,2,1200,2502,2484,16/05/2012,"Gaja, Barbaresco",Piedmont,2001,05/05/2021,10996052001,1099605
3250,06/05/2021,3529,20,3050,200,479,11/05/2021,"Chateau Angelus Premier Grand Cru Classe B, Saint-Emilion Grand Cru",Bordeaux,2009,15/05/2021,10060452009,1006045
750,04/05/2021,1008,37,790,-40,218,01/06/2020,"Chateau Calon Segur 3eme Cru Classe, Saint-Estephe",Bordeaux,2011,05/05/2021,10074752011,1007475
6750,04/05/2021,7944,99,6412,338,1532,25/03/2021,"Chateau Margaux Premier Cru Classe, Margaux",Bordeaux,2009,05/05/2021,10127812009,1012781
1020,04/05/2021,1129,17,1000,20,129,12/04/2021,"Chateau Calon Segur 3eme Cru Classe, Saint-Estephe",Bordeaux,2010,05/05/2021,10074752010,1007475
525,17/06/2021,596,399,494,31,102,20/04/2021,"Chateau Batailley 5eme Cru Classe, Pauillac",Bordeaux,2010,19/06/2021,10063222010,1006322
3250,06/05/2021,3557,18,3050,200,507,11/05/2021,"Chateau Angelus Premier Grand Cru Classe B, Saint-Emilion Grand Cru",Bordeaux,2009,14/05/2021,10060452009,1006045
1408,03/05/2021,1434,5,1238,170,196,02/11/2020,"Tignanello, Toscana",Tuscany,2006,05/05/2021,10953912006,1095391
1290,03/05/2021,1225,11,1172,118,53,07/04/2021,"Tignanello, Toscana",Tuscany,2010,05/05/2021,10953912010,1095391
9950,04/05/2021,9718,3,8000,1950,1718,30/01/2020,"Domaine Leflaive, Chevalier-Montrachet Grand Cru",Burgundy,2014,05/05/2021,10734012014,1073401
3875,04/05/2021,4486,75,3880,-5,606,22/03/2021,"Chateau Margaux Premier Cru Classe, Margaux",Bordeaux,2008,05/05/2021,10127812008,1012781
900,04/05/2021,1187,13,850,50,337,28/01/2021,"Tignanello, Toscana",Tuscany,2012,05/05/2021,10953912012,1095391
3200,06/05/2021,3555,18,3044,156,511,12/03/2021,"Chateau Angelus Premier Grand Cru Classe B, Saint-Emilion Grand Cru",Bordeaux,2009,07/05/2021,10060452009,1006045
3250,06/05/2021,3600,20,3044,206,556,12/03/2021,"Chateau Angelus Premier Grand Cru Classe B, Saint-Emilion Grand Cru",Bordeaux,2009,11/05/2021,10060452009,1006045
3250,05/05/2021,3555,18,3044,206,511,12/03/2021,"Chateau Angelus Premier Grand Cru Classe B, Saint-Emilion Grand Cru",Bordeaux,2009,06/05/2021,10060452009,1006045
3250,05/05/2021,3555,18,3044,206,511,12/03/2021,"Chateau Angelus Premier Grand Cru Classe B, Saint-Emilion Grand Cru",Bordeaux,2009,06/05/2021,10060452009,1006045
3250,03/05/2021,3555,18,3044,206,511,12/03/2021,"Chateau Angelus Premier Grand Cru Classe B, Saint-Emilion Grand Cru",Bordeaux,2009,04/05/2021,10060452009,1006045
3250,03/05/2021,3555,18,3044,206,511,12/03/2021,"Chateau Angelus Premier Grand Cru Classe B, Saint-Emilion Grand Cru",Bordeaux,2009,04/05/2021,10060452009,1006045
780,04/05/2021,837,6,682,98,155,15/09/2020,"Chateau Calon Segur 3eme Cru Classe, Saint-Estephe",Bordeaux,2013,05/05/2021,10074752013,1007475
908,04/05/2021,1101,94,860,48,241,19/04/2021,"Chateau Calon Segur 3eme Cru Classe, Saint-Estephe",Bordeaux,2015,05/05/2021,10074752015,1007475
4400,04/05/2021,4898,27,4400,0,498,29/09/2020,"Chateau Margaux Premier Cru Classe, Margaux",Bordeaux,2001,05/05/2021,10127812001,1012781
10500,04/05/2021,12466,69,9844,656,2622,29/03/2021,"Chateau Margaux Premier Cru Classe, Margaux",Bordeaux,2015,05/05/2021,10127812015,1012781
920,04/05/2021,1098,45,830,90,268,18/04/2021,"Tignanello, Toscana",Tuscany,2014,05/05/2021,10953912014,1095391
3400,06/08/2021,3965,28,3350,50,615,20/07/2021,"Chateau Angelus Premier Grand Cru Classe B, Saint-Emilion Grand Cru",Bordeaux,2010,07/08/2021,10060452010,1006045
525,17/06/2021,596,400,494,31,102,20/04/2021,"Chateau Batailley 5eme Cru Classe, Pauillac",Bordeaux,2010,18/06/2021,10063222010,1006322
3400,06/08/2021,3965,28,3350,50,615,20/07/2021,"Chateau Angelus Premier Grand Cru Classe B, Saint-Emilion Grand Cru",Bordeaux,2010,07/08/2021,10060452010,1006045
750,04/08/2021,947,47,790,-40,157,01/06/2020,"Chateau Calon Segur 3eme Cru Classe, Saint-Estephe",Bordeaux,2011,05/08/2021,10074752011,1007475
990,04/08/2021,1177,63,1029,-39,148,21/07/2021,"Chateau Calon Segur 3eme Cru Classe, Saint-Estephe",Bordeaux,2005,05/08/2021,10074752005,1007475
5100,03/08/2021,5598,19,4650,450,948,21/06/2021,"Chateau Margaux Premier Cru Classe, Margaux",Bordeaux,2003,04/08/2021,10127812003,1012781
3900,03/08/2021,4639,96,3822,78,817,20/06/2021,"Chateau Margaux Premier Cru Classe, Margaux",Bordeaux,2006,04/08/2021,10127812006,1012781
750,02/08/2021,947,47,790,-40,157,01/06/2020,"Chateau Calon Segur 3eme Cru Classe, Saint-Estephe",Bordeaux,2011,04/08/2021,10074752011,1007475
6500,05/08/2021,7571,28,6400,100,1171,22/07/2021,"Chateau Margaux Premier Cru Classe, Margaux",Bordeaux,2005,06/08/2021,10127812005,1012781
3400,30/07/2021,3949,26,3350,50,599,20/07/2021,"Chateau Angelus Premier Grand Cru Classe B, Saint-Emilion Grand Cru",Bordeaux,2010,03/08/2021,10060452010,1006045
900,04/08/2021,1103,23,800,100,303,21/11/2019,"Chateau Calon Segur 3eme Cru Classe, Saint-Estephe",Bordeaux,2003,05/08/2021,10074752003,1007475
996,04/08/2021,1245,43,1026,-30,219,24/06/2021,"Chateau Calon Segur 3eme Cru Classe, Saint-Estephe",Bordeaux,2009,05/08/2021,10074752009,1007475
1030,06/08/2021,1101,7,854,176,247,15/07/2021,"Tignanello, Toscana",Tuscany,2014,07/08/2021,10953912014,1095391
3400,30/07/2021,3950,27,3350,50,600,20/07/2021,"Chateau Angelus Premier Grand Cru Classe B, Saint-Emilion Grand Cru",Bordeaux,2010,31/07/2021,10060452010,1006045
1900,03/08/2021,2281,3,2190,-290,91,01/05/2021,"Gaja, Barbaresco",Piedmont,2004,04/08/2021,10996052004,1099605
3400,30/07/2021,3950,27,3350,50,600,20/07/2021,"Chateau Angelus Premier Grand Cru Classe B, Saint-Emilion Grand Cru",Bordeaux,2010,31/07/2021,10060452010,1006045
525,17/06/2021,596,397,494,31,102,20/04/2021,"Chateau Batailley 5eme Cru Classe, Pauillac",Bordeaux,2010,20/06/2021,10063222010,1006322
1050,07/05/2021,1356,38,940,110,416,18/03/2021,"Chateau Calon Segur 3eme Cru Classe, Saint-Estephe",Bordeaux,2000,09/05/2021,10074752000,1007475
840,04/08/2021,1050,21,745,95,305,16/11/2020,"Chateau Calon Segur 3eme Cru Classe, Saint-Estephe",Bordeaux,2004,05/08/2021,10074752004,1007475
1180,04/08/2021,1353,4,1140,40,213,21/07/2021,"Tignanello, Toscana",Tuscany,2009,05/08/2021,10953912009,1095391
790,05/05/2021,916,39,794,-4,122,20/04/2021,"Chateau Calon Segur 3eme Cru Classe, Saint-Estephe",Bordeaux,2014,11/05/2021,10074752014,1007475
3900,10/05/2021,4520,27,3684,216,836,10/06/2020,"Chateau Margaux Premier Cru Classe, Margaux",Bordeaux,2002,11/05/2021,10127812002,1012781
5600,10/05/2021,5813,2,4400,1200,1413,06/11/2017,"Domaine Leflaive, Chevalier-Montrachet Grand Cru",Burgundy,2013,11/05/2021,10734012013,1073401
995,10/05/2021,1122,18,1000,-5,122,12/04/2021,"Chateau Calon Segur 3eme Cru Classe, Saint-Estephe",Bordeaux,2010,11/05/2021,10074752010,1007475
3400,30/07/2021,3965,28,3350,50,615,20/07/2021,"Chateau Angelus Premier Grand Cru Classe B, Saint-Emilion Grand Cru",Bordeaux,2010,05/08/2021,10060452010,1006045
3400,30/07/2021,3978,27,3350,50,628,20/07/2021,"Chateau Angelus Premier Grand Cru Classe B, Saint-Emilion Grand Cru",Bordeaux,2010,03/08/2021,10060452010,1006045
4820,10/05/2021,4893,7,4160,660,733,19/03/2021,"Chateau Margaux Premier Cru Classe, Margaux",Bordeaux,2019,11/05/2021,10127812019,1012781
400,17/06/2021,432,7,355,45,77,15/04/2021,"Chateau Batailley 5eme Cru Classe, Pauillac",Bordeaux,2012,18/06/2021,10063222012,1006322
1300,10/05/2021,1512,13,1300,0,212,28/09/2020,"Gaja, Barbaresco",Piedmont,2014,11/05/2021,10996052014,1099605
1290,10/05/2021,1227,12,1172,118,55,07/04/2021,"Tignanello, Toscana",Tuscany,2010,11/05/2021,10953912010,1095391
6100,10/05/2021,7453,55,5922,178,1531,13/04/2021,"Chateau Margaux Premier Cru Classe, Margaux",Bordeaux,2010,11/05/2021,10127812010,1012781
1110,04/05/2021,1181,12,1202,-92,-21,10/05/2021,"Tignanello, Toscana",Tuscany,2015,11/05/2021,10953912015,1095391
3400,30/07/2021,3978,27,3350,50,628,20/07/2021,"Chateau Angelus Premier Grand Cru Classe B, Saint-Emilion Grand Cru",Bordeaux,2010,04/08/2021,10060452010,1006045
3700,06/05/2021,4094,29,3592,108,502,06/05/2021,"Chateau Margaux Premier Cru Classe, Margaux",Bordeaux,2007,11/05/2021,10127812007,1012781
830,10/05/2021,928,17,781,49,147,16/11/2020,"Chateau Calon Segur 3eme Cru Classe, Saint-Estephe",Bordeaux,2008,11/05/2021,10074752008,1007475
1000,10/05/2021,1057,9,860,140,197,08/03/2021,"Tignanello, Toscana",Tuscany,2011,11/05/2021,10953912011,1095391
7812,04/05/2021,7812,0,8540,-728,-728,02/12/2019,"Domaine Leflaive, Chevalier-Montrachet Grand Cru",Burgundy,2001,11/05/2021,10734012001,1073401
2260,10/05/2021,2305,4,2190,70,115,01/05/2021,"Gaja, Barbaresco",Piedmont,2004,11/05/2021,10996052004,1099605
9600,10/05/2021,9718,3,8000,1600,1718,30/01/2020,"Domaine Leflaive, Chevalier-Montrachet Grand Cru",Burgundy,2014,11/05/2021,10734012014,1073401
2872,10/05/2021,2872,2,2554,318,318,22/05/2020,"Gaja, Barbaresco",Piedmont,2006,11/05/2021,10996052006,1099605
540,10/05/2021,560,3,544,-4,16,18/09/2020,"Tua Rita, Giusto di Notri, Toscana",Tuscany,2013,11/05/2021,11058072013,1105807
1500,10/05/2021,1679,36,1408,92,271,09/04/2021,"Gaja, Barbaresco",Piedmont,2016,11/05/2021,10996052016,1099605
400,17/06/2021,432,7,355,45,77,15/04/2021,"Chateau Batailley 5eme Cru Classe, Pauillac",Bordeaux,2012,18/06/2021,10063222012,1006322
3400,30/07/2021,3965,28,3350,50,615,20/07/2021,"Chateau Angelus Premier Grand Cru Classe B, Saint-Emilion Grand Cru",Bordeaux,2010,05/08/2021,10060452010,1006045
300,17/06/2021,302,104,304,-4,-2,10/01/2021,"Chateau Batailley 5eme Cru Classe, Pauillac",Bordeaux,2013,18/06/2021,10063222013,1006322
780,10/05/2021,836,6,682,98,154,15/09/2020,"Chateau Calon Segur 3eme Cru Classe, Saint-Estephe",Bordeaux,2013,11/05/2021,10074752013,1007475
3400,30/07/2021,3949,26,3350,50,599,20/07/2021,"Chateau Angelus Premier Grand Cru Classe B, Saint-Emilion Grand Cru",Bordeaux,2010,03/08/2021,10060452010,1006045
7600,10/05/2021,7852,2,7124,476,728,15/02/2019,"Domaine Leflaive, Chevalier-Montrachet Grand Cru",Burgundy,2016,11/05/2021,10734012016,1073401
8040,10/05/2021,8232,20,7950,90,282,12/03/2021,"Chateau Margaux Premier Cru Classe, Margaux",Bordeaux,2000,11/05/2021,10127812000,1012781
500,17/06/2021,559,5,312,188,247,12/03/2021,"Chateau Batailley 5eme Cru Classe, Pauillac",Bordeaux,2015,29/06/2021,10063222015,1006322
3740,10/05/2021,4003,24,3520,220,483,07/04/2021,"Chateau Margaux Premier Cru Classe, Margaux",Bordeaux,2013,11/05/2021,10127812013,1012781
1350,10/05/2021,1464,48,1260,90,204,18/02/2021,"Gaja, Barbaresco",Piedmont,2015,11/05/2021,10996052015,1099605
460,10/05/2021,487,154,420,40,67,23/03/2021,"Tua Rita, Giusto di Notri, Toscana",Tuscany,2016,11/05/2021,11058072016,1105807
8400,10/05/2021,8400,0,7200,1200,1200,06/11/2019,"Domaine Denis Mortet, Chambertin Grand Cru",Burgundy,2014,11/05/2021,10490202014,1049020
3400,30/07/2021,3959,26,3350,50,609,20/07/2021,"Chateau Angelus Premier Grand Cru Classe B, Saint-Emilion Grand Cru",Bordeaux,2010,02/08/2021,10060452010,1006045
3400,30/07/2021,3959,26,3350,50,609,20/07/2021,"Chateau Angelus Premier Grand Cru Classe B, Saint-Emilion Grand Cru",Bordeaux,2010,02/08/2021,10060452010,1006045
1024,10/05/2021,1125,10,1072,-48,53,20/01/2021,"Tignanello, Toscana",Tuscany,2009,11/05/2021,10953912009,1095391
1380,10/05/2021,1458,7,1352,28,106,23/09/2020,"Gaja, Barbaresco",Piedmont,2011,11/05/2021,10996052011,1099605
880,10/05/2021,958,9,725,155,233,13/04/2021,"Chateau Calon Segur 3eme Cru Classe, Saint-Estephe",Bordeaux,2007,11/05/2021,10074752007,1007475
3400,23/07/2021,3950,27,3350,50,600,20/07/2021,"Chateau Angelus Premier Grand Cru Classe B, Saint-Emilion Grand Cru",Bordeaux,2010,30/07/2021,10060452010,1006045
12402,10/05/2021,12557,2,12850,-448,-293,30/11/2020,"Jacques-Frederic Mugnier, Chambolle-Musigny Premier Cru, Les Amoureuses",Burgundy,2011,11/05/2021,10496422011,1049642
3850,10/05/2021,4162,37,3560,290,602,20/11/2020,"Chateau Margaux Premier Cru Classe, Margaux",Bordeaux,2012,11/05/2021,10127812012,1012781
900,10/05/2021,1177,14,850,50,327,28/01/2021,"Tignanello, Toscana",Tuscany,2012,11/05/2021,10953912012,1095391
3400,23/07/2021,3960,27,3350,50,610,20/07/2021,"Chateau Angelus Premier Grand Cru Classe B, Saint-Emilion Grand Cru",Bordeaux,2010,24/07/2021,10060452010,1006045
870,06/05/2021,1037,66,920,-50,117,10/05/2021,"Tignanello, Toscana",Tuscany,2018,11/05/2021,10953912018,1095391
6396,10/05/2021,6935,2,7900,-1504,-965,29/04/2019,"Domaine Leflaive, Chevalier-Montrachet Grand Cru",Burgundy,2015,11/05/2021,10734012015,1073401
500,17/06/2021,534,30,312,188,222,12/03/2021,"Chateau Batailley 5eme Cru Classe, Pauillac",Bordeaux,2015,18/06/2021,10063222015,1006322
908,10/05/2021,1072,33,805,103,267,20/11/2019,"Chateau Calon Segur 3eme Cru Classe, Saint-Estephe",Bordeaux,2001,11/05/2021,10074752001,1007475
520,10/05/2021,575,4,460,60,115,05/05/2020,"Tua Rita, Giusto di Notri, Toscana",Tuscany,2008,11/05/2021,11058072008,1105807
3400,23/07/2021,3970,27,3350,50,620,20/07/2021,"Chateau Angelus Premier Grand Cru Classe B, Saint-Emilion Grand Cru",Bordeaux,2010,26/07/2021,10060452010,1006045
1060,05/05/2021,1113,206,1108,-48,5,08/05/2021,"Tignanello, Toscana",Tuscany,2016,11/05/2021,10953912016,1095391
476,17/06/2021,524,46,364,112,160,12/05/2021,"Chateau Batailley 5eme Cru Classe, Pauillac",Bordeaux,2016,18/06/2021,10063222016,1006322
4800,10/05/2021,5743,26,4800,0,943,11/03/2021,"Chateau Margaux Premier Cru Classe, Margaux",Bordeaux,2003,11/05/2021,10127812003,1012781
3700,10/05/2021,4215,149,3700,0,515,06/05/2021,"Chateau Margaux Premier Cru Classe, Margaux",Bordeaux,2017,11/05/2021,10127812017,1012781
866,10/05/2021,897,49,842,24,55,22/08/2020,"Chateau Calon Segur 3eme Cru Classe, Saint-Estephe",Bordeaux,2019,11/05/2021,10074752019,1007475
3400,23/07/2021,3970,27,3350,50,620,20/07/2021,"Chateau Angelus Premier Grand Cru Classe B, Saint-Emilion Grand Cru",Bordeaux,2010,26/07/2021,10060452010,1006045
8400,10/05/2021,8720,1,5960,2440,2760,01/08/2017,"Domaine Leflaive, Chevalier-Montrachet Grand Cru",Burgundy,2010,11/05/2021,10734012010,1073401
1800,10/05/2021,1840,2,1300,500,540,30/05/2019,"Gaja, Barbaresco",Piedmont,2007,11/05/2021,10996052007,1099605
3827,10/05/2021,4581,59,4116,-289,465,25/02/2021,"Chateau Margaux Premier Cru Classe, Margaux",Bordeaux,2004,11/05/2021,10127812004,1012781
3400,23/07/2021,3960,27,3350,50,610,20/07/2021,"Chateau Angelus Premier Grand Cru Classe B, Saint-Emilion Grand Cru",Bordeaux,2010,24/07/2021,10060452010,1006045
1000,10/05/2021,1244,15,1047,-47,197,27/04/2021,"Chateau Calon Segur 3eme Cru Classe, Saint-Estephe",Bordeaux,2009,11/05/2021,10074752009,1007475
3860,10/05/2021,4795,77,3800,60,995,07/04/2021,"Chateau Margaux Premier Cru Classe, Margaux",Bordeaux,2006,11/05/2021,10127812006,1012781
7000,10/05/2021,6781,1,5360,1640,1421,18/09/2020,"Domaine Leflaive, Chevalier-Montrachet Grand Cru",Burgundy,2009,11/05/2021,10734012009,1073401
3400,23/07/2021,3950,27,3350,50,600,20/07/2021,"Chateau Angelus Premier Grand Cru Classe B, Saint-Emilion Grand Cru",Bordeaux,2010,30/07/2021,10060452010,1006045
5580,10/05/2021,5535,50,5288,292,247,03/05/2021,"Chateau Margaux Premier Cru Classe, Margaux",Bordeaux,2016,11/05/2021,10127812016,1012781
6400,10/05/2021,6400,1,4500,1900,1900,08/04/2015,"Domaine Leflaive, Chevalier-Montrachet Grand Cru",Burgundy,2012,11/05/2021,10734012012,1073401
8000,10/05/2021,8606,8,6974,1026,1632,14/03/2021,"Domaine Leflaive, Chevalier-Montrachet Grand Cru",Burgundy,2017,11/05/2021,10734012017,1073401
420,18/06/2021,427,4,220,200,207,17/06/2015,"Chateau Batailley 5eme Cru Classe, Pauillac",Bordeaux,2002,19/06/2021,10063222002,1006322
1400,10/05/2021,1433,10,1276,124,157,05/03/2021,"Gaja, Barbaresco",Piedmont,2013,11/05/2021,10996052013,1099605
3920,10/05/2021,4498,76,3880,40,618,22/03/2021,"Chateau Margaux Premier Cru Classe, Margaux",Bordeaux,2008,11/05/2021,10127812008,1012781
8016,10/05/2021,9840,3,7290,726,2550,21/08/2020,"Domaine Denis Mortet, Chambertin Grand Cru",Burgundy,2017,11/05/2021,10490202017,1049020
750,10/05/2021,1007,36,790,-40,217,01/06/2020,"Chateau Calon Segur 3eme Cru Classe, Saint-Estephe",Bordeaux,2011,11/05/2021,10074752011,1007475
1082,04/05/2021,1208,69,1048,34,160,27/04/2021,"Chateau Calon Segur 3eme Cru Classe, Saint-Estephe",Bordeaux,2016,11/05/2021,10074752016,1007475
1700,10/05/2021,1674,3,1378,322,296,29/07/2020,"Tignanello, Toscana",Tuscany,2001,11/05/2021,10953912001,1095391
3400,16/07/2021,3943,28,3275,125,668,29/06/2021,"Chateau Angelus Premier Grand Cru Classe B, Saint-Emilion Grand Cru",Bordeaux,2010,17/07/2021,10060452010,1006045
1029,05/05/2021,1181,70,975,54,206,12/04/2021,"Chateau Calon Segur 3eme Cru Classe, Saint-Estephe",Bordeaux,2005,11/05/2021,10074752005,1007475
6600,10/05/2021,7979,73,6412,188,1567,25/03/2021,"Chateau Margaux Premier Cru Classe, Margaux",Bordeaux,2009,11/05/2021,10127812009,1012781
480,18/06/2021,563,5,420,60,143,09/07/2019,"Chateau Batailley 5eme Cru Classe, Pauillac",Bordeaux,2003,19/06/2021,10063222003,1006322
6800,10/05/2021,6800,1,1730,5070,5070,31/10/2011,"Domaine Leflaive, Chevalier-Montrachet Grand Cru",Burgundy,2003,11/05/2021,10734012003,1073401
3400,16/07/2021,3944,28,3350,50,594,20/07/2021,"Chateau Angelus Premier Grand Cru Classe B, Saint-Emilion Grand Cru",Bordeaux,2010,21/07/2021,10060452010,1006045
3400,16/07/2021,3944,28,3275,125,669,29/06/2021,"Chateau Angelus Premier Grand Cru Classe B, Saint-Emilion Grand Cru",Bordeaux,2010,20/07/2021,10060452010,1006045
10500,10/05/2021,12456,64,9844,656,2612,29/03/2021,"Chateau Margaux Premier Cru Classe, Margaux",Bordeaux,2015,11/05/2021,10127812015,1012781
450,18/06/2021,450,1,340,110,110,31/08/2018,"Chateau Batailley 5eme Cru Classe, Pauillac",Bordeaux,2007,19/06/2021,10063222007,1006322
540,10/05/2021,540,1,300,240,240,03/11/2011,"Tua Rita, Giusto di Notri, Toscana",Tuscany,2007,11/05/2021,11058072007,1105807
3800,10/05/2021,4383,125,3690,110,693,13/04/2021,"Chateau Margaux Premier Cru Classe, Margaux",Bordeaux,2011,11/05/2021,10127812011,1012781
3400,16/07/2021,3947,28,3350,50,597,20/07/2021,"Chateau Angelus Premier Grand Cru Classe B, Saint-Emilion Grand Cru",Bordeaux,2010,22/07/2021,10060452010,1006045
790,06/05/2021,891,140,907,-117,-16,03/05/2021,"Tignanello, Toscana",Tuscany,2017,10/05/2021,10953912017,1095391
850,07/05/2021,1110,88,860,-10,250,19/04/2021,"Chateau Calon Segur 3eme Cru Classe, Saint-Estephe",Bordeaux,2015,10/05/2021,10074752015,1007475
400,18/06/2021,432,7,355,45,77,15/04/2021,"Chateau Batailley 5eme Cru Classe, Pauillac",Bordeaux,2012,19/06/2021,10063222012,1006322
430,10/05/2021,456,108,380,50,76,25/03/2021,"Tua Rita, Giusto di Notri, Toscana",Tuscany,2018,11/05/2021,11058072018,1105807
3720,10/05/2021,4078,51,3480,240,598,10/04/2021,"Chateau Margaux Premier Cru Classe, Margaux",Bordeaux,2014,11/05/2021,10127812014,1012781
487,10/05/2021,537,33,320,167,217,24/03/2021,"Tua Rita, Giusto di Notri, Toscana",Tuscany,2017,11/05/2021,11058072017,1105807
400,18/06/2021,432,7,355,45,77,15/04/2021,"Chateau Batailley 5eme Cru Classe, Pauillac",Bordeaux,2012,19/06/2021,10063222012,1006322
660,10/05/2021,724,4,390,270,334,18/08/2017,"Tua Rita, Giusto di Notri, Toscana",Tuscany,2006,11/05/2021,11058072006,1105807
3400,16/07/2021,3947,28,3350,50,597,20/07/2021,"Chateau Angelus Premier Grand Cru Classe B, Saint-Emilion Grand Cru",Bordeaux,2010,22/07/2021,10060452010,1006045
3400,16/07/2021,3943,28,3275,125,668,29/06/2021,"Chateau Angelus Premier Grand Cru Classe B, Saint-Emilion Grand Cru",Bordeaux,2010,17/07/2021,10060452010,1006045
950,10/05/2021,1017,49,863,87,154,10/05/2021,"Chateau Calon Segur 3eme Cru Classe, Saint-Estephe",Bordeaux,2006,11/05/2021,10074752006,1007475
780,10/05/2021,891,139,907,-127,-16,03/05/2021,"Tignanello, Toscana",Tuscany,2017,11/05/2021,10953912017,1095391
5415,10/05/2021,5657,137,5150,265,507,03/05/2021,"Chateau Margaux Premier Cru Classe, Margaux",Bordeaux,2018,11/05/2021,10127812018,1012781
420,10/05/2021,462,10,342,78,120,21/08/2020,"Tua Rita, Giusto di Notri, Toscana",Tuscany,2011,11/05/2021,11058072011,1105807
4400,10/05/2021,4903,27,4400,0,503,29/09/2020,"Chateau Margaux Premier Cru Classe, Margaux",Bordeaux,2001,11/05/2021,10127812001,1012781
850,10/05/2021,1110,90,860,-10,250,19/04/2021,"Chateau Calon Segur 3eme Cru Classe, Saint-Estephe",Bordeaux,2015,11/05/2021,10074752015,1007475
900,10/05/2021,1058,20,800,100,258,21/11/2019,"Chateau Calon Segur 3eme Cru Classe, Saint-Estephe",Bordeaux,2003,11/05/2021,10074752003,1007475
3400,16/07/2021,3944,28,3275,125,669,29/06/2021,"Chateau Angelus Premier Grand Cru Classe B, Saint-Emilion Grand Cru",Bordeaux,2010,20/07/2021,10060452010,1006045
300,18/06/2021,302,104,304,-4,-2,10/01/2021,"Chateau Batailley 5eme Cru Classe, Pauillac",Bordeaux,2013,19/06/2021,10063222013,1006322
820,30/06/2021,939,6,735,85,204,09/09/2020,"Chateau Calon Segur 3eme Cru Classe, Saint-Estephe",Bordeaux,2012,01/07/2021,10074752012,1007475
3750,24/06/2021,4160,42,3560,190,600,20/11/2020,"Chateau Margaux Premier Cru Classe, Margaux",Bordeaux,2012,01/07/2021,10127812012,1012781
895,10/08/2021,963,53,863,32,100,10/05/2021,"Chateau Calon Segur 3eme Cru Classe, Saint-Estephe",Bordeaux,2006,11/08/2021,10074752006,1007475
5100,10/08/2021,5703,19,4650,450,1053,21/06/2021,"Chateau Margaux Premier Cru Classe, Margaux",Bordeaux,2003,11/08/2021,10127812003,1012781
660,10/08/2021,727,5,390,270,337,18/08/2017,"Tua Rita, Giusto di Notri, Toscana",Tuscany,2006,11/08/2021,11058072006,1105807
800,09/08/2021,776,25,682,118,94,15/09/2020,"Chateau Calon Segur 3eme Cru Classe, Saint-Estephe",Bordeaux,2013,11/08/2021,10074752013,1007475
6930,10/08/2021,7721,59,7086,-156,635,11/06/2021,"Chateau Margaux Premier Cru Classe, Margaux",Bordeaux,2009,11/08/2021,10127812009,1012781
3400,16/07/2021,3944,28,3350,50,594,20/07/2021,"Chateau Angelus Premier Grand Cru Classe B, Saint-Emilion Grand Cru",Bordeaux,2010,21/07/2021,10060452010,1006045
3400,09/07/2021,3943,28,3275,125,668,29/06/2021,"Chateau Angelus Premier Grand Cru Classe B, Saint-Emilion Grand Cru",Bordeaux,2010,16/07/2021,10060452010,1006045
5600,10/08/2021,6019,50,5254,346,765,26/05/2021,"Chateau Margaux Premier Cru Classe, Margaux",Bordeaux,2018,11/08/2021,10127812018,1012781
3400,09/07/2021,3889,26,3275,125,614,29/06/2021,"Chateau Angelus Premier Grand Cru Classe B, Saint-Emilion Grand Cru",Bordeaux,2010,10/07/2021,10060452010,1006045
3400,09/07/2021,3889,26,3275,125,614,29/06/2021,"Chateau Angelus Premier Grand Cru Classe B, Saint-Emilion Grand Cru",Bordeaux,2010,10/07/2021,10060452010,1006045
3400,09/07/2021,3861,25,3275,125,586,29/06/2021,"Chateau Angelus Premier Grand Cru Classe B, Saint-Emilion Grand Cru",Bordeaux,2010,11/07/2021,10060452010,1006045
3800,10/08/2021,4350,134,3600,200,750,02/08/2021,"Chateau Margaux Premier Cru Classe, Margaux",Bordeaux,2014,11/08/2021,10127812014,1012781
8252,09/08/2021,10027,3,7290,962,2737,21/08/2020,"Domaine Denis Mortet, Chambertin Grand Cru",Burgundy,2017,11/08/2021,10490202017,1049020
1008,05/08/2021,1177,73,1034,-26,143,10/08/2021,"Tignanello, Toscana",Tuscany,2018,11/08/2021,10953912018,1095391
6400,10/08/2021,7608,61,6188,212,1420,16/07/2021,"Chateau Margaux Premier Cru Classe, Margaux",Bordeaux,2010,11/08/2021,10127812010,1012781
1480,05/08/2021,1632,64,1398,82,234,01/07/2021,"Gaja, Barbaresco",Piedmont,2017,11/08/2021,10996052017,1099605
9000,10/08/2021,9000,1,5400,3600,3600,13/08/2020,"Domaine Leflaive, Chevalier-Montrachet Grand Cru",Burgundy,2008,11/08/2021,10734012008,1073401
8000,10/08/2021,8129,1,7900,100,229,29/04/2019,"Domaine Leflaive, Chevalier-Montrachet Grand Cru",Burgundy,2015,11/08/2021,10734012015,1073401
3950,10/08/2021,4468,108,3780,170,688,23/07/2021,"Chateau Margaux Premier Cru Classe, Margaux",Bordeaux,2008,11/08/2021,10127812008,1012781
995,09/08/2021,1117,19,993,2,124,27/07/2021,"Chateau Calon Segur 3eme Cru Classe, Saint-Estephe",Bordeaux,2010,11/08/2021,10074752010,1007475
1900,10/08/2021,2336,4,2190,-290,146,01/05/2021,"Gaja, Barbaresco",Piedmont,2004,11/08/2021,10996052004,1099605
1090,10/08/2021,1143,8,952,138,191,04/08/2021,"Tignanello, Toscana",Tuscany,2013,11/08/2021,10953912013,1095391
3400,09/07/2021,3861,25,3275,125,586,29/06/2021,"Chateau Angelus Premier Grand Cru Classe B, Saint-Emilion Grand Cru",Bordeaux,2010,11/07/2021,10060452010,1006045
990,10/08/2021,1132,10,880,110,252,22/06/2021,"Tignanello, Toscana",Tuscany,2011,11/08/2021,10953912011,1095391
1550,10/08/2021,1550,1,1300,250,250,27/04/2021,"Gaja, Barbaresco",Piedmont,2012,11/08/2021,10996052012,1099605
1624,10/08/2021,1748,18,1584,40,164,06/08/2021,"Gaja, Barbaresco",Piedmont,2018,11/08/2021,10996052018,1099605
1800,09/07/2021,2294,1,1440,360,854,04/01/2018,"Gaja, Barbaresco",Piedmont,2010,11/08/2021,10996052010,1099605
520,10/08/2021,571,3,460,60,111,05/05/2020,"Tua Rita, Giusto di Notri, Toscana",Tuscany,2008,11/08/2021,11058072008,1105807
3700,10/08/2021,4184,57,3520,180,664,07/04/2021,"Chateau Margaux Premier Cru Classe, Margaux",Bordeaux,2013,11/08/2021,10127812013,1012781
476,18/06/2021,524,46,364,112,160,12/05/2021,"Chateau Batailley 5eme Cru Classe, Pauillac",Bordeaux,2016,19/06/2021,10063222016,1006322
14520,10/08/2021,14520,1,12000,2520,2520,28/05/2020,"Jacques-Frederic Mugnier, Chambolle-Musigny Premier Cru, Les Amoureuses",Burgundy,2014,11/08/2021,10496422014,1049642
10800,06/08/2021,10673,2,8000,2800,2673,30/01/2020,"Domaine Leflaive, Chevalier-Montrachet Grand Cru",Burgundy,2014,11/08/2021,10734012014,1073401
1584,10/08/2021,1670,4,1378,206,292,29/07/2020,"Tignanello, Toscana",Tuscany,2001,11/08/2021,10953912001,1095391
790,10/08/2021,870,15,801,-11,69,31/05/2021,"Chateau Calon Segur 3eme Cru Classe, Saint-Estephe",Bordeaux,2014,11/08/2021,10074752014,1007475
820,10/08/2021,913,5,735,85,178,09/09/2020,"Chateau Calon Segur 3eme Cru Classe, Saint-Estephe",Bordeaux,2012,11/08/2021,10074752012,1007475
940,10/08/2021,1076,76,866,74,210,20/07/2021,"Chateau Calon Segur 3eme Cru Classe, Saint-Estephe",Bordeaux,2015,11/08/2021,10074752015,1007475
3400,09/07/2021,3943,28,3275,125,668,29/06/2021,"Chateau Angelus Premier Grand Cru Classe B, Saint-Emilion Grand Cru",Bordeaux,2010,16/07/2021,10060452010,1006045
1250,10/08/2021,1416,60,1220,30,196,14/07/2021,"Tignanello, Toscana",Tuscany,2016,11/08/2021,10953912016,1095391
3400,02/07/2021,3889,26,3275,125,614,29/06/2021,"Chateau Angelus Premier Grand Cru Classe B, Saint-Emilion Grand Cru",Bordeaux,2010,03/07/2021,10060452010,1006045
540,10/08/2021,540,1,300,240,240,03/11/2011,"Tua Rita, Giusto di Notri, Toscana",Tuscany,2007,11/08/2021,11058072007,1105807
1100,10/08/2021,1220,70,1036,64,184,27/05/2021,"Chateau Calon Segur 3eme Cru Classe, Saint-Estephe",Bordeaux,2016,11/08/2021,10074752016,1007475
996,09/08/2021,1283,36,1026,-30,257,24/06/2021,"Chateau Calon Segur 3eme Cru Classe, Saint-Estephe",Bordeaux,2009,11/08/2021,10074752009,1007475
3400,02/07/2021,3889,26,3275,125,614,29/06/2021,"Chateau Angelus Premier Grand Cru Classe B, Saint-Emilion Grand Cru",Bordeaux,2010,03/07/2021,10060452010,1006045
870,10/08/2021,950,10,705,165,245,01/02/2021,"Chateau Calon Segur 3eme Cru Classe, Saint-Estephe",Bordeaux,2002,11/08/2021,10074752002,1007475
3935,09/08/2021,4659,40,3790,145,869,10/08/2021,"Chateau Margaux Premier Cru Classe, Margaux",Bordeaux,2004,11/08/2021,10127812004,1012781
5900,10/08/2021,5272,9,4160,1740,1112,19/03/2021,"Chateau Margaux Premier Cru Classe, Margaux",Bordeaux,2019,11/08/2021,10127812019,1012781
16200,10/08/2021,16483,0,18750,-2550,-2267,29/08/2018,"Jacques-Frederic Mugnier, Chambolle-Musigny Premier Cru, Les Amoureuses",Burgundy,2015,11/08/2021,10496422015,1049642
8568,10/08/2021,8792,3,7330,1238,1462,02/06/2021,"Domaine Leflaive, Chevalier-Montrachet Grand Cru",Burgundy,2018,11/08/2021,10734012018,1073401
990,10/08/2021,1176,64,1029,-39,147,21/07/2021,"Chateau Calon Segur 3eme Cru Classe, Saint-Estephe",Bordeaux,2005,11/08/2021,10074752005,1007475
480,21/06/2021,563,5,420,60,143,09/07/2019,"Chateau Batailley 5eme Cru Classe, Pauillac",Bordeaux,2003,22/06/2021,10063222003,1006322
880,10/08/2021,967,9,725,155,242,13/04/2021,"Chateau Calon Segur 3eme Cru Classe, Saint-Estephe",Bordeaux,2007,11/08/2021,10074752007,1007475
4450,10/08/2021,4734,16,4400,50,334,29/09/2020,"Chateau Margaux Premier Cru Classe, Margaux",Bordeaux,2001,11/08/2021,10127812001,1012781
920,10/08/2021,1014,13,842,78,172,22/08/2020,"Chateau Calon Segur 3eme Cru Classe, Saint-Estephe",Bordeaux,2019,11/08/2021,10074752019,1007475
3400,25/06/2021,3903,27,3275,125,628,29/06/2021,"Chateau Angelus Premier Grand Cru Classe B, Saint-Emilion Grand Cru",Bordeaux,2010,02/07/2021,10060452010,1006045
895,10/08/2021,949,9,781,114,168,16/11/2020,"Chateau Calon Segur 3eme Cru Classe, Saint-Estephe",Bordeaux,2008,11/08/2021,10074752008,1007475
6500,09/08/2021,7497,25,6400,100,1097,22/07/2021,"Chateau Margaux Premier Cru Classe, Margaux",Bordeaux,2005,11/08/2021,10127812005,1012781
530,21/06/2021,623,49,520,10,103,17/06/2021,"Chateau Batailley 5eme Cru Classe, Pauillac",Bordeaux,2005,22/06/2021,10063222005,1006322
707,10/08/2021,1067,63,908,-201,159,04/08/2021,"Tignanello, Toscana",Tuscany,2017,11/08/2021,10953912017,1095391
530,21/06/2021,623,49,520,10,103,17/06/2021,"Chateau Batailley 5eme Cru Classe, Pauillac",Bordeaux,2005,22/06/2021,10063222005,1006322
3900,10/08/2021,4229,46,3690,210,539,13/04/2021,"Chateau Margaux Premier Cru Classe, Margaux",Bordeaux,2011,11/08/2021,10127812011,1012781
780,10/08/2021,938,100,740,40,198,21/05/2021,"Chateau Calon Segur 3eme Cru Classe, Saint-Estephe",Bordeaux,2017,11/08/2021,10074752017,1007475
420,21/06/2021,521,5,400,20,121,11/05/2021,"Chateau Batailley 5eme Cru Classe, Pauillac",Bordeaux,2006,22/06/2021,10063222006,1006322
3860,09/08/2021,4615,217,3950,-90,665,30/06/2021,"Chateau Margaux Premier Cru Classe, Margaux",Bordeaux,2017,11/08/2021,10127812017,1012781
3900,10/08/2021,4644,97,3822,78,822,20/06/2021,"Chateau Margaux Premier Cru Classe, Margaux",Bordeaux,2006,11/08/2021,10127812006,1012781
3400,25/06/2021,3892,27,3275,125,617,29/06/2021,"Chateau Angelus Premier Grand Cru Classe B, Saint-Emilion Grand Cru",Bordeaux,2010,30/06/2021,10060452010,1006045
1100,27/05/2021,1695,4,1150,-50,545,27/07/2021,"Tignanello, Toscana",Tuscany,2008,11/08/2021,10953912008,1095391
10620,10/08/2021,12019,47,9800,820,2219,11/06/2021,"Chateau Margaux Premier Cru Classe, Margaux",Bordeaux,2015,11/08/2021,10127812015,1012781
3400,25/06/2021,3892,27,3275,125,617,29/06/2021,"Chateau Angelus Premier Grand Cru Classe B, Saint-Emilion Grand Cru",Bordeaux,2010,30/06/2021,10060452010,1006045
3400,25/06/2021,3903,27,3275,125,628,29/06/2021,"Chateau Angelus Premier Grand Cru Classe B, Saint-Emilion Grand Cru",Bordeaux,2010,02/07/2021,10060452010,1006045
990,06/08/2021,1119,10,880,110,239,22/06/2021,"Tignanello, Toscana",Tuscany,2011,07/08/2021,10953912011,1095391
3390,17/06/2021,3873,28,3202,188,671,19/05/2021,"Chateau Angelus Premier Grand Cru Classe B, Saint-Emilion Grand Cru",Bordeaux,2010,21/06/2021,10060452010,1006045
1900,05/08/2021,2281,3,2190,-290,91,01/05/2021,"Gaja, Barbaresco",Piedmont,2004,06/08/2021,10996052004,1099605
820,03/08/2021,925,4,735,85,190,09/09/2020,"Chateau Calon Segur 3eme Cru Classe, Saint-Estephe",Bordeaux,2012,04/08/2021,10074752012,1007475
6250,20/05/2021,7046,40,6300,-50,746,21/05/2021,"Chateau Margaux Premier Cru Classe, Margaux",Bordeaux,2005,24/05/2021,10127812005,1012781
4400,21/05/2021,4831,24,4400,0,431,29/09/2020,"Chateau Margaux Premier Cru Classe, Margaux",Bordeaux,2001,24/05/2021,10127812001,1012781
750,18/05/2021,884,119,740,10,144,21/05/2021,"Chateau Calon Segur 3eme Cru Classe, Saint-Estephe",Bordeaux,2017,24/05/2021,10074752017,1007475
840,18/05/2021,1092,90,860,-20,232,19/04/2021,"Chateau Calon Segur 3eme Cru Classe, Saint-Estephe",Bordeaux,2015,24/05/2021,10074752015,1007475
3390,17/06/2021,3892,27,3175,215,717,24/06/2021,"Chateau Angelus Premier Grand Cru Classe B, Saint-Emilion Grand Cru",Bordeaux,2010,29/06/2021,10060452010,1006045
3390,17/06/2021,3856,29,3202,188,654,19/05/2021,"Chateau Angelus Premier Grand Cru Classe B, Saint-Emilion Grand Cru",Bordeaux,2010,18/06/2021,10060452010,1006045
8040,21/05/2021,8344,19,7950,90,394,12/03/2021,"Chateau Margaux Premier Cru Classe, Margaux",Bordeaux,2000,24/05/2021,10127812000,1012781
750,19/05/2021,1021,50,790,-40,231,01/06/2020,"Chateau Calon Segur 3eme Cru Classe, Saint-Estephe",Bordeaux,2011,24/05/2021,10074752011,1007475
3827,21/05/2021,4497,63,4116,-289,381,25/02/2021,"Chateau Margaux Premier Cru Classe, Margaux",Bordeaux,2004,24/05/2021,10127812004,1012781
790,20/05/2021,917,32,794,-4,123,20/04/2021,"Chateau Calon Segur 3eme Cru Classe, Saint-Estephe",Bordeaux,2014,24/05/2021,10074752014,1007475
6300,21/05/2021,7515,57,6190,110,1325,23/05/2021,"Chateau Margaux Premier Cru Classe, Margaux",Bordeaux,2010,24/05/2021,10127812010,1012781
1050,21/05/2021,1156,59,1048,2,108,27/04/2021,"Chateau Calon Segur 3eme Cru Classe, Saint-Estephe",Bordeaux,2016,24/05/2021,10074752016,1007475
3700,21/05/2021,4063,130,3700,0,363,06/05/2021,"Chateau Margaux Premier Cru Classe, Margaux",Bordeaux,2017,24/05/2021,10127812017,1012781
3390,17/06/2021,3873,28,3202,188,671,19/05/2021,"Chateau Angelus Premier Grand Cru Classe B, Saint-Emilion Grand Cru",Bordeaux,2010,21/06/2021,10060452010,1006045
1480,13/05/2021,1624,73,1358,122,266,12/05/2021,"Gaja, Barbaresco",Piedmont,2017,24/05/2021,10996052017,1099605
3390,17/06/2021,3873,28,3175,215,698,24/06/2021,"Chateau Angelus Premier Grand Cru Classe B, Saint-Emilion Grand Cru",Bordeaux,2010,25/06/2021,10060452010,1006045
4850,20/05/2021,5867,25,4842,8,1025,19/05/2021,"Chateau Margaux Premier Cru Classe, Margaux",Bordeaux,2003,24/05/2021,10127812003,1012781
1000,21/05/2021,1158,42,1047,-47,111,27/04/2021,"Chateau Calon Segur 3eme Cru Classe, Saint-Estephe",Bordeaux,2009,24/05/2021,10074752009,1007475
540,19/05/2021,565,2,544,-4,21,18/09/2020,"Tua Rita, Giusto di Notri, Toscana",Tuscany,2013,24/05/2021,11058072013,1105807
950,18/05/2021,1101,41,830,120,271,18/04/2021,"Tignanello, Toscana",Tuscany,2014,24/05/2021,10953912014,1095391
10500,21/05/2021,12496,70,9844,656,2652,29/03/2021,"Chateau Margaux Premier Cru Classe, Margaux",Bordeaux,2015,24/05/2021,10127812015,1012781
3720,21/05/2021,4099,52,3480,240,619,10/04/2021,"Chateau Margaux Premier Cru Classe, Margaux",Bordeaux,2014,24/05/2021,10127812014,1012781
3390,17/06/2021,3892,27,3175,215,717,24/06/2021,"Chateau Angelus Premier Grand Cru Classe B, Saint-Emilion Grand Cru",Bordeaux,2010,29/06/2021,10060452010,1006045
907,21/05/2021,927,19,805,102,122,20/11/2019,"Chateau Calon Segur 3eme Cru Classe, Saint-Estephe",Bordeaux,2001,24/05/2021,10074752001,1007475
790,18/05/2021,973,21,745,45,228,16/11/2020,"Chateau Calon Segur 3eme Cru Classe, Saint-Estephe",Bordeaux,2004,24/05/2021,10074752004,1007475
1020,18/05/2021,1200,54,950,70,250,03/05/2021,"Chateau Calon Segur 3eme Cru Classe, Saint-Estephe",Bordeaux,2018,24/05/2021,10074752018,1007475
768,21/05/2021,927,12,705,63,222,01/02/2021,"Chateau Calon Segur 3eme Cru Classe, Saint-Estephe",Bordeaux,2002,24/05/2021,10074752002,1007475
6650,20/05/2021,7643,42,6525,125,1118,23/05/2021,"Chateau Margaux Premier Cru Classe, Margaux",Bordeaux,2009,24/05/2021,10127812009,1012781
3920,21/05/2021,4435,93,3800,120,635,12/05/2021,"Chateau Margaux Premier Cru Classe, Margaux",Bordeaux,2008,24/05/2021,10127812008,1012781
860,19/05/2021,1025,70,940,-80,85,13/05/2021,"Tignanello, Toscana",Tuscany,2018,24/05/2021,10953912018,1095391
1000,21/05/2021,1164,85,975,25,189,12/04/2021,"Chateau Calon Segur 3eme Cru Classe, Saint-Estephe",Bordeaux,2005,24/05/2021,10074752005,1007475
790,20/05/2021,917,32,794,-4,123,20/04/2021,"Chateau Calon Segur 3eme Cru Classe, Saint-Estephe",Bordeaux,2014,24/05/2021,10074752014,1007475
960,04/08/2021,1163,11,910,50,253,04/08/2021,"Tignanello, Toscana",Tuscany,2012,05/08/2021,10953912012,1095391
866,05/08/2021,955,8,705,161,250,01/02/2021,"Chateau Calon Segur 3eme Cru Classe, Saint-Estephe",Bordeaux,2002,06/08/2021,10074752002,1007475
990,05/08/2021,1119,10,880,110,239,22/06/2021,"Tignanello, Toscana",Tuscany,2011,06/08/2021,10953912011,1095391
790,05/08/2021,868,17,801,-11,67,31/05/2021,"Chateau Calon Segur 3eme Cru Classe, Saint-Estephe",Bordeaux,2014,06/08/2021,10074752014,1007475
3900,04/08/2021,4442,22,3684,216,758,10/06/2020,"Chateau Margaux Premier Cru Classe, Margaux",Bordeaux,2002,06/08/2021,10127812002,1012781
1700,14/05/2021,1674,3,1378,322,296,29/07/2020,"Tignanello, Toscana",Tuscany,2001,15/05/2021,10953912001,1095391
900,14/05/2021,1057,23,800,100,257,21/11/2019,"Chateau Calon Segur 3eme Cru Classe, Saint-Estephe",Bordeaux,2003,15/05/2021,10074752003,1007475
1000,14/05/2021,1167,79,975,25,192,12/04/2021,"Chateau Calon Segur 3eme Cru Classe, Saint-Estephe",Bordeaux,2005,15/05/2021,10074752005,1007475
1010,14/05/2021,1048,9,860,150,188,08/03/2021,"Tignanello, Toscana",Tuscany,2011,15/05/2021,10953912011,1095391
6800,14/05/2021,6800,1,1730,5070,5070,31/10/2011,"Domaine Leflaive, Chevalier-Montrachet Grand Cru",Burgundy,2003,15/05/2021,10734012003,1073401
3740,14/05/2021,3962,48,3520,220,442,07/04/2021,"Chateau Margaux Premier Cru Classe, Margaux",Bordeaux,2013,15/05/2021,10127812013,1012781
504,14/05/2021,522,1,300,204,222,03/11/2011,"Tua Rita, Giusto di Notri, Toscana",Tuscany,2007,15/05/2021,11058072007,1105807
16200,14/05/2021,16056,0,18750,-2550,-2694,29/08/2018,"Jacques-Frederic Mugnier, Chambolle-Musigny Premier Cru, Les Amoureuses",Burgundy,2015,15/05/2021,10496422015,1049642
880,14/05/2021,967,9,725,155,242,13/04/2021,"Chateau Calon Segur 3eme Cru Classe, Saint-Estephe",Bordeaux,2007,15/05/2021,10074752007,1007475
1400,14/05/2021,1433,10,1276,124,157,05/03/2021,"Gaja, Barbaresco",Piedmont,2013,15/05/2021,10996052013,1099605
3390,17/06/2021,3856,29,3202,188,654,19/05/2021,"Chateau Angelus Premier Grand Cru Classe B, Saint-Emilion Grand Cru",Bordeaux,2010,18/06/2021,10060452010,1006045
3390,17/06/2021,3873,28,3175,215,698,24/06/2021,"Chateau Angelus Premier Grand Cru Classe B, Saint-Emilion Grand Cru",Bordeaux,2010,25/06/2021,10060452010,1006045
750,14/05/2021,1013,35,790,-40,223,01/06/2020,"Chateau Calon Segur 3eme Cru Classe, Saint-Estephe",Bordeaux,2011,15/05/2021,10074752011,1007475
3400,11/06/2021,3854,29,3202,198,652,19/05/2021,"Chateau Angelus Premier Grand Cru Classe B, Saint-Emilion Grand Cru",Bordeaux,2010,12/06/2021,10060452010,1006045
3950,14/05/2021,4455,88,3800,150,655,12/05/2021,"Chateau Margaux Premier Cru Classe, Margaux",Bordeaux,2008,15/05/2021,10127812008,1012781
6300,14/05/2021,7484,52,5922,378,1562,13/04/2021,"Chateau Margaux Premier Cru Classe, Margaux",Bordeaux,2010,15/05/2021,10127812010,1012781
1024,14/05/2021,1125,10,1072,-48,53,20/01/2021,"Tignanello, Toscana",Tuscany,2009,15/05/2021,10953912009,1095391
1050,14/05/2021,1206,70,1048,2,158,27/04/2021,"Chateau Calon Segur 3eme Cru Classe, Saint-Estephe",Bordeaux,2016,15/05/2021,10074752016,1007475
4800,12/05/2021,5741,26,4800,0,941,11/03/2021,"Chateau Margaux Premier Cru Classe, Margaux",Bordeaux,2003,15/05/2021,10127812003,1012781
1350,14/05/2021,1452,7,1352,-2,100,23/09/2020,"Gaja, Barbaresco",Piedmont,2011,15/05/2021,10996052011,1099605
420,21/06/2021,521,5,400,20,121,11/05/2021,"Chateau Batailley 5eme Cru Classe, Pauillac",Bordeaux,2006,22/06/2021,10063222006,1006322
460,14/05/2021,486,149,420,40,66,23/03/2021,"Tua Rita, Giusto di Notri, Toscana",Tuscany,2016,15/05/2021,11058072016,1105807
450,21/06/2021,450,1,340,110,110,31/08/2018,"Chateau Batailley 5eme Cru Classe, Pauillac",Bordeaux,2007,22/06/2021,10063222007,1006322
750,04/05/2021,888,124,760,-10,128,29/04/2021,"Chateau Calon Segur 3eme Cru Classe, Saint-Estephe",Bordeaux,2017,15/05/2021,10074752017,1007475
900,14/05/2021,1036,66,940,-40,96,13/05/2021,"Tignanello, Toscana",Tuscany,2018,15/05/2021,10953912018,1095391
450,21/06/2021,472,2,340,110,132,31/08/2018,"Chateau Batailley 5eme Cru Classe, Pauillac",Bordeaux,2007,22/07/2021,10063222007,1006322
3700,14/05/2021,4142,136,3700,0,442,06/05/2021,"Chateau Margaux Premier Cru Classe, Margaux",Bordeaux,2017,15/05/2021,10127812017,1012781
564,14/05/2021,564,1,351,213,213,25/07/2016,"Tua Rita, Giusto di Notri, Toscana",Tuscany,2004,15/05/2021,11058072004,1105807
4400,14/05/2021,4882,29,4400,0,482,29/09/2020,"Chateau Margaux Premier Cru Classe, Margaux",Bordeaux,2001,15/05/2021,10127812001,1012781
10500,14/05/2021,12426,73,9844,656,2582,29/03/2021,"Chateau Margaux Premier Cru Classe, Margaux",Bordeaux,2015,15/05/2021,10127812015,1012781
450,21/06/2021,492,1,340,110,152,31/08/2018,"Chateau Batailley 5eme Cru Classe, Pauillac",Bordeaux,2007,23/07/2021,10063222007,1006322
3400,11/06/2021,3854,29,3202,198,652,19/05/2021,"Chateau Angelus Premier Grand Cru Classe B, Saint-Emilion Grand Cru",Bordeaux,2010,12/06/2021,10060452010,1006045
1200,14/05/2021,1147,122,1108,92,39,08/05/2021,"Tignanello, Toscana",Tuscany,2016,15/05/2021,10953912016,1095391
450,21/06/2021,465,2,340,110,125,31/08/2018,"Chateau Batailley 5eme Cru Classe, Pauillac",Bordeaux,2007,16/07/2021,10063222007,1006322
420,14/05/2021,462,10,342,78,120,21/08/2020,"Tua Rita, Giusto di Notri, Toscana",Tuscany,2011,15/05/2021,11058072011,1105807
8040,14/05/2021,8232,20,7950,90,282,12/03/2021,"Chateau Margaux Premier Cru Classe, Margaux",Bordeaux,2000,15/05/2021,10127812000,1012781
1100,14/05/2021,1536,7,1010,90,526,18/12/2020,"Tignanello, Toscana",Tuscany,2008,15/05/2021,10953912008,1095391
3357,28/05/2021,3847,29,3202,155,645,19/05/2021,"Chateau Angelus Premier Grand Cru Classe B, Saint-Emilion Grand Cru",Bordeaux,2010,10/06/2021,10060452010,1006045
780,12/05/2021,892,138,814,-34,78,13/05/2021,"Tignanello, Toscana",Tuscany,2017,15/05/2021,10953912017,1095391
525,21/06/2021,596,397,494,31,102,20/04/2021,"Chateau Batailley 5eme Cru Classe, Pauillac",Bordeaux,2010,22/06/2021,10063222010,1006322
7600,14/05/2021,8133,7,7000,600,1133,26/04/2021,"Domaine Leflaive, Chevalier-Montrachet Grand Cru",Burgundy,2018,15/05/2021,10734012018,1073401
3357,28/05/2021,3799,27,3202,155,597,19/05/2021,"Chateau Angelus Premier Grand Cru Classe B, Saint-Emilion Grand Cru",Bordeaux,2010,01/06/2021,10060452010,1006045
3850,14/05/2021,4163,43,3560,290,603,20/11/2020,"Chateau Margaux Premier Cru Classe, Margaux",Bordeaux,2012,15/05/2021,10127812012,1012781
3357,28/05/2021,3792,28,3202,155,590,19/05/2021,"Chateau Angelus Premier Grand Cru Classe B, Saint-Emilion Grand Cru",Bordeaux,2010,02/06/2021,10060452010,1006045
1480,13/05/2021,1605,73,1358,122,247,12/05/2021,"Gaja, Barbaresco",Piedmont,2017,15/05/2021,10996052017,1099605
525,21/06/2021,596,397,494,31,102,20/04/2021,"Chateau Batailley 5eme Cru Classe, Pauillac",Bordeaux,2010,22/06/2021,10063222010,1006322
950,14/05/2021,1014,61,863,87,151,10/05/2021,"Chateau Calon Segur 3eme Cru Classe, Saint-Estephe",Bordeaux,2006,15/05/2021,10074752006,1007475
3357,28/05/2021,3805,29,3202,155,603,19/05/2021,"Chateau Angelus Premier Grand Cru Classe B, Saint-Emilion Grand Cru",Bordeaux,2010,04/06/2021,10060452010,1006045
1500,14/05/2021,1676,36,1408,92,268,09/04/2021,"Gaja, Barbaresco",Piedmont,2016,15/05/2021,10996052016,1099605
3827,14/05/2021,4532,68,4116,-289,416,25/02/2021,"Chateau Margaux Premier Cru Classe, Margaux",Bordeaux,2004,15/05/2021,10127812004,1012781
400,21/06/2021,432,7,355,45,77,15/04/2021,"Chateau Batailley 5eme Cru Classe, Pauillac",Bordeaux,2012,22/06/2021,10063222012,1006322
8400,14/05/2021,8400,0,7200,1200,1200,06/11/2019,"Domaine Denis Mortet, Chambertin Grand Cru",Burgundy,2014,15/05/2021,10490202014,1049020
3900,14/05/2021,4520,33,3684,216,836,10/06/2020,"Chateau Margaux Premier Cru Classe, Margaux",Bordeaux,2002,15/05/2021,10127812002,1012781
520,14/05/2021,575,4,460,60,115,05/05/2020,"Tua Rita, Giusto di Notri, Toscana",Tuscany,2008,15/05/2021,11058072008,1105807
660,14/05/2021,724,4,390,270,334,18/08/2017,"Tua Rita, Giusto di Notri, Toscana",Tuscany,2006,15/05/2021,11058072006,1105807
1300,10/05/2021,1513,13,1300,0,213,28/09/2020,"Gaja, Barbaresco",Piedmont,2014,15/05/2021,10996052014,1099605
900,14/05/2021,1177,14,850,50,327,28/01/2021,"Tignanello, Toscana",Tuscany,2012,15/05/2021,10953912012,1095391
8000,14/05/2021,8606,8,6974,1026,1632,14/03/2021,"Domaine Leflaive, Chevalier-Montrachet Grand Cru",Burgundy,2017,15/05/2021,10734012017,1073401
3750,14/05/2021,4070,27,3592,158,478,06/05/2021,"Chateau Margaux Premier Cru Classe, Margaux",Bordeaux,2007,15/05/2021,10127812007,1012781
850,14/05/2021,1098,97,860,-10,238,19/04/2021,"Chateau Calon Segur 3eme Cru Classe, Saint-Estephe",Bordeaux,2015,15/05/2021,10074752015,1007475
3357,28/05/2021,3806,27,3202,155,604,19/05/2021,"Chateau Angelus Premier Grand Cru Classe B, Saint-Emilion Grand Cru",Bordeaux,2010,29/05/2021,10060452010,1006045
1300,13/05/2021,1327,4,1200,100,127,06/03/2021,"Tignanello, Toscana",Tuscany,2007,15/05/2021,10953912007,1095391
1800,14/05/2021,1919,0,1768,32,151,22/05/2020,"Gaja, Barbaresco",Piedmont,2000,15/05/2021,10996052000,1099605
3357,28/05/2021,3799,27,3202,155,597,19/05/2021,"Chateau Angelus Premier Grand Cru Classe B, Saint-Emilion Grand Cru",Bordeaux,2010,01/06/2021,10060452010,1006045
400,21/06/2021,432,7,355,45,77,15/04/2021,"Chateau Batailley 5eme Cru Classe, Pauillac",Bordeaux,2012,22/06/2021,10063222012,1006322
6250,14/05/2021,6937,42,6116,134,821,07/05/2021,"Chateau Margaux Premier Cru Classe, Margaux",Bordeaux,2005,15/05/2021,10127812005,1012781
995,14/05/2021,1116,19,1000,-5,116,12/04/2021,"Chateau Calon Segur 3eme Cru Classe, Saint-Estephe",Bordeaux,2010,15/05/2021,10074752010,1007475
6650,14/05/2021,7942,75,6500,150,1442,12/05/2021,"Chateau Margaux Premier Cru Classe, Margaux",Bordeaux,2009,15/05/2021,10127812009,1012781
1000,04/05/2021,1202,12,860,140,342,08/03/2021,"Tignanello, Toscana",Tuscany,2013,15/05/2021,10953912013,1095391
3800,14/05/2021,4070,50,3480,320,590,10/04/2021,"Chateau Margaux Premier Cru Classe, Margaux",Bordeaux,2014,15/05/2021,10127812014,1012781
3357,28/05/2021,3854,29,3202,155,652,19/05/2021,"Chateau Angelus Premier Grand Cru Classe B, Saint-Emilion Grand Cru",Bordeaux,2010,11/06/2021,10060452010,1006045
5580,14/05/2021,5709,85,5288,292,421,03/05/2021,"Chateau Margaux Premier Cru Classe, Margaux",Bordeaux,2016,15/05/2021,10127812016,1012781
3357,28/05/2021,3847,29,3202,155,645,19/05/2021,"Chateau Angelus Premier Grand Cru Classe B, Saint-Emilion Grand Cru",Bordeaux,2010,10/06/2021,10060452010,1006045
8016,14/05/2021,9840,3,7290,726,2550,21/08/2020,"Domaine Denis Mortet, Chambertin Grand Cru",Burgundy,2017,15/05/2021,10490202017,1049020
1000,14/05/2021,1237,17,1047,-47,190,27/04/2021,"Chateau Calon Segur 3eme Cru Classe, Saint-Estephe",Bordeaux,2009,15/05/2021,10074752009,1007475
8400,03/08/2021,8400,1,5960,2440,2440,01/08/2017,"Domaine Leflaive, Chevalier-Montrachet Grand Cru",Burgundy,2010,03/08/2021,10734012010,1073401
5290,03/08/2021,5231,7,4160,1130,1071,19/03/2021,"Chateau Margaux Premier Cru Classe, Margaux",Bordeaux,2019,03/08/2021,10127812019,1012781
3357,28/05/2021,3820,28,3202,155,618,19/05/2021,"Chateau Angelus Premier Grand Cru Classe B, Saint-Emilion Grand Cru",Bordeaux,2010,05/06/2021,10060452010,1006045
895,03/08/2021,950,9,781,114,169,16/11/2020,"Chateau Calon Segur 3eme Cru Classe, Saint-Estephe",Bordeaux,2008,03/08/2021,10074752008,1007475
1624,03/08/2021,1810,2,882,742,928,26/04/2019,"Tignanello, Toscana",Tuscany,2003,03/08/2021,10953912003,1095391
750,02/08/2021,947,47,790,-40,157,01/06/2020,"Chateau Calon Segur 3eme Cru Classe, Saint-Estephe",Bordeaux,2011,03/08/2021,10074752011,1007475
820,03/08/2021,925,4,735,85,190,09/09/2020,"Chateau Calon Segur 3eme Cru Classe, Saint-Estephe",Bordeaux,2012,03/08/2021,10074752012,1007475
3357,28/05/2021,3805,29,3202,155,603,19/05/2021,"Chateau Angelus Premier Grand Cru Classe B, Saint-Emilion Grand Cru",Bordeaux,2010,04/06/2021,10060452010,1006045
800,03/08/2021,792,19,682,118,110,15/09/2020,"Chateau Calon Segur 3eme Cru Classe, Saint-Estephe",Bordeaux,2013,03/08/2021,10074752013,1007475
1480,26/07/2021,1623,61,1398,82,225,01/07/2021,"Gaja, Barbaresco",Piedmont,2017,03/08/2021,10996052017,1099605
16200,03/08/2021,16483,0,18750,-2550,-2267,29/08/2018,"Jacques-Frederic Mugnier, Chambolle-Musigny Premier Cru, Les Amoureuses",Burgundy,2015,03/08/2021,10496422015,1049642
3357,28/05/2021,3806,27,3202,155,604,19/05/2021,"Chateau Angelus Premier Grand Cru Classe B, Saint-Emilion Grand Cru",Bordeaux,2010,29/05/2021,10060452010,1006045
6930,03/08/2021,7719,70,7086,-156,633,11/06/2021,"Chateau Margaux Premier Cru Classe, Margaux",Bordeaux,2009,03/08/2021,10127812009,1012781
1900,03/08/2021,2281,3,2190,-290,91,01/05/2021,"Gaja, Barbaresco",Piedmont,2004,03/08/2021,10996052004,1099605
1400,03/08/2021,1427,9,1360,40,67,18/07/2021,"Gaja, Barbaresco",Piedmont,2013,03/08/2021,10996052013,1099605
1040,28/07/2021,1377,69,940,100,437,18/03/2021,"Chateau Calon Segur 3eme Cru Classe, Saint-Estephe",Bordeaux,2000,03/08/2021,10074752000,1007475
1584,03/08/2021,1670,4,1378,206,292,29/07/2020,"Tignanello, Toscana",Tuscany,2001,03/08/2021,10953912001,1095391
5600,03/08/2021,6016,51,5254,346,762,26/05/2021,"Chateau Margaux Premier Cru Classe, Margaux",Bordeaux,2018,03/08/2021,10127812018,1012781
880,03/08/2021,967,9,725,155,242,13/04/2021,"Chateau Calon Segur 3eme Cru Classe, Saint-Estephe",Bordeaux,2007,03/08/2021,10074752007,1007475
3357,28/05/2021,3792,28,3202,155,590,19/05/2021,"Chateau Angelus Premier Grand Cru Classe B, Saint-Emilion Grand Cru",Bordeaux,2010,02/06/2021,10060452010,1006045
840,03/08/2021,1050,21,745,95,305,16/11/2020,"Chateau Calon Segur 3eme Cru Classe, Saint-Estephe",Bordeaux,2004,03/08/2021,10074752004,1007475
5415,30/07/2021,5877,144,5500,-85,377,06/07/2021,"Chateau Margaux Premier Cru Classe, Margaux",Bordeaux,2016,03/08/2021,10127812016,1012781
8568,03/08/2021,8730,4,7330,1238,1400,02/06/2021,"Domaine Leflaive, Chevalier-Montrachet Grand Cru",Burgundy,2018,03/08/2021,10734012018,1073401
3357,28/05/2021,3820,28,3202,155,618,19/05/2021,"Chateau Angelus Premier Grand Cru Classe B, Saint-Emilion Grand Cru",Bordeaux,2010,05/06/2021,10060452010,1006045
8000,03/08/2021,7964,1,7900,100,64,29/04/2019,"Domaine Leflaive, Chevalier-Montrachet Grand Cru",Burgundy,2015,03/08/2021,10734012015,1073401
1299,06/07/2021,1620,5,1150,149,470,27/07/2021,"Tignanello, Toscana",Tuscany,2008,03/08/2021,10953912008,1095391
300,21/06/2021,302,104,304,-4,-2,10/01/2021,"Chateau Batailley 5eme Cru Classe, Pauillac",Bordeaux,2013,22/06/2021,10063222013,1006322
940,03/08/2021,1072,77,866,74,206,20/07/2021,"Chateau Calon Segur 3eme Cru Classe, Saint-Estephe",Bordeaux,2015,03/08/2021,10074752015,1007475
3357,28/05/2021,3854,29,3202,155,652,19/05/2021,"Chateau Angelus Premier Grand Cru Classe B, Saint-Emilion Grand Cru",Bordeaux,2010,11/06/2021,10060452010,1006045
3400,27/05/2021,3667,50,3202,198,465,19/05/2021,"Chateau Angelus Premier Grand Cru Classe B, Saint-Emilion Grand Cru",Bordeaux,2010,28/05/2021,10060452010,1006045
476,21/06/2021,524,46,364,112,160,12/05/2021,"Chateau Batailley 5eme Cru Classe, Pauillac",Bordeaux,2016,22/06/2021,10063222016,1006322
990,03/08/2021,1177,63,1029,-39,148,21/07/2021,"Chateau Calon Segur 3eme Cru Classe, Saint-Estephe",Bordeaux,2005,03/08/2021,10074752005,1007475
3750,26/07/2021,4325,54,3650,100,675,27/07/2021,"Chateau Margaux Premier Cru Classe, Margaux",Bordeaux,2012,03/08/2021,10127812012,1012781
1550,03/08/2021,1550,1,1300,250,250,27/04/2021,"Gaja, Barbaresco",Piedmont,2012,03/08/2021,10996052012,1099605
15600,28/07/2021,15110,3,13000,2600,2110,29/04/2021,"Jacques-Frederic Mugnier, Chambolle-Musigny Premier Cru, Les Amoureuses",Burgundy,2017,03/08/2021,10496422017,1049642
1100,03/08/2021,1217,80,1036,64,181,27/05/2021,"Chateau Calon Segur 3eme Cru Classe, Saint-Estephe",Bordeaux,2016,03/08/2021,10074752016,1007475
875,22/07/2021,966,53,863,12,103,10/05/2021,"Chateau Calon Segur 3eme Cru Classe, Saint-Estephe",Bordeaux,2006,03/08/2021,10074752006,1007475
9000,03/08/2021,8799,1,5400,3600,3399,13/08/2020,"Domaine Leflaive, Chevalier-Montrachet Grand Cru",Burgundy,2008,03/08/2021,10734012008,1073401
3400,27/05/2021,3667,50,3202,198,465,19/05/2021,"Chateau Angelus Premier Grand Cru Classe B, Saint-Emilion Grand Cru",Bordeaux,2010,28/05/2021,10060452010,1006045
3800,28/07/2021,4228,49,3690,110,538,13/04/2021,"Chateau Margaux Premier Cru Classe, Margaux",Bordeaux,2011,03/08/2021,10127812011,1012781
7800,03/08/2021,8910,2,6974,826,1936,14/03/2021,"Domaine Leflaive, Chevalier-Montrachet Grand Cru",Burgundy,2017,03/08/2021,10734012017,1073401
2426,23/07/2021,2701,1,1768,658,933,22/05/2020,"Gaja, Barbaresco",Piedmont,2000,03/08/2021,10996052000,1099605
600,03/08/2021,600,14,408,192,192,09/04/2019,"Tua Rita, Giusto di Notri, Toscana",Tuscany,2012,03/08/2021,11058072012,1105807
3826,03/08/2021,4624,44,4116,-290,508,25/02/2021,"Chateau Margaux Premier Cru Classe, Margaux",Bordeaux,2004,03/08/2021,10127812004,1012781
3800,03/08/2021,4349,127,3600,200,749,02/08/2021,"Chateau Margaux Premier Cru Classe, Margaux",Bordeaux,2014,03/08/2021,10127812014,1012781
920,03/08/2021,954,24,842,78,112,22/08/2020,"Chateau Calon Segur 3eme Cru Classe, Saint-Estephe",Bordeaux,2019,03/08/2021,10074752019,1007475
7812,03/08/2021,7812,0,8540,-728,-728,02/12/2019,"Domaine Leflaive, Chevalier-Montrachet Grand Cru",Burgundy,2001,03/08/2021,10734012001,1073401
480,26/07/2021,456,99,380,100,76,25/03/2021,"Tua Rita, Giusto di Notri, Toscana",Tuscany,2018,03/08/2021,11058072018,1105807
1008,29/07/2021,1158,91,998,10,160,28/07/2021,"Tignanello, Toscana",Tuscany,2018,03/08/2021,10953912018,1095391
3900,03/08/2021,4639,96,3822,78,817,20/06/2021,"Chateau Margaux Premier Cru Classe, Margaux",Bordeaux,2006,03/08/2021,10127812006,1012781
1180,06/08/2021,1331,4,1140,40,191,21/07/2021,"Tignanello, Toscana",Tuscany,2009,07/08/2021,10953912009,1095391
6500,03/08/2021,7571,28,6400,100,1171,22/07/2021,"Chateau Margaux Premier Cru Classe, Margaux",Bordeaux,2005,04/08/2021,10127812005,1012781
460,19/05/2021,486,149,420,40,66,23/03/2021,"Tua Rita, Giusto di Notri, Toscana",Tuscany,2016,20/05/2021,11058072016,1105807
907,19/05/2021,1052,38,805,102,247,20/11/2019,"Chateau Calon Segur 3eme Cru Classe, Saint-Estephe",Bordeaux,2001,20/05/2021,10074752001,1007475
490,19/05/2021,554,21,388,102,166,29/09/2020,"Tua Rita, Giusto di Notri, Toscana",Tuscany,2015,20/05/2021,11058072015,1105807
3700,19/05/2021,4068,124,3700,0,368,06/05/2021,"Chateau Margaux Premier Cru Classe, Margaux",Bordeaux,2017,20/05/2021,10127812017,1012781
3400,20/05/2021,3797,28,3202,198,595,19/05/2021,"Chateau Angelus Premier Grand Cru Classe B, Saint-Emilion Grand Cru",Bordeaux,2010,22/05/2021,10060452010,1006045
6396,19/05/2021,6856,3,7900,-1504,-1044,29/04/2019,"Domaine Leflaive, Chevalier-Montrachet Grand Cru",Burgundy,2015,20/05/2021,10734012015,1073401
840,12/05/2021,1072,28,842,-2,230,22/08/2020,"Chateau Calon Segur 3eme Cru Classe, Saint-Estephe",Bordeaux,2019,20/05/2021,10074752019,1007475
3400,20/05/2021,3806,27,3202,198,604,19/05/2021,"Chateau Angelus Premier Grand Cru Classe B, Saint-Emilion Grand Cru",Bordeaux,2010,23/05/2021,10060452010,1006045
900,18/05/2021,1197,16,850,50,347,28/01/2021,"Tignanello, Toscana",Tuscany,2012,20/05/2021,10953912012,1095391
6300,19/05/2021,7578,55,5922,378,1656,13/04/2021,"Chateau Margaux Premier Cru Classe, Margaux",Bordeaux,2010,20/05/2021,10127812010,1012781
3300,20/05/2021,3797,28,3202,98,595,19/05/2021,"Chateau Angelus Premier Grand Cru Classe B, Saint-Emilion Grand Cru",Bordeaux,2010,21/05/2021,10060452010,1006045
995,19/05/2021,1119,24,1000,-5,119,12/04/2021,"Chateau Calon Segur 3eme Cru Classe, Saint-Estephe",Bordeaux,2010,20/05/2021,10074752010,1007475
3300,20/05/2021,3797,28,3202,98,595,19/05/2021,"Chateau Angelus Premier Grand Cru Classe B, Saint-Emilion Grand Cru",Bordeaux,2010,21/05/2021,10060452010,1006045
3920,19/05/2021,4447,87,3800,120,647,12/05/2021,"Chateau Margaux Premier Cru Classe, Margaux",Bordeaux,2008,20/05/2021,10127812008,1012781
8040,19/05/2021,8372,22,7950,90,422,12/03/2021,"Chateau Margaux Premier Cru Classe, Margaux",Bordeaux,2000,20/05/2021,10127812000,1012781
430,19/05/2021,456,108,380,50,76,25/03/2021,"Tua Rita, Giusto di Notri, Toscana",Tuscany,2018,20/05/2021,11058072018,1105807
1050,19/05/2021,1156,60,1048,2,108,27/04/2021,"Chateau Calon Segur 3eme Cru Classe, Saint-Estephe",Bordeaux,2016,20/05/2021,10074752016,1007475
1050,18/05/2021,1194,23,940,110,254,18/03/2021,"Chateau Calon Segur 3eme Cru Classe, Saint-Estephe",Bordeaux,2000,20/05/2021,10074752000,1007475
6250,19/05/2021,6998,40,6116,134,882,07/05/2021,"Chateau Margaux Premier Cru Classe, Margaux",Bordeaux,2005,20/05/2021,10127812005,1012781
480,22/06/2021,563,5,420,60,143,09/07/2019,"Chateau Batailley 5eme Cru Classe, Pauillac",Bordeaux,2003,23/06/2021,10063222003,1006322
400,22/06/2021,432,7,355,45,77,15/04/2021,"Chateau Batailley 5eme Cru Classe, Pauillac",Bordeaux,2012,23/06/2021,10063222012,1006322
860,19/05/2021,1019,73,940,-80,79,13/05/2021,"Tignanello, Toscana",Tuscany,2018,20/05/2021,10953912018,1095391
6552,19/05/2021,6552,0,3920,2632,2632,26/04/2017,"Domaine Leflaive, Chevalier-Montrachet Grand Cru",Burgundy,2006,20/05/2021,10734012006,1073401
3827,19/05/2021,4484,63,4116,-289,368,25/02/2021,"Chateau Margaux Premier Cru Classe, Margaux",Bordeaux,2004,20/05/2021,10127812004,1012781
3400,20/05/2021,3807,27,3202,198,605,19/05/2021,"Chateau Angelus Premier Grand Cru Classe B, Saint-Emilion Grand Cru",Bordeaux,2010,25/05/2021,10060452010,1006045
400,22/06/2021,432,7,355,45,77,15/04/2021,"Chateau Batailley 5eme Cru Classe, Pauillac",Bordeaux,2012,23/06/2021,10063222012,1006322
300,22/06/2021,302,104,304,-4,-2,10/01/2021,"Chateau Batailley 5eme Cru Classe, Pauillac",Bordeaux,2013,23/06/2021,10063222013,1006322
1408,19/05/2021,1445,5,1238,170,207,02/11/2020,"Tignanello, Toscana",Tuscany,2006,20/05/2021,10953912006,1095391
3400,20/05/2021,3661,51,3202,198,459,19/05/2021,"Chateau Angelus Premier Grand Cru Classe B, Saint-Emilion Grand Cru",Bordeaux,2010,26/05/2021,10060452010,1006045
5415,10/05/2021,5599,141,5150,265,449,03/05/2021,"Chateau Margaux Premier Cru Classe, Margaux",Bordeaux,2018,20/05/2021,10127812018,1012781
3400,20/05/2021,3797,28,3202,198,595,19/05/2021,"Chateau Angelus Premier Grand Cru Classe B, Saint-Emilion Grand Cru",Bordeaux,2010,22/05/2021,10060452010,1006045
7800,19/05/2021,8223,8,7000,800,1223,26/04/2021,"Domaine Leflaive, Chevalier-Montrachet Grand Cru",Burgundy,2018,20/05/2021,10734012018,1073401
840,14/05/2021,938,18,781,59,157,16/11/2020,"Chateau Calon Segur 3eme Cru Classe, Saint-Estephe",Bordeaux,2008,20/05/2021,10074752008,1007475
7906,13/05/2021,8122,2,7124,782,998,15/02/2019,"Domaine Leflaive, Chevalier-Montrachet Grand Cru",Burgundy,2016,20/05/2021,10734012016,1073401
3850,19/05/2021,4179,43,3560,290,619,20/11/2020,"Chateau Margaux Premier Cru Classe, Margaux",Bordeaux,2012,20/05/2021,10127812012,1012781
880,19/05/2021,986,13,725,155,261,13/04/2021,"Chateau Calon Segur 3eme Cru Classe, Saint-Estephe",Bordeaux,2007,20/05/2021,10074752007,1007475
12402,19/05/2021,12557,2,12850,-448,-293,30/11/2020,"Jacques-Frederic Mugnier, Chambolle-Musigny Premier Cru, Les Amoureuses",Burgundy,2011,20/05/2021,10496422011,1049642
16200,19/05/2021,16056,0,18750,-2550,-2694,29/08/2018,"Jacques-Frederic Mugnier, Chambolle-Musigny Premier Cru, Les Amoureuses",Burgundy,2015,20/05/2021,10496422015,1049642
1350,19/05/2021,1473,61,1260,90,213,18/02/2021,"Gaja, Barbaresco",Piedmont,2015,20/05/2021,10996052015,1099605
4400,12/05/2021,5014,9,4160,240,854,19/03/2021,"Chateau Margaux Premier Cru Classe, Margaux",Bordeaux,2019,20/05/2021,10127812019,1012781
3600,19/05/2021,4029,78,3690,-90,339,13/04/2021,"Chateau Margaux Premier Cru Classe, Margaux",Bordeaux,2011,20/05/2021,10127812011,1012781
520,19/05/2021,563,5,460,60,103,05/05/2020,"Tua Rita, Giusto di Notri, Toscana",Tuscany,2008,20/05/2021,11058072008,1105807
3740,19/05/2021,3974,49,3520,220,454,07/04/2021,"Chateau Margaux Premier Cru Classe, Margaux",Bordeaux,2013,20/05/2021,10127812013,1012781
10500,19/05/2021,12484,70,9844,656,2640,29/03/2021,"Chateau Margaux Premier Cru Classe, Margaux",Bordeaux,2015,20/05/2021,10127812015,1012781
660,19/05/2021,724,4,390,270,334,18/08/2017,"Tua Rita, Giusto di Notri, Toscana",Tuscany,2006,20/05/2021,11058072006,1105807
3400,20/05/2021,3661,51,3202,198,459,19/05/2021,"Chateau Angelus Premier Grand Cru Classe B, Saint-Emilion Grand Cru",Bordeaux,2010,26/05/2021,10060452010,1006045
476,22/06/2021,524,46,364,112,160,12/05/2021,"Chateau Batailley 5eme Cru Classe, Pauillac",Bordeaux,2016,23/06/2021,10063222016,1006322
1800,18/05/2021,1968,1,1768,32,200,22/05/2020,"Gaja, Barbaresco",Piedmont,2000,20/05/2021,10996052000,1099605
950,18/05/2021,1096,42,830,120,266,18/04/2021,"Tignanello, Toscana",Tuscany,2014,20/05/2021,10953912014,1095391
800,17/05/2021,933,118,814,-14,119,13/05/2021,"Tignanello, Toscana",Tuscany,2017,20/05/2021,10953912017,1095391
1020,18/05/2021,1198,62,950,70,248,03/05/2021,"Chateau Calon Segur 3eme Cru Classe, Saint-Estephe",Bordeaux,2018,20/05/2021,10074752018,1007475
750,18/05/2021,883,124,760,-10,123,17/05/2021,"Chateau Calon Segur 3eme Cru Classe, Saint-Estephe",Bordeaux,2017,20/05/2021,10074752017,1007475
1500,19/05/2021,1692,49,1408,92,284,09/04/2021,"Gaja, Barbaresco",Piedmont,2016,20/05/2021,10996052016,1099605
1120,13/05/2021,1348,9,1172,-52,176,07/04/2021,"Tignanello, Toscana",Tuscany,2010,20/05/2021,10953912010,1095391
8000,19/05/2021,8606,8,6974,1026,1632,14/03/2021,"Domaine Leflaive, Chevalier-Montrachet Grand Cru",Burgundy,2017,20/05/2021,10734012017,1073401
1024,19/05/2021,1132,12,1072,-48,60,20/01/2021,"Tignanello, Toscana",Tuscany,2009,20/05/2021,10953912009,1095391
530,23/06/2021,623,49,520,10,103,17/06/2021,"Chateau Batailley 5eme Cru Classe, Pauillac",Bordeaux,2005,24/06/2021,10063222005,1006322
1300,19/05/2021,1522,12,1300,0,222,28/09/2020,"Gaja, Barbaresco",Piedmont,2014,20/05/2021,10996052014,1099605
4400,19/05/2021,4860,27,4400,0,460,29/09/2020,"Chateau Margaux Premier Cru Classe, Margaux",Bordeaux,2001,20/05/2021,10127812001,1012781
530,23/06/2021,623,49,520,10,103,17/06/2021,"Chateau Batailley 5eme Cru Classe, Pauillac",Bordeaux,2005,24/06/2021,10063222005,1006322
9600,19/05/2021,9718,3,8000,1600,1718,30/01/2020,"Domaine Leflaive, Chevalier-Montrachet Grand Cru",Burgundy,2014,20/05/2021,10734012014,1073401
17000,19/05/2021,15189,7,13000,4000,2189,29/04/2021,"Jacques-Frederic Mugnier, Chambolle-Musigny Premier Cru, Les Amoureuses",Burgundy,2017,20/05/2021,10496422017,1049642
950,19/05/2021,1003,61,863,87,140,10/05/2021,"Chateau Calon Segur 3eme Cru Classe, Saint-Estephe",Bordeaux,2006,20/05/2021,10074752006,1007475
2872,19/05/2021,2872,2,2554,318,318,22/05/2020,"Gaja, Barbaresco",Piedmont,2006,20/05/2021,10996052006,1099605
1100,19/05/2021,1531,7,1010,90,521,18/12/2020,"Tignanello, Toscana",Tuscany,2008,20/05/2021,10953912008,1095391
4850,13/05/2021,5822,27,4842,8,980,19/05/2021,"Chateau Margaux Premier Cru Classe, Margaux",Bordeaux,2003,20/05/2021,10127812003,1012781
420,23/06/2021,521,5,400,20,121,11/05/2021,"Chateau Batailley 5eme Cru Classe, Pauillac",Bordeaux,2006,24/06/2021,10063222006,1006322
3900,19/05/2021,4527,29,3684,216,843,10/06/2020,"Chateau Margaux Premier Cru Classe, Margaux",Bordeaux,2002,20/05/2021,10127812002,1012781
2232,19/05/2021,2335,5,2190,42,145,01/05/2021,"Gaja, Barbaresco",Piedmont,2004,20/05/2021,10996052004,1099605
420,23/06/2021,521,5,400,20,121,11/05/2021,"Chateau Batailley 5eme Cru Classe, Pauillac",Bordeaux,2006,24/06/2021,10063222006,1006322
3400,20/05/2021,3806,27,3202,198,604,19/05/2021,"Chateau Angelus Premier Grand Cru Classe B, Saint-Emilion Grand Cru",Bordeaux,2010,23/05/2021,10060452010,1006045
600,19/05/2021,600,14,408,192,192,09/04/2019,"Tua Rita, Giusto di Notri, Toscana",Tuscany,2012,20/05/2021,11058072012,1105807
5580,18/05/2021,5728,81,5238,342,490,17/05/2021,"Chateau Margaux Premier Cru Classe, Margaux",Bordeaux,2016,20/05/2021,10127812016,1012781
3400,20/05/2021,3807,27,3202,198,605,19/05/2021,"Chateau Angelus Premier Grand Cru Classe B, Saint-Emilion Grand Cru",Bordeaux,2010,25/05/2021,10060452010,1006045
3400,13/05/2021,3806,27,3176,224,630,08/03/2021,"Chateau Angelus Premier Grand Cru Classe B, Saint-Emilion Grand Cru",Bordeaux,2010,19/05/2021,10060452010,1006045
1000,19/05/2021,1168,47,1047,-47,121,27/04/2021,"Chateau Calon Segur 3eme Cru Classe, Saint-Estephe",Bordeaux,2009,20/05/2021,10074752009,1007475
3400,13/05/2021,3806,27,3202,198,604,19/05/2021,"Chateau Angelus Premier Grand Cru Classe B, Saint-Emilion Grand Cru",Bordeaux,2010,20/05/2021,10060452010,1006045
1280,19/05/2021,1338,6,1200,80,138,06/03/2021,"Tignanello, Toscana",Tuscany,2007,20/05/2021,10953912007,1095391
6650,18/05/2021,7639,41,6500,150,1139,12/05/2021,"Chateau Margaux Premier Cru Classe, Margaux",Bordeaux,2009,20/05/2021,10127812009,1012781
525,23/06/2021,596,397,494,31,102,20/04/2021,"Chateau Batailley 5eme Cru Classe, Pauillac",Bordeaux,2010,24/06/2021,10063222010,1006322
3400,13/05/2021,3806,27,3176,224,630,08/03/2021,"Chateau Angelus Premier Grand Cru Classe B, Saint-Emilion Grand Cru",Bordeaux,2010,19/05/2021,10060452010,1006045
709,13/05/2021,837,11,682,27,155,15/09/2020,"Chateau Calon Segur 3eme Cru Classe, Saint-Estephe",Bordeaux,2013,20/05/2021,10074752013,1007475
840,18/05/2021,1084,97,860,-20,224,19/04/2021,"Chateau Calon Segur 3eme Cru Classe, Saint-Estephe",Bordeaux,2015,20/05/2021,10074752015,1007475
7812,19/05/2021,7812,0,8540,-728,-728,02/12/2019,"Domaine Leflaive, Chevalier-Montrachet Grand Cru",Burgundy,2001,20/05/2021,10734012001,1073401
1350,19/05/2021,1449,7,1352,-2,97,23/09/2020,"Gaja, Barbaresco",Piedmont,2011,20/05/2021,10996052011,1099605
504,19/05/2021,522,1,300,204,222,03/11/2011,"Tua Rita, Giusto di Notri, Toscana",Tuscany,2007,20/05/2021,11058072007,1105807
3400,13/05/2021,3806,27,3202,198,604,19/05/2021,"Chateau Angelus Premier Grand Cru Classe B, Saint-Emilion Grand Cru",Bordeaux,2010,20/05/2021,10060452010,1006045
1010,18/05/2021,1046,10,860,150,186,08/03/2021,"Tignanello, Toscana",Tuscany,2011,20/05/2021,10953912011,1095391
3560,19/05/2021,4088,30,3592,-32,496,06/05/2021,"Chateau Margaux Premier Cru Classe, Margaux",Bordeaux,2007,20/05/2021,10127812007,1012781
1200,19/05/2021,1148,123,1124,76,24,19/05/2021,"Tignanello, Toscana",Tuscany,2016,20/05/2021,10953912016,1095391
3702,19/05/2021,3684,2,1200,2502,2484,16/05/2012,"Gaja, Barbaresco",Piedmont,2001,20/05/2021,10996052001,1099605
525,23/06/2021,596,397,494,31,102,20/04/2021,"Chateau Batailley 5eme Cru Classe, Pauillac",Bordeaux,2010,24/06/2021,10063222010,1006322
400,23/06/2021,432,7,355,45,77,15/04/2021,"Chateau Batailley 5eme Cru Classe, Pauillac",Bordeaux,2012,24/06/2021,10063222012,1006322
400,23/06/2021,432,7,355,45,77,15/04/2021,"Chateau Batailley 5eme Cru Classe, Pauillac",Bordeaux,2012,24/06/2021,10063222012,1006322
3860,19/05/2021,4751,72,3800,60,951,07/04/2021,"Chateau Margaux Premier Cru Classe, Margaux",Bordeaux,2006,20/05/2021,10127812006,1012781
900,19/05/2021,1092,30,800,100,292,21/11/2019,"Chateau Calon Segur 3eme Cru Classe, Saint-Estephe",Bordeaux,2003,20/05/2021,10074752003,1007475
540,19/05/2021,546,3,544,-4,2,18/09/2020,"Tua Rita, Giusto di Notri, Toscana",Tuscany,2013,20/05/2021,11058072013,1105807
750,19/05/2021,1025,48,790,-40,235,01/06/2020,"Chateau Calon Segur 3eme Cru Classe, Saint-Estephe",Bordeaux,2011,20/05/2021,10074752011,1007475
3720,19/05/2021,4102,51,3480,240,622,10/04/2021,"Chateau Margaux Premier Cru Classe, Margaux",Bordeaux,2014,20/05/2021,10127812014,1012781
790,18/05/2021,967,18,745,45,222,16/11/2020,"Chateau Calon Segur 3eme Cru Classe, Saint-Estephe",Bordeaux,2004,20/05/2021,10074752004,1007475
3390,04/05/2021,3827,28,3176,214,651,08/03/2021,"Chateau Angelus Premier Grand Cru Classe B, Saint-Emilion Grand Cru",Bordeaux,2010,08/05/2021,10060452010,1006045
1000,19/05/2021,1164,85,975,25,189,12/04/2021,"Chateau Calon Segur 3eme Cru Classe, Saint-Estephe",Bordeaux,2005,20/05/2021,10074752005,1007475
3390,04/05/2021,3838,26,3176,214,662,08/03/2021,"Chateau Angelus Premier Grand Cru Classe B, Saint-Emilion Grand Cru",Bordeaux,2010,12/05/2021,10060452010,1006045
995,04/08/2021,1113,18,993,2,120,27/07/2021,"Chateau Calon Segur 3eme Cru Classe, Saint-Estephe",Bordeaux,2010,05/08/2021,10074752010,1007475
3800,04/08/2021,4349,127,3600,200,749,02/08/2021,"Chateau Margaux Premier Cru Classe, Margaux",Bordeaux,2014,05/08/2021,10127812014,1012781
300,23/06/2021,302,104,304,-4,-2,10/01/2021,"Chateau Batailley 5eme Cru Classe, Pauillac",Bordeaux,2013,24/06/2021,10063222013,1006322
3800,04/08/2021,4532,56,3525,275,1007,18/06/2021,"Chateau Margaux Premier Cru Classe, Margaux",Bordeaux,2007,05/08/2021,10127812007,1012781
990,03/08/2021,1119,10,880,110,239,22/06/2021,"Tignanello, Toscana",Tuscany,2011,04/08/2021,10953912011,1095391
3390,04/05/2021,3806,28,3176,214,630,08/03/2021,"Chateau Angelus Premier Grand Cru Classe B, Saint-Emilion Grand Cru",Bordeaux,2010,14/05/2021,10060452010,1006045
6930,05/08/2021,7720,70,7086,-156,634,11/06/2021,"Chateau Margaux Premier Cru Classe, Margaux",Bordeaux,2009,06/08/2021,10127812009,1012781
3850,21/05/2021,4177,44,3560,290,617,20/11/2020,"Chateau Margaux Premier Cru Classe, Margaux",Bordeaux,2012,22/05/2021,10127812012,1012781
1050,21/05/2021,1155,61,1048,2,107,27/04/2021,"Chateau Calon Segur 3eme Cru Classe, Saint-Estephe",Bordeaux,2016,22/05/2021,10074752016,1007475
880,21/05/2021,986,13,725,155,261,13/04/2021,"Chateau Calon Segur 3eme Cru Classe, Saint-Estephe",Bordeaux,2007,22/05/2021,10074752007,1007475
3390,04/05/2021,3807,27,3176,214,631,08/03/2021,"Chateau Angelus Premier Grand Cru Classe B, Saint-Emilion Grand Cru",Bordeaux,2010,16/05/2021,10060452010,1006045
12402,21/05/2021,12601,2,12850,-448,-249,30/11/2020,"Jacques-Frederic Mugnier, Chambolle-Musigny Premier Cru, Les Amoureuses",Burgundy,2011,22/05/2021,10496422011,1049642
1024,19/05/2021,1178,11,1072,-48,106,20/01/2021,"Tignanello, Toscana",Tuscany,2009,22/05/2021,10953912009,1095391
4400,21/05/2021,4861,28,4400,0,461,29/09/2020,"Chateau Margaux Premier Cru Classe, Margaux",Bordeaux,2001,22/05/2021,10127812001,1012781
2872,21/05/2021,2872,1,2554,318,318,22/05/2020,"Gaja, Barbaresco",Piedmont,2006,22/05/2021,10996052006,1099605
3860,19/05/2021,4720,77,3800,60,920,07/04/2021,"Chateau Margaux Premier Cru Classe, Margaux",Bordeaux,2006,22/05/2021,10127812006,1012781
3740,21/05/2021,3969,50,3520,220,449,07/04/2021,"Chateau Margaux Premier Cru Classe, Margaux",Bordeaux,2013,22/05/2021,10127812013,1012781
840,21/05/2021,938,18,781,59,157,16/11/2020,"Chateau Calon Segur 3eme Cru Classe, Saint-Estephe",Bordeaux,2008,22/05/2021,10074752008,1007475
476,23/06/2021,525,45,364,112,161,12/05/2021,"Chateau Batailley 5eme Cru Classe, Pauillac",Bordeaux,2016,24/06/2021,10063222016,1006322
9600,19/05/2021,9884,2,8000,1600,1884,30/01/2020,"Domaine Leflaive, Chevalier-Montrachet Grand Cru",Burgundy,2014,22/05/2021,10734012014,1073401
504,21/05/2021,522,1,300,204,222,03/11/2011,"Tua Rita, Giusto di Notri, Toscana",Tuscany,2007,22/05/2021,11058072007,1105807
405,23/06/2021,418,19,357,48,61,06/05/2021,"Chateau Batailley 5eme Cru Classe, Pauillac",Bordeaux,2018,24/06/2021,10063222018,1006322
7800,21/05/2021,8198,8,7000,800,1198,26/04/2021,"Domaine Leflaive, Chevalier-Montrachet Grand Cru",Burgundy,2018,22/05/2021,10734012018,1073401
3700,21/05/2021,4071,131,3700,0,371,06/05/2021,"Chateau Margaux Premier Cru Classe, Margaux",Bordeaux,2017,22/05/2021,10127812017,1012781
750,18/05/2021,883,124,740,10,143,21/05/2021,"Chateau Calon Segur 3eme Cru Classe, Saint-Estephe",Bordeaux,2017,22/05/2021,10074752017,1007475
2232,21/05/2021,2343,5,2190,42,153,01/05/2021,"Gaja, Barbaresco",Piedmont,2004,22/05/2021,10996052004,1099605
1000,21/05/2021,1168,47,1047,-47,121,27/04/2021,"Chateau Calon Segur 3eme Cru Classe, Saint-Estephe",Bordeaux,2009,22/05/2021,10074752009,1007475
5415,10/05/2021,5598,143,5150,265,448,03/05/2021,"Chateau Margaux Premier Cru Classe, Margaux",Bordeaux,2018,22/05/2021,10127812018,1012781
6300,21/05/2021,7485,60,5922,378,1563,13/04/2021,"Chateau Margaux Premier Cru Classe, Margaux",Bordeaux,2010,22/05/2021,10127812010,1012781
3390,04/05/2021,3807,27,3176,214,631,08/03/2021,"Chateau Angelus Premier Grand Cru Classe B, Saint-Emilion Grand Cru",Bordeaux,2010,16/05/2021,10060452010,1006045
3390,04/05/2021,3828,27,3176,214,652,08/03/2021,"Chateau Angelus Premier Grand Cru Classe B, Saint-Emilion Grand Cru",Bordeaux,2010,10/05/2021,10060452010,1006045
1020,21/05/2021,1048,10,860,160,188,08/03/2021,"Tignanello, Toscana",Tuscany,2011,22/05/2021,10953912011,1095391
1480,13/05/2021,1625,74,1358,122,267,12/05/2021,"Gaja, Barbaresco",Piedmont,2017,22/05/2021,10996052017,1099605
950,21/05/2021,1003,61,863,87,140,10/05/2021,"Chateau Calon Segur 3eme Cru Classe, Saint-Estephe",Bordeaux,2006,22/05/2021,10074752006,1007475
3390,04/05/2021,3837,26,3176,214,661,08/03/2021,"Chateau Angelus Premier Grand Cru Classe B, Saint-Emilion Grand Cru",Bordeaux,2010,11/05/2021,10060452010,1006045
550,24/06/2021,547,6,420,130,127,09/07/2019,"Chateau Batailley 5eme Cru Classe, Pauillac",Bordeaux,2003,03/07/2021,10063222003,1006322
3900,19/05/2021,4518,30,3684,216,834,10/06/2020,"Chateau Margaux Premier Cru Classe, Margaux",Bordeaux,2002,22/05/2021,10127812002,1012781
768,21/05/2021,926,13,705,63,221,01/02/2021,"Chateau Calon Segur 3eme Cru Classe, Saint-Estephe",Bordeaux,2002,22/05/2021,10074752002,1007475
6650,20/05/2021,7645,42,6980,-330,665,21/05/2021,"Chateau Margaux Premier Cru Classe, Margaux",Bordeaux,2009,22/05/2021,10127812009,1012781
460,21/05/2021,486,149,420,40,66,23/03/2021,"Tua Rita, Giusto di Notri, Toscana",Tuscany,2016,22/05/2021,11058072016,1105807
16200,21/05/2021,16056,0,18750,-2550,-2694,29/08/2018,"Jacques-Frederic Mugnier, Chambolle-Musigny Premier Cru, Les Amoureuses",Burgundy,2015,22/05/2021,10496422015,1049642
3390,04/05/2021,3838,26,3176,214,662,08/03/2021,"Chateau Angelus Premier Grand Cru Classe B, Saint-Emilion Grand Cru",Bordeaux,2010,12/05/2021,10060452010,1006045
600,24/06/2021,556,2,300,300,256,15/12/2019,"Chateau Batailley 5eme Cru Classe, Pauillac",Bordeaux,2004,30/06/2021,10063222004,1006322
8000,21/05/2021,8613,7,6974,1026,1639,14/03/2021,"Domaine Leflaive, Chevalier-Montrachet Grand Cru",Burgundy,2017,22/05/2021,10734012017,1073401
5580,20/05/2021,5722,87,5238,342,484,17/05/2021,"Chateau Margaux Premier Cru Classe, Margaux",Bordeaux,2016,22/05/2021,10127812016,1012781
1800,21/05/2021,1968,1,1768,32,200,22/05/2020,"Gaja, Barbaresco",Piedmont,2000,22/05/2021,10996052000,1099605
3720,21/05/2021,4099,53,3480,240,619,10/04/2021,"Chateau Margaux Premier Cru Classe, Margaux",Bordeaux,2014,22/05/2021,10127812014,1012781
3390,04/05/2021,3806,28,3176,214,630,08/03/2021,"Chateau Angelus Premier Grand Cru Classe B, Saint-Emilion Grand Cru",Bordeaux,2010,14/05/2021,10060452010,1006045
8016,21/05/2021,9840,3,7290,726,2550,21/08/2020,"Domaine Denis Mortet, Chambertin Grand Cru",Burgundy,2017,22/05/2021,10490202017,1049020
540,19/05/2021,546,2,544,-4,2,18/09/2020,"Tua Rita, Giusto di Notri, Toscana",Tuscany,2013,22/05/2021,11058072013,1105807
1500,21/05/2021,1693,49,1408,92,285,09/04/2021,"Gaja, Barbaresco",Piedmont,2016,22/05/2021,10996052016,1099605
3390,04/05/2021,3810,29,3176,214,634,08/03/2021,"Chateau Angelus Premier Grand Cru Classe B, Saint-Emilion Grand Cru",Bordeaux,2010,05/05/2021,10060452010,1006045
8040,21/05/2021,8385,22,7950,90,435,12/03/2021,"Chateau Margaux Premier Cru Classe, Margaux",Bordeaux,2000,22/05/2021,10127812000,1012781
400,24/06/2021,445,5,300,100,145,05/11/2020,"Chateau Batailley 5eme Cru Classe, Pauillac",Bordeaux,2011,04/07/2021,10063222011,1006322
1200,20/05/2021,1257,39,1124,76,133,19/05/2021,"Tignanello, Toscana",Tuscany,2016,22/05/2021,10953912016,1095391
8240,12/05/2021,8933,1,5960,2280,2973,01/08/2017,"Domaine Leflaive, Chevalier-Montrachet Grand Cru",Burgundy,2010,22/05/2021,10734012010,1073401
1244,20/05/2021,1523,3,882,362,641,26/04/2019,"Tignanello, Toscana",Tuscany,2003,22/05/2021,10953912003,1095391
12456,17/05/2021,14387,1,12000,456,2387,28/05/2020,"Jacques-Frederic Mugnier, Chambolle-Musigny Premier Cru, Les Amoureuses",Burgundy,2014,22/05/2021,10496422014,1049642
750,19/05/2021,1016,53,790,-40,226,01/06/2020,"Chateau Calon Segur 3eme Cru Classe, Saint-Estephe",Bordeaux,2011,22/05/2021,10074752011,1007475
1280,21/05/2021,1328,6,1200,80,128,06/03/2021,"Tignanello, Toscana",Tuscany,2007,22/05/2021,10953912007,1095391
6552,21/05/2021,6552,0,3920,2632,2632,26/04/2017,"Domaine Leflaive, Chevalier-Montrachet Grand Cru",Burgundy,2006,22/05/2021,10734012006,1073401
400,24/06/2021,437,6,300,100,137,05/11/2020,"Chateau Batailley 5eme Cru Classe, Pauillac",Bordeaux,2011,02/07/2021,10063222011,1006322
790,20/05/2021,933,38,794,-4,139,20/04/2021,"Chateau Calon Segur 3eme Cru Classe, Saint-Estephe",Bordeaux,2014,22/05/2021,10074752014,1007475
1020,18/05/2021,1201,55,950,70,251,03/05/2021,"Chateau Calon Segur 3eme Cru Classe, Saint-Estephe",Bordeaux,2018,22/05/2021,10074752018,1007475
790,18/05/2021,969,22,745,45,224,16/11/2020,"Chateau Calon Segur 3eme Cru Classe, Saint-Estephe",Bordeaux,2004,22/05/2021,10074752004,1007475
420,21/05/2021,462,10,342,78,120,21/08/2020,"Tua Rita, Giusto di Notri, Toscana",Tuscany,2011,22/05/2021,11058072011,1105807
1280,21/05/2021,1353,8,1172,108,181,07/04/2021,"Tignanello, Toscana",Tuscany,2010,22/05/2021,10953912010,1095391
900,21/05/2021,1188,16,850,50,338,28/01/2021,"Tignanello, Toscana",Tuscany,2012,22/05/2021,10953912012,1095391
3390,04/05/2021,3827,28,3176,214,651,08/03/2021,"Chateau Angelus Premier Grand Cru Classe B, Saint-Emilion Grand Cru",Bordeaux,2010,08/05/2021,10060452010,1006045
3390,04/05/2021,3810,29,3176,214,634,08/03/2021,"Chateau Angelus Premier Grand Cru Classe B, Saint-Emilion Grand Cru",Bordeaux,2010,05/05/2021,10060452010,1006045
1100,21/05/2021,1513,7,1010,90,503,18/12/2020,"Tignanello, Toscana",Tuscany,2008,22/05/2021,10953912008,1095391
3758,21/05/2021,4037,83,3690,68,347,13/04/2021,"Chateau Margaux Premier Cru Classe, Margaux",Bordeaux,2011,22/05/2021,10127812011,1012781
400,24/06/2021,439,5,300,100,139,05/11/2020,"Chateau Batailley 5eme Cru Classe, Pauillac",Bordeaux,2011,25/06/2021,10063222011,1006322
3390,04/05/2021,3828,27,3176,214,652,08/03/2021,"Chateau Angelus Premier Grand Cru Classe B, Saint-Emilion Grand Cru",Bordeaux,2010,10/05/2021,10060452010,1006045
10500,21/05/2021,12480,71,9844,656,2636,29/03/2021,"Chateau Margaux Premier Cru Classe, Margaux",Bordeaux,2015,22/05/2021,10127812015,1012781
400,24/06/2021,439,5,300,100,139,05/11/2020,"Chateau Batailley 5eme Cru Classe, Pauillac",Bordeaux,2011,25/06/2021,10063222011,1006322
3920,21/05/2021,4436,94,3800,120,636,12/05/2021,"Chateau Margaux Premier Cru Classe, Margaux",Bordeaux,2008,22/05/2021,10127812008,1012781
790,20/05/2021,946,130,814,-24,132,13/05/2021,"Tignanello, Toscana",Tuscany,2017,22/05/2021,10953912017,1095391
400,24/06/2021,437,6,300,100,137,05/11/2020,"Chateau Batailley 5eme Cru Classe, Pauillac",Bordeaux,2011,02/07/2021,10063222011,1006322
1408,20/05/2021,1446,2,1150,258,296,21/04/2019,"Tignanello, Toscana",Tuscany,2005,22/05/2021,10953912005,1095391
3390,04/05/2021,3837,26,3176,214,661,08/03/2021,"Chateau Angelus Premier Grand Cru Classe B, Saint-Emilion Grand Cru",Bordeaux,2010,11/05/2021,10060452010,1006045
1408,20/05/2021,1405,4,1238,170,167,02/11/2020,"Tignanello, Toscana",Tuscany,2006,22/05/2021,10953912006,1095391
3420,03/05/2021,3658,38,3176,244,482,08/03/2021,"Chateau Angelus Premier Grand Cru Classe B, Saint-Emilion Grand Cru",Bordeaux,2010,04/05/2021,10060452010,1006045
520,21/05/2021,563,5,460,60,103,05/05/2020,"Tua Rita, Giusto di Notri, Toscana",Tuscany,2008,22/05/2021,11058072008,1105807
1350,21/05/2021,1449,7,1352,-2,97,23/09/2020,"Gaja, Barbaresco",Piedmont,2011,22/05/2021,10996052011,1099605
400,24/06/2021,445,5,300,100,145,05/11/2020,"Chateau Batailley 5eme Cru Classe, Pauillac",Bordeaux,2011,04/07/2021,10063222011,1006322
1000,21/05/2021,1162,86,975,25,187,12/04/2021,"Chateau Calon Segur 3eme Cru Classe, Saint-Estephe",Bordeaux,2005,22/05/2021,10074752005,1007475
6250,20/05/2021,7005,42,6300,-50,705,21/05/2021,"Chateau Margaux Premier Cru Classe, Margaux",Bordeaux,2005,22/05/2021,10127812005,1012781
3827,21/05/2021,4485,64,4116,-289,369,25/02/2021,"Chateau Margaux Premier Cru Classe, Margaux",Bordeaux,2004,22/05/2021,10127812004,1012781
1800,21/05/2021,1703,2,1440,360,263,04/01/2018,"Gaja, Barbaresco",Piedmont,2010,22/05/2021,10996052010,1099605
1050,20/05/2021,1137,7,860,190,277,08/03/2021,"Tignanello, Toscana",Tuscany,2013,22/05/2021,10953912013,1095391
907,21/05/2021,1051,39,805,102,246,20/11/2019,"Chateau Calon Segur 3eme Cru Classe, Saint-Estephe",Bordeaux,2001,22/05/2021,10074752001,1007475
1176,21/05/2021,1330,1,996,180,334,14/06/2019,"Tignanello, Toscana",Tuscany,2000,22/05/2021,10953912000,1095391
995,21/05/2021,1124,23,1000,-5,124,12/04/2021,"Chateau Calon Segur 3eme Cru Classe, Saint-Estephe",Bordeaux,2010,22/05/2021,10074752010,1007475
1700,20/05/2021,1653,3,1378,322,275,29/07/2020,"Tignanello, Toscana",Tuscany,2001,22/05/2021,10953912001,1095391
1678,20/05/2021,1661,4,1180,498,481,25/06/2020,"Tignanello, Toscana",Tuscany,2004,22/05/2021,10953912004,1095391
660,21/05/2021,724,4,390,270,334,18/08/2017,"Tua Rita, Giusto di Notri, Toscana",Tuscany,2006,22/05/2021,11058072006,1105807
400,24/06/2021,432,7,355,45,77,15/04/2021,"Chateau Batailley 5eme Cru Classe, Pauillac",Bordeaux,2012,25/06/2021,10063222012,1006322
3420,03/05/2021,3658,38,3176,244,482,08/03/2021,"Chateau Angelus Premier Grand Cru Classe B, Saint-Emilion Grand Cru",Bordeaux,2010,04/05/2021,10060452010,1006045
4850,20/05/2021,5873,26,4842,8,1031,19/05/2021,"Chateau Margaux Premier Cru Classe, Margaux",Bordeaux,2003,22/05/2021,10127812003,1012781
900,25/05/2021,1024,69,940,-40,84,13/05/2021,"Tignanello, Toscana",Tuscany,2018,26/05/2021,10953912018,1095391
995,25/05/2021,1115,22,1000,-5,115,12/04/2021,"Chateau Calon Segur 3eme Cru Classe, Saint-Estephe",Bordeaux,2010,26/05/2021,10074752010,1007475
1020,18/05/2021,1199,55,950,70,249,03/05/2021,"Chateau Calon Segur 3eme Cru Classe, Saint-Estephe",Bordeaux,2018,26/05/2021,10074752018,1007475
1280,25/05/2021,1328,6,1200,80,128,06/03/2021,"Tignanello, Toscana",Tuscany,2007,26/05/2021,10953912007,1095391
1280,25/05/2021,1367,8,1172,108,195,07/04/2021,"Tignanello, Toscana",Tuscany,2010,26/05/2021,10953912010,1095391
2590,09/08/2021,2924,151,2000,590,924,03/02/2020,"Chateau Angelus Premier Grand Cru Classe B, Saint-Emilion Grand Cru",Bordeaux,2011,10/08/2021,10060452011,1006045
3702,19/05/2021,3662,2,1200,2502,2462,16/05/2012,"Gaja, Barbaresco",Piedmont,2001,26/05/2021,10996052001,1099605
400,24/06/2021,432,7,355,45,77,15/04/2021,"Chateau Batailley 5eme Cru Classe, Pauillac",Bordeaux,2012,25/06/2021,10063222012,1006322
3800,25/05/2021,4045,78,3690,110,355,13/04/2021,"Chateau Margaux Premier Cru Classe, Margaux",Bordeaux,2011,26/05/2021,10127812011,1012781
8000,25/05/2021,8643,7,6974,1026,1669,14/03/2021,"Domaine Leflaive, Chevalier-Montrachet Grand Cru",Burgundy,2017,26/05/2021,10734012017,1073401
790,24/05/2021,944,135,814,-24,130,13/05/2021,"Tignanello, Toscana",Tuscany,2017,26/05/2021,10953912017,1095391
2590,09/08/2021,2924,151,2000,590,924,03/02/2020,"Chateau Angelus Premier Grand Cru Classe B, Saint-Emilion Grand Cru",Bordeaux,2011,10/08/2021,10060452011,1006045
300,24/06/2021,302,104,304,-4,-2,10/01/2021,"Chateau Batailley 5eme Cru Classe, Pauillac",Bordeaux,2013,25/06/2021,10063222013,1006322
6300,25/05/2021,7514,59,6190,110,1324,23/05/2021,"Chateau Margaux Premier Cru Classe, Margaux",Bordeaux,2010,26/05/2021,10127812010,1012781
359,24/06/2021,368,89,324,35,44,09/06/2021,"Chateau Batailley 5eme Cru Classe, Pauillac",Bordeaux,2014,25/06/2021,10063222014,1006322
476,24/06/2021,525,45,364,112,161,12/05/2021,"Chateau Batailley 5eme Cru Classe, Pauillac",Bordeaux,2016,25/06/2021,10063222016,1006322
1020,25/05/2021,1048,10,860,160,188,08/03/2021,"Tignanello, Toscana",Tuscany,2011,26/05/2021,10953912011,1095391
2580,06/08/2021,2928,163,2000,580,928,03/02/2020,"Chateau Angelus Premier Grand Cru Classe B, Saint-Emilion Grand Cru",Bordeaux,2011,07/08/2021,10060452011,1006045
2580,06/08/2021,2924,151,2000,580,924,03/02/2020,"Chateau Angelus Premier Grand Cru Classe B, Saint-Emilion Grand Cru",Bordeaux,2011,09/08/2021,10060452011,1006045
2580,06/08/2021,2928,163,2000,580,928,03/02/2020,"Chateau Angelus Premier Grand Cru Classe B, Saint-Emilion Grand Cru",Bordeaux,2011,07/08/2021,10060452011,1006045
6250,25/05/2021,7073,39,6360,-110,713,24/05/2021,"Chateau Margaux Premier Cru Classe, Margaux",Bordeaux,2005,26/05/2021,10127812005,1012781
4850,20/05/2021,5806,27,4842,8,964,19/05/2021,"Chateau Margaux Premier Cru Classe, Margaux",Bordeaux,2003,26/05/2021,10127812003,1012781
900,25/05/2021,1092,30,800,100,292,21/11/2019,"Chateau Calon Segur 3eme Cru Classe, Saint-Estephe",Bordeaux,2003,26/05/2021,10074752003,1007475
2580,06/08/2021,2924,151,2000,580,924,03/02/2020,"Chateau Angelus Premier Grand Cru Classe B, Saint-Emilion Grand Cru",Bordeaux,2011,09/08/2021,10060452011,1006045
2580,05/08/2021,2928,163,2000,580,928,03/02/2020,"Chateau Angelus Premier Grand Cru Classe B, Saint-Emilion Grand Cru",Bordeaux,2011,06/08/2021,10060452011,1006045
8100,24/05/2021,8359,18,7950,150,409,12/03/2021,"Chateau Margaux Premier Cru Classe, Margaux",Bordeaux,2000,26/05/2021,10127812000,1012781
2580,05/08/2021,2928,163,2000,580,928,03/02/2020,"Chateau Angelus Premier Grand Cru Classe B, Saint-Emilion Grand Cru",Bordeaux,2011,06/08/2021,10060452011,1006045
2872,25/05/2021,2872,1,2554,318,318,22/05/2020,"Gaja, Barbaresco",Piedmont,2006,26/05/2021,10996052006,1099605
2580,04/08/2021,2929,159,2000,580,929,03/02/2020,"Chateau Angelus Premier Grand Cru Classe B, Saint-Emilion Grand Cru",Bordeaux,2011,05/08/2021,10060452011,1006045
2580,04/08/2021,2929,159,2000,580,929,03/02/2020,"Chateau Angelus Premier Grand Cru Classe B, Saint-Emilion Grand Cru",Bordeaux,2011,05/08/2021,10060452011,1006045
880,25/05/2021,986,13,725,155,261,13/04/2021,"Chateau Calon Segur 3eme Cru Classe, Saint-Estephe",Bordeaux,2007,26/05/2021,10074752007,1007475
2580,03/08/2021,2929,159,2000,580,929,03/02/2020,"Chateau Angelus Premier Grand Cru Classe B, Saint-Emilion Grand Cru",Bordeaux,2011,03/08/2021,10060452011,1006045
2580,03/08/2021,2929,159,2000,580,929,03/02/2020,"Chateau Angelus Premier Grand Cru Classe B, Saint-Emilion Grand Cru",Bordeaux,2011,04/08/2021,10060452011,1006045
16200,25/05/2021,16056,0,18750,-2550,-2694,29/08/2018,"Jacques-Frederic Mugnier, Chambolle-Musigny Premier Cru, Les Amoureuses",Burgundy,2015,26/05/2021,10496422015,1049642
420,25/06/2021,427,4,220,200,207,17/06/2015,"Chateau Batailley 5eme Cru Classe, Pauillac",Bordeaux,2002,26/06/2021,10063222002,1006322
660,25/05/2021,724,4,390,270,334,18/08/2017,"Tua Rita, Giusto di Notri, Toscana",Tuscany,2006,26/05/2021,11058072006,1105807
460,25/05/2021,486,149,420,40,66,23/03/2021,"Tua Rita, Giusto di Notri, Toscana",Tuscany,2016,26/05/2021,11058072016,1105807
1350,25/05/2021,1432,7,1352,-2,80,23/09/2020,"Gaja, Barbaresco",Piedmont,2011,26/05/2021,10996052011,1099605
530,25/06/2021,623,49,520,10,103,17/06/2021,"Chateau Batailley 5eme Cru Classe, Pauillac",Bordeaux,2005,26/06/2021,10063222005,1006322
1000,25/05/2021,1156,96,1000,0,156,25/05/2021,"Chateau Calon Segur 3eme Cru Classe, Saint-Estephe",Bordeaux,2005,26/05/2021,10074752005,1007475
7800,25/05/2021,8198,8,7000,800,1198,26/04/2021,"Domaine Leflaive, Chevalier-Montrachet Grand Cru",Burgundy,2018,26/05/2021,10734012018,1073401
950,25/05/2021,1003,58,863,87,140,10/05/2021,"Chateau Calon Segur 3eme Cru Classe, Saint-Estephe",Bordeaux,2006,26/05/2021,10074752006,1007475
4400,25/05/2021,4862,22,4400,0,462,29/09/2020,"Chateau Margaux Premier Cru Classe, Margaux",Bordeaux,2001,26/05/2021,10127812001,1012781
1024,25/05/2021,1178,11,1072,-48,106,20/01/2021,"Tignanello, Toscana",Tuscany,2009,26/05/2021,10953912009,1095391
3900,25/05/2021,4517,30,3684,216,833,10/06/2020,"Chateau Margaux Premier Cru Classe, Margaux",Bordeaux,2002,26/05/2021,10127812002,1012781
750,25/05/2021,1016,51,790,-40,226,01/06/2020,"Chateau Calon Segur 3eme Cru Classe, Saint-Estephe",Bordeaux,2011,26/05/2021,10074752011,1007475
3750,25/05/2021,4099,30,3592,158,507,06/05/2021,"Chateau Margaux Premier Cru Classe, Margaux",Bordeaux,2007,26/05/2021,10127812007,1012781
1500,25/05/2021,1687,49,1408,92,279,09/04/2021,"Gaja, Barbaresco",Piedmont,2016,26/05/2021,10996052016,1099605
2580,02/08/2021,2931,161,2000,580,931,03/02/2020,"Chateau Angelus Premier Grand Cru Classe B, Saint-Emilion Grand Cru",Bordeaux,2011,03/08/2021,10060452011,1006045
2232,25/05/2021,2351,5,2190,42,161,01/05/2021,"Gaja, Barbaresco",Piedmont,2004,26/05/2021,10996052004,1099605
1050,25/05/2021,1158,58,1034,16,124,25/05/2021,"Chateau Calon Segur 3eme Cru Classe, Saint-Estephe",Bordeaux,2016,26/05/2021,10074752016,1007475
885,25/05/2021,938,18,781,104,157,16/11/2020,"Chateau Calon Segur 3eme Cru Classe, Saint-Estephe",Bordeaux,2008,26/05/2021,10074752008,1007475
10500,25/05/2021,12622,64,9844,656,2778,29/03/2021,"Chateau Margaux Premier Cru Classe, Margaux",Bordeaux,2015,26/05/2021,10127812015,1012781
1000,24/05/2021,1158,42,1030,-30,128,25/05/2021,"Chateau Calon Segur 3eme Cru Classe, Saint-Estephe",Bordeaux,2009,26/05/2021,10074752009,1007475
6750,25/05/2021,7647,42,6525,225,1122,23/05/2021,"Chateau Margaux Premier Cru Classe, Margaux",Bordeaux,2009,26/05/2021,10127812009,1012781
1596,25/05/2021,1596,0,1300,296,296,27/04/2021,"Gaja, Barbaresco",Piedmont,2012,26/05/2021,10996052012,1099605
500,25/05/2021,537,33,320,180,217,24/03/2021,"Tua Rita, Giusto di Notri, Toscana",Tuscany,2017,26/05/2021,11058072017,1105807
3740,25/05/2021,3967,45,3520,220,447,07/04/2021,"Chateau Margaux Premier Cru Classe, Margaux",Bordeaux,2013,26/05/2021,10127812013,1012781
530,25/06/2021,622,49,520,10,102,17/06/2021,"Chateau Batailley 5eme Cru Classe, Pauillac",Bordeaux,2005,27/06/2021,10063222005,1006322
520,25/05/2021,563,5,460,60,103,05/05/2020,"Tua Rita, Giusto di Notri, Toscana",Tuscany,2008,26/05/2021,11058072008,1105807
2580,02/08/2021,2931,161,2000,580,931,03/02/2020,"Chateau Angelus Premier Grand Cru Classe B, Saint-Emilion Grand Cru",Bordeaux,2011,03/08/2021,10060452011,1006045
1480,24/05/2021,1573,123,1358,122,215,12/05/2021,"Gaja, Barbaresco",Piedmont,2017,26/05/2021,10996052017,1099605
530,25/06/2021,623,49,520,10,103,17/06/2021,"Chateau Batailley 5eme Cru Classe, Pauillac",Bordeaux,2005,26/06/2021,10063222005,1006322
5580,24/05/2021,5674,69,5238,342,436,17/05/2021,"Chateau Margaux Premier Cru Classe, Margaux",Bordeaux,2016,26/05/2021,10127812016,1012781
530,25/06/2021,622,49,520,10,102,17/06/2021,"Chateau Batailley 5eme Cru Classe, Pauillac",Bordeaux,2005,27/06/2021,10063222005,1006322
3800,25/05/2021,4108,42,3480,320,628,10/04/2021,"Chateau Margaux Premier Cru Classe, Margaux",Bordeaux,2014,26/05/2021,10127812014,1012781
5490,24/05/2021,5592,141,5150,340,442,03/05/2021,"Chateau Margaux Premier Cru Classe, Margaux",Bordeaux,2018,26/05/2021,10127812018,1012781
3920,25/05/2021,4437,92,3800,120,637,12/05/2021,"Chateau Margaux Premier Cru Classe, Margaux",Bordeaux,2008,26/05/2021,10127812008,1012781
4400,12/05/2021,5010,8,4160,240,850,19/03/2021,"Chateau Margaux Premier Cru Classe, Margaux",Bordeaux,2019,26/05/2021,10127812019,1012781
1200,25/05/2021,1253,40,1124,76,129,19/05/2021,"Tignanello, Toscana",Tuscany,2016,26/05/2021,10953912016,1095391
850,18/05/2021,927,12,705,145,222,01/02/2021,"Chateau Calon Segur 3eme Cru Classe, Saint-Estephe",Bordeaux,2002,26/05/2021,10074752002,1007475
3750,24/05/2021,4161,43,3560,190,601,20/11/2020,"Chateau Margaux Premier Cru Classe, Margaux",Bordeaux,2012,26/05/2021,10127812012,1012781
3700,25/05/2021,4061,131,3700,0,361,06/05/2021,"Chateau Margaux Premier Cru Classe, Margaux",Bordeaux,2017,26/05/2021,10127812017,1012781
420,25/06/2021,495,4,400,20,95,11/05/2021,"Chateau Batailley 5eme Cru Classe, Pauillac",Bordeaux,2006,26/06/2021,10063222006,1006322
2580,30/07/2021,2931,161,2000,580,931,03/02/2020,"Chateau Angelus Premier Grand Cru Classe B, Saint-Emilion Grand Cru",Bordeaux,2011,31/07/2021,10060452011,1006045
3827,25/05/2021,4513,61,4116,-289,397,25/02/2021,"Chateau Margaux Premier Cru Classe, Margaux",Bordeaux,2004,26/05/2021,10127812004,1012781
3850,21/05/2021,4186,43,3560,290,626,20/11/2020,"Chateau Margaux Premier Cru Classe, Margaux",Bordeaux,2012,23/05/2021,10127812012,1012781
6300,21/05/2021,7510,59,5922,378,1588,13/04/2021,"Chateau Margaux Premier Cru Classe, Margaux",Bordeaux,2010,23/05/2021,10127812010,1012781
6650,20/05/2021,7643,42,6980,-330,663,21/05/2021,"Chateau Margaux Premier Cru Classe, Margaux",Bordeaux,2009,23/05/2021,10127812009,1012781
2580,30/07/2021,2931,161,2000,580,931,03/02/2020,"Chateau Angelus Premier Grand Cru Classe B, Saint-Emilion Grand Cru",Bordeaux,2011,31/07/2021,10060452011,1006045
420,25/06/2021,495,4,400,20,95,11/05/2021,"Chateau Batailley 5eme Cru Classe, Pauillac",Bordeaux,2006,26/06/2021,10063222006,1006322
1200,24/05/2021,1253,40,1124,76,129,19/05/2021,"Tignanello, Toscana",Tuscany,2016,25/05/2021,10953912016,1095391
6300,24/05/2021,7525,57,6190,110,1335,23/05/2021,"Chateau Margaux Premier Cru Classe, Margaux",Bordeaux,2010,25/05/2021,10127812010,1012781
880,24/05/2021,986,13,725,155,261,13/04/2021,"Chateau Calon Segur 3eme Cru Classe, Saint-Estephe",Bordeaux,2007,25/05/2021,10074752007,1007475
4400,12/05/2021,5000,8,4160,240,840,19/03/2021,"Chateau Margaux Premier Cru Classe, Margaux",Bordeaux,2019,25/05/2021,10127812019,1012781
7800,24/05/2021,8198,8,7000,800,1198,26/04/2021,"Domaine Leflaive, Chevalier-Montrachet Grand Cru",Burgundy,2018,25/05/2021,10734012018,1073401
1350,24/05/2021,1436,7,1352,-2,84,23/09/2020,"Gaja, Barbaresco",Piedmont,2011,25/05/2021,10996052011,1099605
1200,18/05/2021,1223,9,1202,-2,21,10/05/2021,"Tignanello, Toscana",Tuscany,2015,25/05/2021,10953912015,1095391
525,25/06/2021,596,397,494,31,102,20/04/2021,"Chateau Batailley 5eme Cru Classe, Pauillac",Bordeaux,2010,26/06/2021,10063222010,1006322
6552,24/05/2021,6552,0,3920,2632,2632,26/04/2017,"Domaine Leflaive, Chevalier-Montrachet Grand Cru",Burgundy,2006,25/05/2021,10734012006,1073401
1020,18/05/2021,1200,55,950,70,250,03/05/2021,"Chateau Calon Segur 3eme Cru Classe, Saint-Estephe",Bordeaux,2018,25/05/2021,10074752018,1007475
1050,24/05/2021,1212,20,940,110,272,18/03/2021,"Chateau Calon Segur 3eme Cru Classe, Saint-Estephe",Bordeaux,2000,25/05/2021,10074752000,1007475
900,21/05/2021,1240,13,850,50,390,28/01/2021,"Tignanello, Toscana",Tuscany,2012,25/05/2021,10953912012,1095391
2580,29/07/2021,2932,160,2000,580,932,03/02/2020,"Chateau Angelus Premier Grand Cru Classe B, Saint-Emilion Grand Cru",Bordeaux,2011,30/07/2021,10060452011,1006045
1100,24/05/2021,1513,7,1010,90,503,18/12/2020,"Tignanello, Toscana",Tuscany,2008,25/05/2021,10953912008,1095391
2580,29/07/2021,2932,160,2000,580,932,03/02/2020,"Chateau Angelus Premier Grand Cru Classe B, Saint-Emilion Grand Cru",Bordeaux,2011,30/07/2021,10060452011,1006045
525,25/06/2021,596,397,494,31,102,20/04/2021,"Chateau Batailley 5eme Cru Classe, Pauillac",Bordeaux,2010,26/06/2021,10063222010,1006322
2580,28/07/2021,2932,160,2000,580,932,03/02/2020,"Chateau Angelus Premier Grand Cru Classe B, Saint-Emilion Grand Cru",Bordeaux,2011,29/07/2021,10060452011,1006045
400,25/06/2021,432,7,355,45,77,15/04/2021,"Chateau Batailley 5eme Cru Classe, Pauillac",Bordeaux,2012,26/06/2021,10063222012,1006322
790,24/05/2021,944,134,814,-24,130,13/05/2021,"Tignanello, Toscana",Tuscany,2017,25/05/2021,10953912017,1095391
2580,28/07/2021,2932,160,2000,580,932,03/02/2020,"Chateau Angelus Premier Grand Cru Classe B, Saint-Emilion Grand Cru",Bordeaux,2011,29/07/2021,10060452011,1006045
6750,24/05/2021,7647,42,6525,225,1122,23/05/2021,"Chateau Margaux Premier Cru Classe, Margaux",Bordeaux,2009,25/05/2021,10127812009,1012781
1408,20/05/2021,1409,5,1238,170,171,02/11/2020,"Tignanello, Toscana",Tuscany,2006,25/05/2021,10953912006,1095391
400,25/06/2021,432,7,355,45,77,15/04/2021,"Chateau Batailley 5eme Cru Classe, Pauillac",Bordeaux,2012,26/06/2021,10063222012,1006322
12700,18/05/2021,12601,2,12850,-150,-249,30/11/2020,"Jacques-Frederic Mugnier, Chambolle-Musigny Premier Cru, Les Amoureuses",Burgundy,2011,25/05/2021,10496422011,1049642
300,25/06/2021,302,104,304,-4,-2,10/01/2021,"Chateau Batailley 5eme Cru Classe, Pauillac",Bordeaux,2013,26/06/2021,10063222013,1006322
1280,24/05/2021,1328,6,1200,80,128,06/03/2021,"Tignanello, Toscana",Tuscany,2007,25/05/2021,10953912007,1095391
3740,24/05/2021,3967,45,3520,220,447,07/04/2021,"Chateau Margaux Premier Cru Classe, Margaux",Bordeaux,2013,25/05/2021,10127812013,1012781
3827,24/05/2021,4507,62,4116,-289,391,25/02/2021,"Chateau Margaux Premier Cru Classe, Margaux",Bordeaux,2004,25/05/2021,10127812004,1012781
1020,24/05/2021,1048,10,860,160,188,08/03/2021,"Tignanello, Toscana",Tuscany,2011,25/05/2021,10953912011,1095391
359,25/06/2021,368,89,324,35,44,09/06/2021,"Chateau Batailley 5eme Cru Classe, Pauillac",Bordeaux,2014,26/06/2021,10063222014,1006322
3750,24/05/2021,4162,46,3560,190,602,20/11/2020,"Chateau Margaux Premier Cru Classe, Margaux",Bordeaux,2012,25/05/2021,10127812012,1012781
460,24/05/2021,486,149,420,40,66,23/03/2021,"Tua Rita, Giusto di Notri, Toscana",Tuscany,2016,25/05/2021,11058072016,1105807
2580,27/07/2021,2944,145,2000,580,944,03/02/2020,"Chateau Angelus Premier Grand Cru Classe B, Saint-Emilion Grand Cru",Bordeaux,2011,28/07/2021,10060452011,1006045
3920,24/05/2021,4435,93,3800,120,635,12/05/2021,"Chateau Margaux Premier Cru Classe, Margaux",Bordeaux,2008,25/05/2021,10127812008,1012781
2580,27/07/2021,2944,145,2000,580,944,03/02/2020,"Chateau Angelus Premier Grand Cru Classe B, Saint-Emilion Grand Cru",Bordeaux,2011,28/07/2021,10060452011,1006045
476,25/06/2021,527,44,364,112,163,12/05/2021,"Chateau Batailley 5eme Cru Classe, Pauillac",Bordeaux,2016,26/06/2021,10063222016,1006322
2580,26/07/2021,2944,145,2000,580,944,03/02/2020,"Chateau Angelus Premier Grand Cru Classe B, Saint-Emilion Grand Cru",Bordeaux,2011,27/07/2021,10060452011,1006045
3758,24/05/2021,4045,78,3690,68,355,13/04/2021,"Chateau Margaux Premier Cru Classe, Margaux",Bordeaux,2011,25/05/2021,10127812011,1012781
963,24/05/2021,1156,96,975,-12,181,12/04/2021,"Chateau Calon Segur 3eme Cru Classe, Saint-Estephe",Bordeaux,2005,25/05/2021,10074752005,1007475
1500,24/05/2021,1690,49,1408,92,282,09/04/2021,"Gaja, Barbaresco",Piedmont,2016,25/05/2021,10996052016,1099605
995,24/05/2021,1115,22,1000,-5,115,12/04/2021,"Chateau Calon Segur 3eme Cru Classe, Saint-Estephe",Bordeaux,2010,25/05/2021,10074752010,1007475
2580,26/07/2021,2944,145,2000,580,944,03/02/2020,"Chateau Angelus Premier Grand Cru Classe B, Saint-Emilion Grand Cru",Bordeaux,2011,27/07/2021,10060452011,1006045
2872,24/05/2021,2872,1,2554,318,318,22/05/2020,"Gaja, Barbaresco",Piedmont,2006,25/05/2021,10996052006,1099605
790,18/05/2021,979,21,745,45,234,16/11/2020,"Chateau Calon Segur 3eme Cru Classe, Saint-Estephe",Bordeaux,2004,25/05/2021,10074752004,1007475
1764,24/05/2021,1851,1,1768,-4,83,22/05/2020,"Gaja, Barbaresco",Piedmont,2000,25/05/2021,10996052000,1099605
5580,24/05/2021,5722,87,5238,342,484,17/05/2021,"Chateau Margaux Premier Cru Classe, Margaux",Bordeaux,2016,25/05/2021,10127812016,1012781
396,25/06/2021,411,28,357,39,54,06/05/2021,"Chateau Batailley 5eme Cru Classe, Pauillac",Bordeaux,2018,26/06/2021,10063222018,1006322
750,24/05/2021,1016,51,790,-40,226,01/06/2020,"Chateau Calon Segur 3eme Cru Classe, Saint-Estephe",Bordeaux,2011,25/05/2021,10074752011,1007475
2580,23/07/2021,3006,98,2000,580,1006,03/02/2020,"Chateau Angelus Premier Grand Cru Classe B, Saint-Emilion Grand Cru",Bordeaux,2011,24/07/2021,10060452011,1006045
8000,24/05/2021,8643,7,6974,1026,1669,14/03/2021,"Domaine Leflaive, Chevalier-Montrachet Grand Cru",Burgundy,2017,25/05/2021,10734012017,1073401
3720,24/05/2021,4108,42,3480,240,628,10/04/2021,"Chateau Margaux Premier Cru Classe, Margaux",Bordeaux,2014,25/05/2021,10127812014,1012781
2580,23/07/2021,3006,98,2000,580,1006,03/02/2020,"Chateau Angelus Premier Grand Cru Classe B, Saint-Emilion Grand Cru",Bordeaux,2011,24/07/2021,10060452011,1006045
6250,24/05/2021,7070,39,6360,-110,710,24/05/2021,"Chateau Margaux Premier Cru Classe, Margaux",Bordeaux,2005,25/05/2021,10127812005,1012781
660,24/05/2021,724,4,390,270,334,18/08/2017,"Tua Rita, Giusto di Notri, Toscana",Tuscany,2006,25/05/2021,11058072006,1105807
2232,24/05/2021,2351,5,2190,42,161,01/05/2021,"Gaja, Barbaresco",Piedmont,2004,25/05/2021,10996052004,1099605
16200,24/05/2021,16056,0,18750,-2550,-2694,29/08/2018,"Jacques-Frederic Mugnier, Chambolle-Musigny Premier Cru, Les Amoureuses",Burgundy,2015,25/05/2021,10496422015,1049642
10500,24/05/2021,12574,68,9844,656,2730,29/03/2021,"Chateau Margaux Premier Cru Classe, Margaux",Bordeaux,2015,25/05/2021,10127812015,1012781
520,24/05/2021,563,5,460,60,103,05/05/2020,"Tua Rita, Giusto di Notri, Toscana",Tuscany,2008,25/05/2021,11058072008,1105807
1398,18/05/2021,1421,10,1276,122,145,05/03/2021,"Gaja, Barbaresco",Piedmont,2013,25/05/2021,10996052013,1099605
3560,19/05/2021,4099,30,3592,-32,507,06/05/2021,"Chateau Margaux Premier Cru Classe, Margaux",Bordeaux,2007,25/05/2021,10127812007,1012781
3700,24/05/2021,4062,130,3700,0,362,06/05/2021,"Chateau Margaux Premier Cru Classe, Margaux",Bordeaux,2017,25/05/2021,10127812017,1012781
2580,22/07/2021,2990,105,2000,580,990,03/02/2020,"Chateau Angelus Premier Grand Cru Classe B, Saint-Emilion Grand Cru",Bordeaux,2011,23/07/2021,10060452011,1006045
420,24/05/2021,462,10,342,78,120,21/08/2020,"Tua Rita, Giusto di Notri, Toscana",Tuscany,2011,25/05/2021,11058072011,1105807
1050,24/05/2021,1158,58,1048,2,110,27/04/2021,"Chateau Calon Segur 3eme Cru Classe, Saint-Estephe",Bordeaux,2016,25/05/2021,10074752016,1007475
2200,24/05/2021,2127,2,1340,860,787,13/03/2020,"Gaja, Barbaresco",Piedmont,2009,25/05/2021,10996052009,1099605
1350,24/05/2021,1473,60,1260,90,213,18/02/2021,"Gaja, Barbaresco",Piedmont,2015,25/05/2021,10996052015,1099605
1000,24/05/2021,1158,42,1047,-47,111,27/04/2021,"Chateau Calon Segur 3eme Cru Classe, Saint-Estephe",Bordeaux,2009,25/05/2021,10074752009,1007475
530,28/06/2021,622,49,520,10,102,17/06/2021,"Chateau Batailley 5eme Cru Classe, Pauillac",Bordeaux,2005,29/06/2021,10063222005,1006322
2580,22/07/2021,2990,105,2000,580,990,03/02/2020,"Chateau Angelus Premier Grand Cru Classe B, Saint-Emilion Grand Cru",Bordeaux,2011,23/07/2021,10060452011,1006045
3900,19/05/2021,4517,30,3684,216,833,10/06/2020,"Chateau Margaux Premier Cru Classe, Margaux",Bordeaux,2002,25/05/2021,10127812002,1012781
1050,24/05/2021,1137,7,860,190,277,08/03/2021,"Tignanello, Toscana",Tuscany,2013,25/05/2021,10953912013,1095391
950,24/05/2021,1003,61,863,87,140,10/05/2021,"Chateau Calon Segur 3eme Cru Classe, Saint-Estephe",Bordeaux,2006,25/05/2021,10074752006,1007475
530,28/06/2021,622,49,520,10,102,17/06/2021,"Chateau Batailley 5eme Cru Classe, Pauillac",Bordeaux,2005,29/06/2021,10063222005,1006322
8016,24/05/2021,9840,3,7290,726,2550,21/08/2020,"Domaine Denis Mortet, Chambertin Grand Cru",Burgundy,2017,25/05/2021,10490202017,1049020
2580,21/07/2021,2990,105,2000,580,990,03/02/2020,"Chateau Angelus Premier Grand Cru Classe B, Saint-Emilion Grand Cru",Bordeaux,2011,22/07/2021,10060452011,1006045
4400,24/05/2021,4862,22,4400,0,462,29/09/2020,"Chateau Margaux Premier Cru Classe, Margaux",Bordeaux,2001,25/05/2021,10127812001,1012781
840,18/05/2021,1092,91,860,-20,232,19/04/2021,"Chateau Calon Segur 3eme Cru Classe, Saint-Estephe",Bordeaux,2015,25/05/2021,10074752015,1007475
2580,21/07/2021,2990,105,2000,580,990,03/02/2020,"Chateau Angelus Premier Grand Cru Classe B, Saint-Emilion Grand Cru",Bordeaux,2011,22/07/2021,10060452011,1006045
5450,24/05/2021,5592,141,5150,300,442,03/05/2021,"Chateau Margaux Premier Cru Classe, Margaux",Bordeaux,2018,25/05/2021,10127812018,1012781
2580,20/07/2021,2990,105,2000,580,990,03/02/2020,"Chateau Angelus Premier Grand Cru Classe B, Saint-Emilion Grand Cru",Bordeaux,2011,21/07/2021,10060452011,1006045
420,28/06/2021,495,4,400,20,95,11/05/2021,"Chateau Batailley 5eme Cru Classe, Pauillac",Bordeaux,2006,29/06/2021,10063222006,1006322
430,24/05/2021,503,4,300,130,203,03/11/2011,"Tua Rita, Giusto di Notri, Toscana",Tuscany,2007,25/05/2021,11058072007,1105807
490,19/05/2021,553,18,388,102,165,29/09/2020,"Tua Rita, Giusto di Notri, Toscana",Tuscany,2015,25/05/2021,11058072015,1105807
2580,20/07/2021,2990,105,2000,580,990,03/02/2020,"Chateau Angelus Premier Grand Cru Classe B, Saint-Emilion Grand Cru",Bordeaux,2011,21/07/2021,10060452011,1006045
564,24/05/2021,564,1,351,213,213,25/07/2016,"Tua Rita, Giusto di Notri, Toscana",Tuscany,2004,25/05/2021,11058072004,1105807
420,28/06/2021,495,4,400,20,95,11/05/2021,"Chateau Batailley 5eme Cru Classe, Pauillac",Bordeaux,2006,29/06/2021,10063222006,1006322
8040,24/05/2021,8359,18,7950,90,409,12/03/2021,"Chateau Margaux Premier Cru Classe, Margaux",Bordeaux,2000,25/05/2021,10127812000,1012781
2580,19/07/2021,2990,105,2000,580,990,03/02/2020,"Chateau Angelus Premier Grand Cru Classe B, Saint-Emilion Grand Cru",Bordeaux,2011,20/07/2021,10060452011,1006045
1280,24/05/2021,1367,8,1172,108,195,07/04/2021,"Tignanello, Toscana",Tuscany,2010,25/05/2021,10953912010,1095391
1700,18/05/2021,1814,3,1300,400,514,30/05/2019,"Gaja, Barbaresco",Piedmont,2007,25/05/2021,10996052007,1099605
1700,24/05/2021,1666,4,1378,322,288,29/07/2020,"Tignanello, Toscana",Tuscany,2001,25/05/2021,10953912001,1095391
907,24/05/2021,927,19,805,102,122,20/11/2019,"Chateau Calon Segur 3eme Cru Classe, Saint-Estephe",Bordeaux,2001,25/05/2021,10074752001,1007475
1480,24/05/2021,1580,123,1358,122,222,12/05/2021,"Gaja, Barbaresco",Piedmont,2017,25/05/2021,10996052017,1099605
2386,04/08/2021,2281,3,2190,196,91,01/05/2021,"Gaja, Barbaresco",Piedmont,2004,05/08/2021,10996052004,1099605
3900,07/06/2021,4613,95,3861,39,752,28/05/2021,"Chateau Margaux Premier Cru Classe, Margaux",Bordeaux,2006,08/06/2021,10127812006,1012781
525,28/06/2021,596,397,494,31,102,20/04/2021,"Chateau Batailley 5eme Cru Classe, Pauillac",Bordeaux,2010,29/06/2021,10063222010,1006322
660,07/06/2021,724,4,390,270,334,18/08/2017,"Tua Rita, Giusto di Notri, Toscana",Tuscany,2006,08/06/2021,11058072006,1105807
950,07/06/2021,1007,57,863,87,144,10/05/2021,"Chateau Calon Segur 3eme Cru Classe, Saint-Estephe",Bordeaux,2006,08/06/2021,10074752006,1007475
525,28/06/2021,596,397,494,31,102,20/04/2021,"Chateau Batailley 5eme Cru Classe, Pauillac",Bordeaux,2010,29/06/2021,10063222010,1006322
525,28/06/2021,595,398,494,31,101,20/04/2021,"Chateau Batailley 5eme Cru Classe, Pauillac",Bordeaux,2010,30/06/2021,10063222010,1006322
487,07/06/2021,524,45,320,167,204,24/03/2021,"Tua Rita, Giusto di Notri, Toscana",Tuscany,2017,08/06/2021,11058072017,1105807
2580,19/07/2021,2990,105,2000,580,990,03/02/2020,"Chateau Angelus Premier Grand Cru Classe B, Saint-Emilion Grand Cru",Bordeaux,2011,20/07/2021,10060452011,1006045
2144,15/07/2021,2986,93,2000,144,986,03/02/2020,"Chateau Angelus Premier Grand Cru Classe B, Saint-Emilion Grand Cru",Bordeaux,2011,16/07/2021,10060452011,1006045
1500,07/06/2021,1682,49,1408,92,274,09/04/2021,"Gaja, Barbaresco",Piedmont,2016,08/06/2021,10996052016,1099605
1000,07/06/2021,1163,42,1030,-30,133,25/05/2021,"Chateau Calon Segur 3eme Cru Classe, Saint-Estephe",Bordeaux,2009,08/06/2021,10074752009,1007475
525,28/06/2021,595,398,494,31,101,20/04/2021,"Chateau Batailley 5eme Cru Classe, Pauillac",Bordeaux,2010,30/06/2021,10063222010,1006322
750,07/06/2021,1007,50,790,-40,217,01/06/2020,"Chateau Calon Segur 3eme Cru Classe, Saint-Estephe",Bordeaux,2011,08/06/2021,10074752011,1007475
8098,07/06/2021,9941,3,7290,808,2651,21/08/2020,"Domaine Denis Mortet, Chambertin Grand Cru",Burgundy,2017,08/06/2021,10490202017,1049020
7906,27/05/2021,7792,2,7124,782,668,15/02/2019,"Domaine Leflaive, Chevalier-Montrachet Grand Cru",Burgundy,2016,08/06/2021,10734012016,1073401
460,07/06/2021,492,182,420,40,72,28/05/2021,"Tua Rita, Giusto di Notri, Toscana",Tuscany,2016,08/06/2021,11058072016,1105807
400,28/06/2021,432,7,355,45,77,15/04/2021,"Chateau Batailley 5eme Cru Classe, Pauillac",Bordeaux,2012,29/06/2021,10063222012,1006322
1024,07/06/2021,1202,9,1072,-48,130,20/01/2021,"Tignanello, Toscana",Tuscany,2009,08/06/2021,10953912009,1095391
2144,15/07/2021,2986,93,2000,144,986,03/02/2020,"Chateau Angelus Premier Grand Cru Classe B, Saint-Emilion Grand Cru",Bordeaux,2011,16/07/2021,10060452011,1006045
2580,14/07/2021,2986,93,2000,580,986,03/02/2020,"Chateau Angelus Premier Grand Cru Classe B, Saint-Emilion Grand Cru",Bordeaux,2011,15/07/2021,10060452011,1006045
860,07/06/2021,1025,69,916,-56,109,04/06/2021,"Tignanello, Toscana",Tuscany,2018,08/06/2021,10953912018,1095391
6250,04/06/2021,7429,49,6360,-110,1069,24/05/2021,"Chateau Margaux Premier Cru Classe, Margaux",Bordeaux,2005,08/06/2021,10127812005,1012781
1765,07/06/2021,1948,2,1768,-3,180,22/05/2020,"Gaja, Barbaresco",Piedmont,2000,08/06/2021,10996052000,1099605
6557,07/06/2021,6557,0,3920,2637,2637,26/04/2017,"Domaine Leflaive, Chevalier-Montrachet Grand Cru",Burgundy,2006,08/06/2021,10734012006,1073401
5600,10/05/2021,5852,1,4400,1200,1452,06/11/2017,"Domaine Leflaive, Chevalier-Montrachet Grand Cru",Burgundy,2013,08/06/2021,10734012013,1073401
4850,04/06/2021,5597,33,4842,8,755,19/05/2021,"Chateau Margaux Premier Cru Classe, Margaux",Bordeaux,2003,08/06/2021,10127812003,1012781
1290,07/06/2021,1352,8,1172,118,180,07/04/2021,"Tignanello, Toscana",Tuscany,2010,08/06/2021,10953912010,1095391
400,28/06/2021,432,7,355,45,77,15/04/2021,"Chateau Batailley 5eme Cru Classe, Pauillac",Bordeaux,2012,29/06/2021,10063222012,1006322
7800,07/06/2021,8230,8,7330,470,900,02/06/2021,"Domaine Leflaive, Chevalier-Montrachet Grand Cru",Burgundy,2018,08/06/2021,10734012018,1073401
686,07/06/2021,828,13,682,4,146,15/09/2020,"Chateau Calon Segur 3eme Cru Classe, Saint-Estephe",Bordeaux,2013,08/06/2021,10074752013,1007475
1700,07/06/2021,1658,4,1378,322,280,29/07/2020,"Tignanello, Toscana",Tuscany,2001,08/06/2021,10953912001,1095391
574,07/06/2021,574,1,351,223,223,25/07/2016,"Tua Rita, Giusto di Notri, Toscana",Tuscany,2004,08/06/2021,11058072004,1105807
3740,07/06/2021,3976,53,3520,220,456,07/04/2021,"Chateau Margaux Premier Cru Classe, Margaux",Bordeaux,2013,08/06/2021,10127812013,1012781
880,03/06/2021,934,13,781,99,153,16/11/2020,"Chateau Calon Segur 3eme Cru Classe, Saint-Estephe",Bordeaux,2008,08/06/2021,10074752008,1007475
2580,14/07/2021,2986,93,2000,580,986,03/02/2020,"Chateau Angelus Premier Grand Cru Classe B, Saint-Emilion Grand Cru",Bordeaux,2011,15/07/2021,10060452011,1006045
300,28/06/2021,302,104,304,-4,-2,10/01/2021,"Chateau Batailley 5eme Cru Classe, Pauillac",Bordeaux,2013,29/06/2021,10063222013,1006322
2500,07/06/2021,3334,3,1200,1300,2134,16/05/2012,"Gaja, Barbaresco",Piedmont,2001,08/06/2021,10996052001,1099605
3720,07/06/2021,4294,147,3480,240,814,10/04/2021,"Chateau Margaux Premier Cru Classe, Margaux",Bordeaux,2014,08/06/2021,10127812014,1012781
1350,07/06/2021,1445,7,1352,-2,93,23/09/2020,"Gaja, Barbaresco",Piedmont,2011,08/06/2021,10996052011,1099605
5415,03/06/2021,5624,80,5238,177,386,17/05/2021,"Chateau Margaux Premier Cru Classe, Margaux",Bordeaux,2016,08/06/2021,10127812016,1012781
2580,13/07/2021,2982,94,2000,580,982,03/02/2020,"Chateau Angelus Premier Grand Cru Classe B, Saint-Emilion Grand Cru",Bordeaux,2011,14/07/2021,10060452011,1006045
850,07/06/2021,937,165,800,50,137,05/06/2021,"Tignanello, Toscana",Tuscany,2017,08/06/2021,10953912017,1095391
1050,03/06/2021,1146,6,860,190,286,08/03/2021,"Tignanello, Toscana",Tuscany,2013,08/06/2021,10953912013,1095391
487,07/06/2021,549,21,388,99,161,29/09/2020,"Tua Rita, Giusto di Notri, Toscana",Tuscany,2015,08/06/2021,11058072015,1105807
5490,07/06/2021,5818,106,5254,236,564,26/05/2021,"Chateau Margaux Premier Cru Classe, Margaux",Bordeaux,2018,08/06/2021,10127812018,1012781
2580,13/07/2021,2982,94,2000,580,982,03/02/2020,"Chateau Angelus Premier Grand Cru Classe B, Saint-Emilion Grand Cru",Bordeaux,2011,14/07/2021,10060452011,1006045
8100,07/06/2021,8471,19,7950,150,521,12/03/2021,"Chateau Margaux Premier Cru Classe, Margaux",Bordeaux,2000,08/06/2021,10127812000,1012781
3560,07/06/2021,4098,34,3592,-32,506,06/05/2021,"Chateau Margaux Premier Cru Classe, Margaux",Bordeaux,2007,08/06/2021,10127812007,1012781
1800,07/06/2021,1815,3,1300,500,515,30/05/2019,"Gaja, Barbaresco",Piedmont,2007,08/06/2021,10996052007,1099605
3826,07/06/2021,4526,58,4116,-290,410,25/02/2021,"Chateau Margaux Premier Cru Classe, Margaux",Bordeaux,2004,08/06/2021,10127812004,1012781
870,07/06/2021,948,10,705,165,243,01/02/2021,"Chateau Calon Segur 3eme Cru Classe, Saint-Estephe",Bordeaux,2002,08/06/2021,10074752002,1007475
3700,07/06/2021,4220,119,3660,40,560,02/06/2021,"Chateau Margaux Premier Cru Classe, Margaux",Bordeaux,2017,08/06/2021,10127812017,1012781
520,07/06/2021,557,4,460,60,97,05/05/2020,"Tua Rita, Giusto di Notri, Toscana",Tuscany,2008,08/06/2021,11058072008,1105807
6830,07/06/2021,7660,50,6525,305,1135,23/05/2021,"Chateau Margaux Premier Cru Classe, Margaux",Bordeaux,2009,08/06/2021,10127812009,1012781
2580,12/07/2021,2981,94,2000,580,981,03/02/2020,"Chateau Angelus Premier Grand Cru Classe B, Saint-Emilion Grand Cru",Bordeaux,2011,13/07/2021,10060452011,1006045
900,07/06/2021,1090,29,800,100,290,21/11/2019,"Chateau Calon Segur 3eme Cru Classe, Saint-Estephe",Bordeaux,2003,08/06/2021,10074752003,1007475
8000,07/06/2021,8614,6,6974,1026,1640,14/03/2021,"Domaine Leflaive, Chevalier-Montrachet Grand Cru",Burgundy,2017,08/06/2021,10734012017,1073401
3750,04/06/2021,4201,39,3560,190,641,20/11/2020,"Chateau Margaux Premier Cru Classe, Margaux",Bordeaux,2012,08/06/2021,10127812012,1012781
2580,12/07/2021,2981,94,2000,580,981,03/02/2020,"Chateau Angelus Premier Grand Cru Classe B, Saint-Emilion Grand Cru",Bordeaux,2011,13/07/2021,10060452011,1006045
990,07/06/2021,1110,21,1000,-10,110,12/04/2021,"Chateau Calon Segur 3eme Cru Classe, Saint-Estephe",Bordeaux,2010,08/06/2021,10074752010,1007475
3758,07/06/2021,4050,97,3690,68,360,13/04/2021,"Chateau Margaux Premier Cru Classe, Margaux",Bordeaux,2011,08/06/2021,10127812011,1012781
359,28/06/2021,368,89,324,35,44,09/06/2021,"Chateau Batailley 5eme Cru Classe, Pauillac",Bordeaux,2014,29/06/2021,10063222014,1006322
2580,09/07/2021,2981,94,2000,580,981,03/02/2020,"Chateau Angelus Premier Grand Cru Classe B, Saint-Emilion Grand Cru",Bordeaux,2011,10/07/2021,10060452011,1006045
1080,07/06/2021,1161,58,1036,44,125,27/05/2021,"Chateau Calon Segur 3eme Cru Classe, Saint-Estephe",Bordeaux,2016,08/06/2021,10074752016,1007475
6300,07/06/2021,7458,64,6190,110,1268,23/05/2021,"Chateau Margaux Premier Cru Classe, Margaux",Bordeaux,2010,08/06/2021,10127812010,1012781
2580,09/07/2021,2981,94,2000,580,981,03/02/2020,"Chateau Angelus Premier Grand Cru Classe B, Saint-Emilion Grand Cru",Bordeaux,2011,10/07/2021,10060452011,1006045
907,07/06/2021,956,23,805,102,151,20/11/2019,"Chateau Calon Segur 3eme Cru Classe, Saint-Estephe",Bordeaux,2001,08/06/2021,10074752001,1007475
1000,07/06/2021,1153,98,988,12,165,28/05/2021,"Chateau Calon Segur 3eme Cru Classe, Saint-Estephe",Bordeaux,2005,08/06/2021,10074752005,1007475
880,07/06/2021,986,13,725,155,261,13/04/2021,"Chateau Calon Segur 3eme Cru Classe, Saint-Estephe",Bordeaux,2007,08/06/2021,10074752007,1007475
790,03/06/2021,1089,79,860,-70,229,19/04/2021,"Chateau Calon Segur 3eme Cru Classe, Saint-Estephe",Bordeaux,2015,08/06/2021,10074752015,1007475
10500,07/06/2021,12094,52,9844,656,2250,29/03/2021,"Chateau Margaux Premier Cru Classe, Margaux",Bordeaux,2015,08/06/2021,10127812015,1012781
16200,07/06/2021,16577,0,18750,-2550,-2173,29/08/2018,"Jacques-Frederic Mugnier, Chambolle-Musigny Premier Cru, Les Amoureuses",Burgundy,2015,08/06/2021,10496422015,1049642
476,28/06/2021,522,40,364,112,158,12/05/2021,"Chateau Batailley 5eme Cru Classe, Pauillac",Bordeaux,2016,29/06/2021,10063222016,1006322
3900,07/06/2021,4431,108,3700,200,731,07/06/2021,"Chateau Margaux Premier Cru Classe, Margaux",Bordeaux,2008,08/06/2021,10127812008,1012781
2580,08/07/2021,2981,94,2000,580,981,03/02/2020,"Chateau Angelus Premier Grand Cru Classe B, Saint-Emilion Grand Cru",Bordeaux,2011,09/07/2021,10060452011,1006045
1550,07/06/2021,1557,1,1300,250,257,27/04/2021,"Gaja, Barbaresco",Piedmont,2012,08/06/2021,10996052012,1099605
3900,07/06/2021,4472,28,3684,216,788,10/06/2020,"Chateau Margaux Premier Cru Classe, Margaux",Bordeaux,2002,08/06/2021,10127812002,1012781
1028,27/05/2021,1055,8,860,168,195,08/03/2021,"Tignanello, Toscana",Tuscany,2011,08/06/2021,10953912011,1095391
1103,07/06/2021,1261,36,1102,1,159,05/06/2021,"Tignanello, Toscana",Tuscany,2016,08/06/2021,10953912016,1095391
950,07/06/2021,1086,27,842,108,244,22/08/2020,"Chateau Calon Segur 3eme Cru Classe, Saint-Estephe",Bordeaux,2019,08/06/2021,10074752019,1007475
760,03/06/2021,919,111,740,20,179,21/05/2021,"Chateau Calon Segur 3eme Cru Classe, Saint-Estephe",Bordeaux,2017,08/06/2021,10074752017,1007475
1050,07/06/2021,1212,23,940,110,272,18/03/2021,"Chateau Calon Segur 3eme Cru Classe, Saint-Estephe",Bordeaux,2000,08/06/2021,10074752000,1007475
5000,07/06/2021,5058,6,4160,840,898,19/03/2021,"Chateau Margaux Premier Cru Classe, Margaux",Bordeaux,2019,08/06/2021,10127812019,1012781
540,07/06/2021,533,3,300,240,233,03/11/2011,"Tua Rita, Giusto di Notri, Toscana",Tuscany,2007,08/06/2021,11058072007,1105807
2199,07/06/2021,2219,2,1340,859,879,13/03/2020,"Gaja, Barbaresco",Piedmont,2009,08/06/2021,10996052009,1099605
3900,07/06/2021,4472,28,3684,216,788,10/06/2020,"Chateau Margaux Premier Cru Classe, Margaux",Bordeaux,2002,08/06/2021,10127812002,1012781
2580,08/07/2021,2981,94,2000,580,981,03/02/2020,"Chateau Angelus Premier Grand Cru Classe B, Saint-Emilion Grand Cru",Bordeaux,2011,09/07/2021,10060452011,1006045
1010,03/06/2021,1216,62,950,60,266,03/05/2021,"Chateau Calon Segur 3eme Cru Classe, Saint-Estephe",Bordeaux,2018,04/06/2021,10074752018,1007475
468,29/06/2021,547,6,420,48,127,09/07/2019,"Chateau Batailley 5eme Cru Classe, Pauillac",Bordeaux,2003,30/06/2021,10063222003,1006322
1350,03/06/2021,1445,7,1352,-2,93,23/09/2020,"Gaja, Barbaresco",Piedmont,2011,04/06/2021,10996052011,1099605
10500,02/06/2021,12604,57,9844,656,2760,29/03/2021,"Chateau Margaux Premier Cru Classe, Margaux",Bordeaux,2015,04/06/2021,10127812015,1012781
880,03/06/2021,1107,40,830,50,277,18/04/2021,"Tignanello, Toscana",Tuscany,2014,04/06/2021,10953912014,1095391
10650,03/06/2021,10048,1,4000,6650,6048,25/04/2016,"Domaine Denis Mortet, Chambertin Grand Cru",Burgundy,2013,04/06/2021,10490202013,1049020
660,03/06/2021,724,4,390,270,334,18/08/2017,"Tua Rita, Giusto di Notri, Toscana",Tuscany,2006,04/06/2021,11058072006,1105807
790,03/06/2021,1093,89,860,-70,233,19/04/2021,"Chateau Calon Segur 3eme Cru Classe, Saint-Estephe",Bordeaux,2015,04/06/2021,10074752015,1007475
2580,07/07/2021,2959,96,2000,580,959,03/02/2020,"Chateau Angelus Premier Grand Cru Classe B, Saint-Emilion Grand Cru",Bordeaux,2011,08/07/2021,10060452011,1006045
5490,03/06/2021,5613,93,5254,236,359,26/05/2021,"Chateau Margaux Premier Cru Classe, Margaux",Bordeaux,2018,04/06/2021,10127812018,1012781
830,03/06/2021,958,6,735,95,223,09/09/2020,"Chateau Calon Segur 3eme Cru Classe, Saint-Estephe",Bordeaux,2012,04/06/2021,10074752012,1007475
1150,03/06/2021,1230,11,1202,-52,28,10/05/2021,"Tignanello, Toscana",Tuscany,2015,04/06/2021,10953912015,1095391
2580,07/07/2021,2959,96,2000,580,959,03/02/2020,"Chateau Angelus Premier Grand Cru Classe B, Saint-Emilion Grand Cru",Bordeaux,2011,08/07/2021,10060452011,1006045
400,29/06/2021,445,4,332,68,113,06/10/2020,"Chateau Batailley 5eme Cru Classe, Pauillac",Bordeaux,2008,30/06/2021,10063222008,1006322
15600,01/06/2021,15144,7,13000,2600,2144,29/04/2021,"Jacques-Frederic Mugnier, Chambolle-Musigny Premier Cru, Les Amoureuses",Burgundy,2017,04/06/2021,10496422017,1049642
3720,03/06/2021,4216,86,3480,240,736,10/04/2021,"Chateau Margaux Premier Cru Classe, Margaux",Bordeaux,2014,04/06/2021,10127812014,1012781
3740,03/06/2021,3986,53,3520,220,466,07/04/2021,"Chateau Margaux Premier Cru Classe, Margaux",Bordeaux,2013,04/06/2021,10127812013,1012781
5000,03/06/2021,5046,8,4160,840,886,19/03/2021,"Chateau Margaux Premier Cru Classe, Margaux",Bordeaux,2019,04/06/2021,10127812019,1012781
950,03/06/2021,1080,28,842,108,238,22/08/2020,"Chateau Calon Segur 3eme Cru Classe, Saint-Estephe",Bordeaux,2019,04/06/2021,10074752019,1007475
1678,27/05/2021,1663,4,1180,498,483,25/06/2020,"Tignanello, Toscana",Tuscany,2004,04/06/2021,10953912004,1095391
790,31/05/2021,937,151,816,-26,121,27/05/2021,"Tignanello, Toscana",Tuscany,2017,04/06/2021,10953912017,1095391
880,03/06/2021,935,18,781,99,154,16/11/2020,"Chateau Calon Segur 3eme Cru Classe, Saint-Estephe",Bordeaux,2008,04/06/2021,10074752008,1007475
7800,03/06/2021,8198,7,7330,470,868,02/06/2021,"Domaine Leflaive, Chevalier-Montrachet Grand Cru",Burgundy,2018,04/06/2021,10734012018,1073401
400,29/06/2021,432,7,355,45,77,15/04/2021,"Chateau Batailley 5eme Cru Classe, Pauillac",Bordeaux,2012,30/06/2021,10063222012,1006322
400,29/06/2021,432,7,355,45,77,15/04/2021,"Chateau Batailley 5eme Cru Classe, Pauillac",Bordeaux,2012,30/06/2021,10063222012,1006322
6250,31/05/2021,7279,55,6360,-110,919,24/05/2021,"Chateau Margaux Premier Cru Classe, Margaux",Bordeaux,2005,04/06/2021,10127812005,1012781
1800,03/06/2021,1815,3,1300,500,515,30/05/2019,"Gaja, Barbaresco",Piedmont,2007,04/06/2021,10996052007,1099605
1024,02/06/2021,1201,9,1072,-48,129,20/01/2021,"Tignanello, Toscana",Tuscany,2009,04/06/2021,10953912009,1095391
300,29/06/2021,302,110,304,-4,-2,10/01/2021,"Chateau Batailley 5eme Cru Classe, Pauillac",Bordeaux,2013,30/06/2021,10063222013,1006322
1350,03/06/2021,1473,61,1260,90,213,18/02/2021,"Gaja, Barbaresco",Piedmont,2015,04/06/2021,10996052015,1099605
359,29/06/2021,368,90,324,35,44,09/06/2021,"Chateau Batailley 5eme Cru Classe, Pauillac",Bordeaux,2014,30/06/2021,10063222014,1006322
2580,06/07/2021,2959,96,2000,580,959,03/02/2020,"Chateau Angelus Premier Grand Cru Classe B, Saint-Emilion Grand Cru",Bordeaux,2011,07/07/2021,10060452011,1006045
900,02/06/2021,1091,31,800,100,291,21/11/2019,"Chateau Calon Segur 3eme Cru Classe, Saint-Estephe",Bordeaux,2003,04/06/2021,10074752003,1007475
3560,02/06/2021,4098,36,3592,-32,506,06/05/2021,"Chateau Margaux Premier Cru Classe, Margaux",Bordeaux,2007,04/06/2021,10127812007,1012781
2580,06/07/2021,2959,96,2000,580,959,03/02/2020,"Chateau Angelus Premier Grand Cru Classe B, Saint-Emilion Grand Cru",Bordeaux,2011,07/07/2021,10060452011,1006045
530,29/06/2021,535,29,312,218,223,12/03/2021,"Chateau Batailley 5eme Cru Classe, Pauillac",Bordeaux,2015,05/07/2021,10063222015,1006322
6750,03/06/2021,7631,44,6525,225,1106,23/05/2021,"Chateau Margaux Premier Cru Classe, Margaux",Bordeaux,2009,04/06/2021,10127812009,1012781
6300,03/06/2021,7467,62,6190,110,1277,23/05/2021,"Chateau Margaux Premier Cru Classe, Margaux",Bordeaux,2010,04/06/2021,10127812010,1012781
12700,03/06/2021,12601,2,12850,-150,-249,30/11/2020,"Jacques-Frederic Mugnier, Chambolle-Musigny Premier Cru, Les Amoureuses",Burgundy,2011,04/06/2021,10496422011,1049642
1020,03/06/2021,1049,9,860,160,189,08/03/2021,"Tignanello, Toscana",Tuscany,2011,04/06/2021,10953912011,1095391
789,03/06/2021,973,22,745,44,228,16/11/2020,"Chateau Calon Segur 3eme Cru Classe, Saint-Estephe",Bordeaux,2004,04/06/2021,10074752004,1007475
17180,03/06/2021,17180,0,6538,10642,10642,05/07/2016,"Jacques-Frederic Mugnier, Chambolle-Musigny Premier Cru, Les Amoureuses",Burgundy,2012,04/06/2021,10496422012,1049642
3700,03/06/2021,4151,136,3660,40,491,02/06/2021,"Chateau Margaux Premier Cru Classe, Margaux",Bordeaux,2017,04/06/2021,10127812017,1012781
2580,05/07/2021,2959,96,2000,580,959,03/02/2020,"Chateau Angelus Premier Grand Cru Classe B, Saint-Emilion Grand Cru",Bordeaux,2011,06/07/2021,10060452011,1006045
2580,05/07/2021,2959,96,2000,580,959,03/02/2020,"Chateau Angelus Premier Grand Cru Classe B, Saint-Emilion Grand Cru",Bordeaux,2011,06/07/2021,10060452011,1006045
8040,03/06/2021,8513,22,7950,90,563,12/03/2021,"Chateau Margaux Premier Cru Classe, Margaux",Bordeaux,2000,04/06/2021,10127812000,1012781
530,29/06/2021,534,30,312,218,222,12/03/2021,"Chateau Batailley 5eme Cru Classe, Pauillac",Bordeaux,2015,30/06/2021,10063222015,1006322
2199,03/06/2021,2184,1,1340,859,844,13/03/2020,"Gaja, Barbaresco",Piedmont,2009,04/06/2021,10996052009,1099605
5415,03/06/2021,5661,83,5238,177,423,17/05/2021,"Chateau Margaux Premier Cru Classe, Margaux",Bordeaux,2016,04/06/2021,10127812016,1012781
540,03/06/2021,533,3,300,240,233,03/11/2011,"Tua Rita, Giusto di Notri, Toscana",Tuscany,2007,04/06/2021,11058072007,1105807
2580,02/07/2021,2911,146,2000,580,911,03/02/2020,"Chateau Angelus Premier Grand Cru Classe B, Saint-Emilion Grand Cru",Bordeaux,2011,03/07/2021,10060452011,1006045
870,03/06/2021,945,10,705,165,240,01/02/2021,"Chateau Calon Segur 3eme Cru Classe, Saint-Estephe",Bordeaux,2002,04/06/2021,10074752002,1007475
2580,02/07/2021,2959,96,2000,580,959,03/02/2020,"Chateau Angelus Premier Grand Cru Classe B, Saint-Emilion Grand Cru",Bordeaux,2011,04/07/2021,10060452011,1006045
8098,03/06/2021,9941,3,7290,808,2651,21/08/2020,"Domaine Denis Mortet, Chambertin Grand Cru",Burgundy,2017,04/06/2021,10490202017,1049020
1050,21/05/2021,1158,59,1036,14,122,27/05/2021,"Chateau Calon Segur 3eme Cru Classe, Saint-Estephe",Bordeaux,2016,04/06/2021,10074752016,1007475
530,29/06/2021,536,29,312,218,224,12/03/2021,"Chateau Batailley 5eme Cru Classe, Pauillac",Bordeaux,2015,16/07/2021,10063222015,1006322
476,29/06/2021,522,40,364,112,158,12/05/2021,"Chateau Batailley 5eme Cru Classe, Pauillac",Bordeaux,2016,30/06/2021,10063222016,1006322
1050,03/06/2021,1144,6,860,190,284,08/03/2021,"Tignanello, Toscana",Tuscany,2013,04/06/2021,10953912013,1095391
1103,03/06/2021,1260,38,1124,-21,136,19/05/2021,"Tignanello, Toscana",Tuscany,2016,04/06/2021,10953912016,1095391
950,03/06/2021,1006,62,863,87,143,10/05/2021,"Chateau Calon Segur 3eme Cru Classe, Saint-Estephe",Bordeaux,2006,04/06/2021,10074752006,1007475
2580,02/07/2021,2911,146,2000,580,911,03/02/2020,"Chateau Angelus Premier Grand Cru Classe B, Saint-Emilion Grand Cru",Bordeaux,2011,03/07/2021,10060452011,1006045
3750,24/05/2021,4149,42,3560,190,589,20/11/2020,"Chateau Margaux Premier Cru Classe, Margaux",Bordeaux,2012,04/06/2021,10127812012,1012781
1700,03/06/2021,1658,4,1378,322,280,29/07/2020,"Tignanello, Toscana",Tuscany,2001,04/06/2021,10953912001,1095391
1050,01/06/2021,1209,24,940,110,269,18/03/2021,"Chateau Calon Segur 3eme Cru Classe, Saint-Estephe",Bordeaux,2000,04/06/2021,10074752000,1007475
8000,03/06/2021,8672,7,6974,1026,1698,14/03/2021,"Domaine Leflaive, Chevalier-Montrachet Grand Cru",Burgundy,2017,04/06/2021,10734012017,1073401
3900,03/06/2021,4425,92,3800,100,625,12/05/2021,"Chateau Margaux Premier Cru Classe, Margaux",Bordeaux,2008,04/06/2021,10127812008,1012781
2580,02/07/2021,2959,96,2000,580,959,03/02/2020,"Chateau Angelus Premier Grand Cru Classe B, Saint-Emilion Grand Cru",Bordeaux,2011,04/07/2021,10060452011,1006045
900,28/05/2021,1245,13,850,50,395,28/01/2021,"Tignanello, Toscana",Tuscany,2012,04/06/2021,10953912012,1095391
4386,02/06/2021,4774,27,4400,-14,374,29/09/2020,"Chateau Margaux Premier Cru Classe, Margaux",Bordeaux,2001,04/06/2021,10127812001,1012781
520,03/06/2021,563,5,460,60,103,05/05/2020,"Tua Rita, Giusto di Notri, Toscana",Tuscany,2008,04/06/2021,11058072008,1105807
1028,30/06/2021,914,4,470,558,444,29/03/2018,"Chateau Batailley 5eme Cru Classe, Pauillac",Bordeaux,2000,01/07/2021,10063222000,1006322
1028,30/06/2021,914,4,470,558,444,29/03/2018,"Chateau Batailley 5eme Cru Classe, Pauillac",Bordeaux,2000,01/07/2021,10063222000,1006322
1398,03/06/2021,1421,9,1276,122,145,05/03/2021,"Gaja, Barbaresco",Piedmont,2013,04/06/2021,10996052013,1099605
3900,03/06/2021,4690,79,3861,39,829,28/05/2021,"Chateau Margaux Premier Cru Classe, Margaux",Bordeaux,2006,04/06/2021,10127812006,1012781
1000,03/06/2021,1152,99,988,12,164,28/05/2021,"Chateau Calon Segur 3eme Cru Classe, Saint-Estephe",Bordeaux,2005,04/06/2021,10074752005,1007475
760,03/06/2021,893,119,740,20,153,21/05/2021,"Chateau Calon Segur 3eme Cru Classe, Saint-Estephe",Bordeaux,2017,04/06/2021,10074752017,1007475
990,03/06/2021,1113,22,1000,-10,113,12/04/2021,"Chateau Calon Segur 3eme Cru Classe, Saint-Estephe",Bordeaux,2010,04/06/2021,10074752010,1007475
790,27/05/2021,920,32,801,-11,119,31/05/2021,"Chateau Calon Segur 3eme Cru Classe, Saint-Estephe",Bordeaux,2014,04/06/2021,10074752014,1007475
880,03/06/2021,986,13,725,155,261,13/04/2021,"Chateau Calon Segur 3eme Cru Classe, Saint-Estephe",Bordeaux,2007,04/06/2021,10074752007,1007475
1000,03/06/2021,1161,43,1030,-30,131,25/05/2021,"Chateau Calon Segur 3eme Cru Classe, Saint-Estephe",Bordeaux,2009,04/06/2021,10074752009,1007475
1500,02/06/2021,1682,49,1408,92,274,09/04/2021,"Gaja, Barbaresco",Piedmont,2016,04/06/2021,10996052016,1099605
2580,01/07/2021,2911,145,2000,580,911,03/02/2020,"Chateau Angelus Premier Grand Cru Classe B, Saint-Emilion Grand Cru",Bordeaux,2011,02/07/2021,10060452011,1006045
3826,03/06/2021,4532,59,4116,-290,416,25/02/2021,"Chateau Margaux Premier Cru Classe, Margaux",Bordeaux,2004,04/06/2021,10127812004,1012781
3758,03/06/2021,4047,99,3690,68,357,13/04/2021,"Chateau Margaux Premier Cru Classe, Margaux",Bordeaux,2011,04/06/2021,10127812011,1012781
1550,03/06/2021,1557,1,1300,250,257,27/04/2021,"Gaja, Barbaresco",Piedmont,2012,04/06/2021,10996052012,1099605
460,03/06/2021,492,182,420,40,72,28/05/2021,"Tua Rita, Giusto di Notri, Toscana",Tuscany,2016,04/06/2021,11058072016,1105807
907,02/06/2021,958,23,805,102,153,20/11/2019,"Chateau Calon Segur 3eme Cru Classe, Saint-Estephe",Bordeaux,2001,04/06/2021,10074752001,1007475
1290,03/06/2021,1351,8,1172,118,179,07/04/2021,"Tignanello, Toscana",Tuscany,2010,04/06/2021,10953912010,1095391
468,30/06/2021,547,6,420,48,127,09/07/2019,"Chateau Batailley 5eme Cru Classe, Pauillac",Bordeaux,2003,01/07/2021,10063222003,1006322
530,30/06/2021,622,49,520,10,102,17/06/2021,"Chateau Batailley 5eme Cru Classe, Pauillac",Bordeaux,2005,01/07/2021,10063222005,1006322
2580,01/07/2021,2911,145,2000,580,911,03/02/2020,"Chateau Angelus Premier Grand Cru Classe B, Saint-Emilion Grand Cru",Bordeaux,2011,02/07/2021,10060452011,1006045
16200,03/06/2021,16577,0,18750,-2550,-2173,29/08/2018,"Jacques-Frederic Mugnier, Chambolle-Musigny Premier Cru, Les Amoureuses",Burgundy,2015,04/06/2021,10496422015,1049642
3900,05/08/2021,4639,96,3822,78,817,20/06/2021,"Chateau Margaux Premier Cru Classe, Margaux",Bordeaux,2006,06/08/2021,10127812006,1012781
940,05/08/2021,1074,77,866,74,208,20/07/2021,"Chateau Calon Segur 3eme Cru Classe, Saint-Estephe",Bordeaux,2015,06/08/2021,10074752015,1007475
2580,30/06/2021,2905,157,2000,580,905,03/02/2020,"Chateau Angelus Premier Grand Cru Classe B, Saint-Emilion Grand Cru",Bordeaux,2011,01/07/2021,10060452011,1006045
2580,30/06/2021,2905,157,2000,580,905,03/02/2020,"Chateau Angelus Premier Grand Cru Classe B, Saint-Emilion Grand Cru",Bordeaux,2011,01/07/2021,10060452011,1006045
530,30/06/2021,622,49,520,10,102,17/06/2021,"Chateau Batailley 5eme Cru Classe, Pauillac",Bordeaux,2005,01/07/2021,10063222005,1006322
4450,06/08/2021,4734,16,4400,50,334,29/09/2020,"Chateau Margaux Premier Cru Classe, Margaux",Bordeaux,2001,07/08/2021,10127812001,1012781
1020,18/05/2021,1216,61,950,70,266,03/05/2021,"Chateau Calon Segur 3eme Cru Classe, Saint-Estephe",Bordeaux,2018,28/05/2021,10074752018,1007475
2872,27/05/2021,2872,1,2554,318,318,22/05/2020,"Gaja, Barbaresco",Piedmont,2006,28/05/2021,10996052006,1099605
990,27/05/2021,1114,22,1000,-10,114,12/04/2021,"Chateau Calon Segur 3eme Cru Classe, Saint-Estephe",Bordeaux,2010,28/05/2021,10074752010,1007475
750,18/05/2021,892,119,740,10,152,21/05/2021,"Chateau Calon Segur 3eme Cru Classe, Saint-Estephe",Bordeaux,2017,28/05/2021,10074752017,1007475
3900,27/05/2021,4717,77,3800,100,917,07/04/2021,"Chateau Margaux Premier Cru Classe, Margaux",Bordeaux,2006,28/05/2021,10127812006,1012781
790,27/05/2021,921,31,794,-4,127,20/04/2021,"Chateau Calon Segur 3eme Cru Classe, Saint-Estephe",Bordeaux,2014,28/05/2021,10074752014,1007475
1350,27/05/2021,1432,7,1352,-2,80,23/09/2020,"Gaja, Barbaresco",Piedmont,2011,28/05/2021,10996052011,1099605
2580,29/06/2021,2905,157,2000,580,905,03/02/2020,"Chateau Angelus Premier Grand Cru Classe B, Saint-Emilion Grand Cru",Bordeaux,2011,30/06/2021,10060452011,1006045
1290,26/05/2021,1368,8,1172,118,196,07/04/2021,"Tignanello, Toscana",Tuscany,2010,28/05/2021,10953912010,1095391
1480,24/05/2021,1545,124,1358,122,187,12/05/2021,"Gaja, Barbaresco",Piedmont,2017,28/05/2021,10996052017,1099605
420,30/06/2021,495,4,400,20,95,11/05/2021,"Chateau Batailley 5eme Cru Classe, Pauillac",Bordeaux,2006,01/07/2021,10063222006,1006322
3700,27/05/2021,4047,132,3700,0,347,06/05/2021,"Chateau Margaux Premier Cru Classe, Margaux",Bordeaux,2017,28/05/2021,10127812017,1012781
2580,29/06/2021,2905,157,2000,580,905,03/02/2020,"Chateau Angelus Premier Grand Cru Classe B, Saint-Emilion Grand Cru",Bordeaux,2011,30/06/2021,10060452011,1006045
1024,25/05/2021,1183,11,1072,-48,111,20/01/2021,"Tignanello, Toscana",Tuscany,2009,28/05/2021,10953912009,1095391
420,30/06/2021,495,4,400,20,95,11/05/2021,"Chateau Batailley 5eme Cru Classe, Pauillac",Bordeaux,2006,01/07/2021,10063222006,1006322
420,30/06/2021,445,3,400,20,45,11/05/2021,"Chateau Batailley 5eme Cru Classe, Pauillac",Bordeaux,2006,02/07/2021,10063222006,1006322
420,30/06/2021,445,3,400,20,45,11/05/2021,"Chateau Batailley 5eme Cru Classe, Pauillac",Bordeaux,2006,02/07/2021,10063222006,1006322
2580,28/06/2021,2905,157,2000,580,905,03/02/2020,"Chateau Angelus Premier Grand Cru Classe B, Saint-Emilion Grand Cru",Bordeaux,2011,29/06/2021,10060452011,1006045
3826,27/05/2021,4507,62,4116,-290,391,25/02/2021,"Chateau Margaux Premier Cru Classe, Margaux",Bordeaux,2004,28/05/2021,10127812004,1012781
2580,28/06/2021,2905,157,2000,580,905,03/02/2020,"Chateau Angelus Premier Grand Cru Classe B, Saint-Emilion Grand Cru",Bordeaux,2011,29/06/2021,10060452011,1006045
1350,26/05/2021,1472,62,1260,90,212,18/02/2021,"Gaja, Barbaresco",Piedmont,2015,28/05/2021,10996052015,1099605
3740,27/05/2021,3970,42,3520,220,450,07/04/2021,"Chateau Margaux Premier Cru Classe, Margaux",Bordeaux,2013,28/05/2021,10127812013,1012781
16200,27/05/2021,16056,0,18750,-2550,-2694,29/08/2018,"Jacques-Frederic Mugnier, Chambolle-Musigny Premier Cru, Les Amoureuses",Burgundy,2015,28/05/2021,10496422015,1049642
8023,27/05/2021,9841,3,7290,733,2551,21/08/2020,"Domaine Denis Mortet, Chambertin Grand Cru",Burgundy,2017,28/05/2021,10490202017,1049020
2580,25/06/2021,2916,157,2000,580,916,03/02/2020,"Chateau Angelus Premier Grand Cru Classe B, Saint-Emilion Grand Cru",Bordeaux,2011,26/06/2021,10060452011,1006045
1408,27/05/2021,1352,2,996,412,356,14/06/2019,"Tignanello, Toscana",Tuscany,2000,28/05/2021,10953912000,1095391
430,27/05/2021,456,106,380,50,76,25/03/2021,"Tua Rita, Giusto di Notri, Toscana",Tuscany,2018,28/05/2021,11058072018,1105807
789,27/05/2021,977,21,745,44,232,16/11/2020,"Chateau Calon Segur 3eme Cru Classe, Saint-Estephe",Bordeaux,2004,28/05/2021,10074752004,1007475
400,30/06/2021,445,4,332,68,113,06/10/2020,"Chateau Batailley 5eme Cru Classe, Pauillac",Bordeaux,2008,01/07/2021,10063222008,1006322
2580,25/06/2021,2916,157,2000,580,916,03/02/2020,"Chateau Angelus Premier Grand Cru Classe B, Saint-Emilion Grand Cru",Bordeaux,2011,26/06/2021,10060452011,1006045
1050,21/05/2021,1155,61,1036,14,119,27/05/2021,"Chateau Calon Segur 3eme Cru Classe, Saint-Estephe",Bordeaux,2016,28/05/2021,10074752016,1007475
1300,27/05/2021,1523,12,1300,0,223,28/09/2020,"Gaja, Barbaresco",Piedmont,2014,28/05/2021,10996052014,1099605
400,30/06/2021,417,3,332,68,85,06/10/2020,"Chateau Batailley 5eme Cru Classe, Pauillac",Bordeaux,2008,14/07/2021,10063222008,1006322
4850,27/05/2021,5670,35,4842,8,828,19/05/2021,"Chateau Margaux Premier Cru Classe, Margaux",Bordeaux,2003,28/05/2021,10127812003,1012781
2580,24/06/2021,2915,158,2000,580,915,03/02/2020,"Chateau Angelus Premier Grand Cru Classe B, Saint-Emilion Grand Cru",Bordeaux,2011,25/06/2021,10060452011,1006045
400,30/06/2021,428,3,332,68,96,06/10/2020,"Chateau Batailley 5eme Cru Classe, Pauillac",Bordeaux,2008,16/07/2021,10063222008,1006322
7906,27/05/2021,8122,2,7124,782,998,15/02/2019,"Domaine Leflaive, Chevalier-Montrachet Grand Cru",Burgundy,2016,28/05/2021,10734012016,1073401
2580,24/06/2021,2915,158,2000,580,915,03/02/2020,"Chateau Angelus Premier Grand Cru Classe B, Saint-Emilion Grand Cru",Bordeaux,2011,25/06/2021,10060452011,1006045
1100,27/05/2021,1464,9,1010,90,454,18/12/2020,"Tignanello, Toscana",Tuscany,2008,28/05/2021,10953912008,1095391
4400,27/05/2021,4830,19,4400,0,430,29/09/2020,"Chateau Margaux Premier Cru Classe, Margaux",Bordeaux,2001,28/05/2021,10127812001,1012781
2580,23/06/2021,2915,158,2000,580,915,03/02/2020,"Chateau Angelus Premier Grand Cru Classe B, Saint-Emilion Grand Cru",Bordeaux,2011,24/06/2021,10060452011,1006045
2580,23/06/2021,2915,158,2000,580,915,03/02/2020,"Chateau Angelus Premier Grand Cru Classe B, Saint-Emilion Grand Cru",Bordeaux,2011,24/06/2021,10060452011,1006045
400,30/06/2021,431,3,332,68,99,06/10/2020,"Chateau Batailley 5eme Cru Classe, Pauillac",Bordeaux,2008,17/07/2021,10063222008,1006322
7800,27/05/2021,8198,8,7000,800,1198,26/04/2021,"Domaine Leflaive, Chevalier-Montrachet Grand Cru",Burgundy,2018,28/05/2021,10734012018,1073401
2580,22/06/2021,2915,158,2000,580,915,03/02/2020,"Chateau Angelus Premier Grand Cru Classe B, Saint-Emilion Grand Cru",Bordeaux,2011,23/06/2021,10060452011,1006045
2580,22/06/2021,2915,158,2000,580,915,03/02/2020,"Chateau Angelus Premier Grand Cru Classe B, Saint-Emilion Grand Cru",Bordeaux,2011,23/06/2021,10060452011,1006045
490,27/05/2021,553,20,388,102,165,29/09/2020,"Tua Rita, Giusto di Notri, Toscana",Tuscany,2015,28/05/2021,11058072015,1105807
13037,27/05/2021,15012,7,13000,37,2012,29/04/2021,"Jacques-Frederic Mugnier, Chambolle-Musigny Premier Cru, Les Amoureuses",Burgundy,2017,28/05/2021,10496422017,1049642
2580,21/06/2021,2918,152,2000,580,918,03/02/2020,"Chateau Angelus Premier Grand Cru Classe B, Saint-Emilion Grand Cru",Bordeaux,2011,22/06/2021,10060452011,1006045
2200,26/05/2021,2128,2,1340,860,788,13/03/2020,"Gaja, Barbaresco",Piedmont,2009,28/05/2021,10996052009,1099605
6300,27/05/2021,7563,55,6190,110,1373,23/05/2021,"Chateau Margaux Premier Cru Classe, Margaux",Bordeaux,2010,28/05/2021,10127812010,1012781
3750,27/05/2021,4108,33,3592,158,516,06/05/2021,"Chateau Margaux Premier Cru Classe, Margaux",Bordeaux,2007,28/05/2021,10127812007,1012781
540,27/05/2021,565,2,544,-4,21,18/09/2020,"Tua Rita, Giusto di Notri, Toscana",Tuscany,2013,28/05/2021,11058072013,1105807
6750,27/05/2021,7647,42,6525,225,1122,23/05/2021,"Chateau Margaux Premier Cru Classe, Margaux",Bordeaux,2009,28/05/2021,10127812009,1012781
780,27/05/2021,842,12,682,98,160,15/09/2020,"Chateau Calon Segur 3eme Cru Classe, Saint-Estephe",Bordeaux,2013,28/05/2021,10074752013,1007475
525,30/06/2021,596,397,494,31,102,20/04/2021,"Chateau Batailley 5eme Cru Classe, Pauillac",Bordeaux,2010,02/07/2021,10063222010,1006322
1050,24/05/2021,1213,22,940,110,273,18/03/2021,"Chateau Calon Segur 3eme Cru Classe, Saint-Estephe",Bordeaux,2000,28/05/2021,10074752000,1007475
1408,27/05/2021,1409,5,1238,170,171,02/11/2020,"Tignanello, Toscana",Tuscany,2006,28/05/2021,10953912006,1095391
1398,18/05/2021,1417,13,1276,122,141,05/03/2021,"Gaja, Barbaresco",Piedmont,2013,28/05/2021,10996052013,1099605
1300,27/05/2021,1331,6,1200,100,131,06/03/2021,"Tignanello, Toscana",Tuscany,2007,28/05/2021,10953912007,1095391
5490,26/05/2021,5583,91,5254,236,329,26/05/2021,"Chateau Margaux Premier Cru Classe, Margaux",Bordeaux,2018,28/05/2021,10127812018,1012781
9600,27/05/2021,9895,3,8000,1600,1895,30/01/2020,"Domaine Leflaive, Chevalier-Montrachet Grand Cru",Burgundy,2014,28/05/2021,10734012014,1073401
1500,27/05/2021,1687,50,1408,92,279,09/04/2021,"Gaja, Barbaresco",Piedmont,2016,28/05/2021,10996052016,1099605
660,27/05/2021,724,4,390,270,334,18/08/2017,"Tua Rita, Giusto di Notri, Toscana",Tuscany,2006,28/05/2021,11058072006,1105807
460,27/05/2021,481,149,420,40,61,27/05/2021,"Tua Rita, Giusto di Notri, Toscana",Tuscany,2016,28/05/2021,11058072016,1105807
990,27/05/2021,1152,98,1000,-10,152,25/05/2021,"Chateau Calon Segur 3eme Cru Classe, Saint-Estephe",Bordeaux,2005,28/05/2021,10074752005,1007475
3758,27/05/2021,4011,98,3690,68,321,13/04/2021,"Chateau Margaux Premier Cru Classe, Margaux",Bordeaux,2011,28/05/2021,10127812011,1012781
6396,27/05/2021,6960,3,7900,-1504,-940,29/04/2019,"Domaine Leflaive, Chevalier-Montrachet Grand Cru",Burgundy,2015,28/05/2021,10734012015,1073401
520,27/05/2021,563,5,460,60,103,05/05/2020,"Tua Rita, Giusto di Notri, Toscana",Tuscany,2008,28/05/2021,11058072008,1105807
1408,27/05/2021,1446,2,1150,258,296,21/04/2019,"Tignanello, Toscana",Tuscany,2005,28/05/2021,10953912005,1095391
840,21/05/2021,936,18,781,59,155,16/11/2020,"Chateau Calon Segur 3eme Cru Classe, Saint-Estephe",Bordeaux,2008,28/05/2021,10074752008,1007475
900,25/05/2021,1021,71,940,-40,81,13/05/2021,"Tignanello, Toscana",Tuscany,2018,28/05/2021,10953912018,1095391
525,30/06/2021,595,398,494,31,101,20/04/2021,"Chateau Batailley 5eme Cru Classe, Pauillac",Bordeaux,2010,01/07/2021,10063222010,1006322
6400,27/05/2021,6400,1,4500,1900,1900,08/04/2015,"Domaine Leflaive, Chevalier-Montrachet Grand Cru",Burgundy,2012,28/05/2021,10734012012,1073401
2232,27/05/2021,2359,5,2190,42,169,01/05/2021,"Gaja, Barbaresco",Piedmont,2004,28/05/2021,10996052004,1099605
8000,27/05/2021,8668,7,6974,1026,1694,14/03/2021,"Domaine Leflaive, Chevalier-Montrachet Grand Cru",Burgundy,2017,28/05/2021,10734012017,1073401
3720,27/05/2021,4106,43,3480,240,626,10/04/2021,"Chateau Margaux Premier Cru Classe, Margaux",Bordeaux,2014,28/05/2021,10127812014,1012781
830,18/05/2021,973,6,735,95,238,09/09/2020,"Chateau Calon Segur 3eme Cru Classe, Saint-Estephe",Bordeaux,2012,28/05/2021,10074752012,1007475
950,27/05/2021,1003,59,863,87,140,10/05/2021,"Chateau Calon Segur 3eme Cru Classe, Saint-Estephe",Bordeaux,2006,28/05/2021,10074752006,1007475
2580,21/06/2021,2918,152,2000,580,918,03/02/2020,"Chateau Angelus Premier Grand Cru Classe B, Saint-Emilion Grand Cru",Bordeaux,2011,22/06/2021,10060452011,1006045
1764,24/05/2021,1852,1,1768,-4,84,22/05/2020,"Gaja, Barbaresco",Piedmont,2000,28/05/2021,10996052000,1099605
3900,27/05/2021,4433,92,3800,100,633,12/05/2021,"Chateau Margaux Premier Cru Classe, Margaux",Bordeaux,2008,28/05/2021,10127812008,1012781
790,27/05/2021,940,146,816,-26,124,27/05/2021,"Tignanello, Toscana",Tuscany,2017,28/05/2021,10953912017,1095391
1245,27/05/2021,1523,3,882,363,641,26/04/2019,"Tignanello, Toscana",Tuscany,2003,28/05/2021,10953912003,1095391
525,30/06/2021,595,398,494,31,101,20/04/2021,"Chateau Batailley 5eme Cru Classe, Pauillac",Bordeaux,2010,01/07/2021,10063222010,1006322
8040,27/05/2021,8366,18,7950,90,416,12/03/2021,"Chateau Margaux Premier Cru Classe, Margaux",Bordeaux,2000,28/05/2021,10127812000,1012781
1678,27/05/2021,1661,4,1180,498,481,25/06/2020,"Tignanello, Toscana",Tuscany,2004,28/05/2021,10953912004,1095391
1408,27/05/2021,1409,5,1238,170,171,02/11/2020,"Tignanello, Toscana",Tuscany,2006,28/05/2021,10953912006,1095391
525,30/06/2021,596,397,494,31,102,20/04/2021,"Chateau Batailley 5eme Cru Classe, Pauillac",Bordeaux,2010,02/07/2021,10063222010,1006322
4400,27/05/2021,4830,19,4400,0,430,29/09/2020,"Chateau Margaux Premier Cru Classe, Margaux",Bordeaux,2001,28/05/2021,10127812001,1012781
940,03/08/2021,1072,77,866,74,206,20/07/2021,"Chateau Calon Segur 3eme Cru Classe, Saint-Estephe",Bordeaux,2015,04/08/2021,10074752015,1007475
790,03/08/2021,868,17,801,-11,67,31/05/2021,"Chateau Calon Segur 3eme Cru Classe, Saint-Estephe",Bordeaux,2014,04/08/2021,10074752014,1007475
2580,18/06/2021,2918,152,2000,580,918,03/02/2020,"Chateau Angelus Premier Grand Cru Classe B, Saint-Emilion Grand Cru",Bordeaux,2011,21/06/2021,10060452011,1006045
2580,18/06/2021,2917,153,2000,580,917,03/02/2020,"Chateau Angelus Premier Grand Cru Classe B, Saint-Emilion Grand Cru",Bordeaux,2011,19/06/2021,10060452011,1006045
1030,04/08/2021,1101,7,854,176,247,15/07/2021,"Tignanello, Toscana",Tuscany,2014,05/08/2021,10953912014,1095391
4450,04/08/2021,4739,16,4400,50,339,29/09/2020,"Chateau Margaux Premier Cru Classe, Margaux",Bordeaux,2001,05/08/2021,10127812001,1012781
3740,30/06/2021,4016,53,3520,220,496,07/04/2021,"Chateau Margaux Premier Cru Classe, Margaux",Bordeaux,2013,01/07/2021,10127812013,1012781
2580,18/06/2021,2918,152,2000,580,918,03/02/2020,"Chateau Angelus Premier Grand Cru Classe B, Saint-Emilion Grand Cru",Bordeaux,2011,21/06/2021,10060452011,1006045
2580,18/06/2021,2917,153,2000,580,917,03/02/2020,"Chateau Angelus Premier Grand Cru Classe B, Saint-Emilion Grand Cru",Bordeaux,2011,19/06/2021,10060452011,1006045
880,02/06/2021,986,13,725,155,261,13/04/2021,"Chateau Calon Segur 3eme Cru Classe, Saint-Estephe",Bordeaux,2007,03/06/2021,10074752007,1007475
2580,17/06/2021,2917,153,2000,580,917,03/02/2020,"Chateau Angelus Premier Grand Cru Classe B, Saint-Emilion Grand Cru",Bordeaux,2011,18/06/2021,10060452011,1006045
3720,02/06/2021,4213,86,3480,240,733,10/04/2021,"Chateau Margaux Premier Cru Classe, Margaux",Bordeaux,2014,03/06/2021,10127812014,1012781
400,30/06/2021,432,7,355,45,77,15/04/2021,"Chateau Batailley 5eme Cru Classe, Pauillac",Bordeaux,2012,01/07/2021,10063222012,1006322
3758,02/06/2021,4047,98,3690,68,357,13/04/2021,"Chateau Margaux Premier Cru Classe, Margaux",Bordeaux,2011,03/06/2021,10127812011,1012781
3560,02/06/2021,4097,36,3592,-32,505,06/05/2021,"Chateau Margaux Premier Cru Classe, Margaux",Bordeaux,2007,03/06/2021,10127812007,1012781
8040,02/06/2021,8513,22,7950,90,563,12/03/2021,"Chateau Margaux Premier Cru Classe, Margaux",Bordeaux,2000,03/06/2021,10127812000,1012781
950,02/06/2021,1080,28,842,108,238,22/08/2020,"Chateau Calon Segur 3eme Cru Classe, Saint-Estephe",Bordeaux,2019,03/06/2021,10074752019,1007475
7000,10/05/2021,6856,1,5360,1640,1496,18/09/2020,"Domaine Leflaive, Chevalier-Montrachet Grand Cru",Burgundy,2009,03/06/2021,10734012009,1073401
15600,01/06/2021,15133,7,13000,2600,2133,29/04/2021,"Jacques-Frederic Mugnier, Chambolle-Musigny Premier Cru, Les Amoureuses",Burgundy,2017,03/06/2021,10496422017,1049642
900,02/06/2021,1093,30,800,100,293,21/11/2019,"Chateau Calon Segur 3eme Cru Classe, Saint-Estephe",Bordeaux,2003,03/06/2021,10074752003,1007475
1000,31/05/2021,1162,42,1030,-30,132,25/05/2021,"Chateau Calon Segur 3eme Cru Classe, Saint-Estephe",Bordeaux,2009,03/06/2021,10074752009,1007475
1480,24/05/2021,1559,176,1358,122,201,12/05/2021,"Gaja, Barbaresco",Piedmont,2017,03/06/2021,10996052017,1099605
7800,02/06/2021,8198,7,7330,470,868,02/06/2021,"Domaine Leflaive, Chevalier-Montrachet Grand Cru",Burgundy,2018,03/06/2021,10734012018,1073401
400,30/06/2021,432,7,355,45,77,15/04/2021,"Chateau Batailley 5eme Cru Classe, Pauillac",Bordeaux,2012,01/07/2021,10063222012,1006322
4386,02/06/2021,4841,22,4400,-14,441,29/09/2020,"Chateau Margaux Premier Cru Classe, Margaux",Bordeaux,2001,03/06/2021,10127812001,1012781
2580,17/06/2021,2917,153,2000,580,917,03/02/2020,"Chateau Angelus Premier Grand Cru Classe B, Saint-Emilion Grand Cru",Bordeaux,2011,18/06/2021,10060452011,1006045
990,02/06/2021,1113,22,1000,-10,113,12/04/2021,"Chateau Calon Segur 3eme Cru Classe, Saint-Estephe",Bordeaux,2010,03/06/2021,10074752010,1007475
870,02/06/2021,945,10,705,165,240,01/02/2021,"Chateau Calon Segur 3eme Cru Classe, Saint-Estephe",Bordeaux,2002,03/06/2021,10074752002,1007475
2580,16/06/2021,2917,153,2000,580,917,03/02/2020,"Chateau Angelus Premier Grand Cru Classe B, Saint-Emilion Grand Cru",Bordeaux,2011,17/06/2021,10060452011,1006045
2580,16/06/2021,2917,153,2000,580,917,03/02/2020,"Chateau Angelus Premier Grand Cru Classe B, Saint-Emilion Grand Cru",Bordeaux,2011,17/06/2021,10060452011,1006045
1000,02/06/2021,1154,98,988,12,166,28/05/2021,"Chateau Calon Segur 3eme Cru Classe, Saint-Estephe",Bordeaux,2005,03/06/2021,10074752005,1007475
10446,31/05/2021,12585,60,9844,602,2741,29/03/2021,"Chateau Margaux Premier Cru Classe, Margaux",Bordeaux,2015,03/06/2021,10127812015,1012781
1029,31/05/2021,1152,7,860,169,292,08/03/2021,"Tignanello, Toscana",Tuscany,2013,03/06/2021,10953912013,1095391
790,31/05/2021,942,140,816,-26,126,27/05/2021,"Tignanello, Toscana",Tuscany,2017,03/06/2021,10953912017,1095391
950,02/06/2021,1006,62,863,87,143,10/05/2021,"Chateau Calon Segur 3eme Cru Classe, Saint-Estephe",Bordeaux,2006,03/06/2021,10074752006,1007475
1050,21/05/2021,1149,47,1036,14,113,27/05/2021,"Chateau Calon Segur 3eme Cru Classe, Saint-Estephe",Bordeaux,2016,03/06/2021,10074752016,1007475
6250,31/05/2021,7287,55,6360,-110,927,24/05/2021,"Chateau Margaux Premier Cru Classe, Margaux",Bordeaux,2005,03/06/2021,10127812005,1012781
780,02/06/2021,842,12,682,98,160,15/09/2020,"Chateau Calon Segur 3eme Cru Classe, Saint-Estephe",Bordeaux,2013,03/06/2021,10074752013,1007475
4850,27/05/2021,5637,36,4842,8,795,19/05/2021,"Chateau Margaux Premier Cru Classe, Margaux",Bordeaux,2003,03/06/2021,10127812003,1012781
1500,02/06/2021,1683,49,1408,92,275,09/04/2021,"Gaja, Barbaresco",Piedmont,2016,03/06/2021,10996052016,1099605
2375,02/06/2021,2917,153,2000,375,917,03/02/2020,"Chateau Angelus Premier Grand Cru Classe B, Saint-Emilion Grand Cru",Bordeaux,2011,03/06/2021,10060452011,1006045
3826,02/06/2021,4532,59,4116,-290,416,25/02/2021,"Chateau Margaux Premier Cru Classe, Margaux",Bordeaux,2004,03/06/2021,10127812004,1012781
2375,02/06/2021,2920,152,2000,375,920,03/02/2020,"Chateau Angelus Premier Grand Cru Classe B, Saint-Emilion Grand Cru",Bordeaux,2011,11/06/2021,10060452011,1006045
850,02/06/2021,1093,89,860,-10,233,19/04/2021,"Chateau Calon Segur 3eme Cru Classe, Saint-Estephe",Bordeaux,2015,03/06/2021,10074752015,1007475
3694,31/05/2021,4147,135,3660,34,487,02/06/2021,"Chateau Margaux Premier Cru Classe, Margaux",Bordeaux,2017,03/06/2021,10127812017,1012781
660,02/06/2021,724,4,390,270,334,18/08/2017,"Tua Rita, Giusto di Notri, Toscana",Tuscany,2006,03/06/2021,11058072006,1105807
520,02/06/2021,563,5,460,60,103,05/05/2020,"Tua Rita, Giusto di Notri, Toscana",Tuscany,2008,03/06/2021,11058072008,1105807
2375,02/06/2021,2918,152,2000,375,918,03/02/2020,"Chateau Angelus Premier Grand Cru Classe B, Saint-Emilion Grand Cru",Bordeaux,2011,05/06/2021,10060452011,1006045
3900,02/06/2021,4508,29,3684,216,824,10/06/2020,"Chateau Margaux Premier Cru Classe, Margaux",Bordeaux,2002,03/06/2021,10127812002,1012781
6557,02/06/2021,6557,0,3920,2637,2637,26/04/2017,"Domaine Leflaive, Chevalier-Montrachet Grand Cru",Burgundy,2006,03/06/2021,10734012006,1073401
300,30/06/2021,302,110,304,-4,-2,10/01/2021,"Chateau Batailley 5eme Cru Classe, Pauillac",Bordeaux,2013,01/07/2021,10063222013,1006322
3900,02/06/2021,4425,92,3800,100,625,12/05/2021,"Chateau Margaux Premier Cru Classe, Margaux",Bordeaux,2008,03/06/2021,10127812008,1012781
750,02/06/2021,1015,52,790,-40,225,01/06/2020,"Chateau Calon Segur 3eme Cru Classe, Saint-Estephe",Bordeaux,2011,03/06/2021,10074752011,1007475
359,30/06/2021,368,90,324,35,44,09/06/2021,"Chateau Batailley 5eme Cru Classe, Pauillac",Bordeaux,2014,01/07/2021,10063222014,1006322
359,30/06/2021,369,90,324,35,45,09/06/2021,"Chateau Batailley 5eme Cru Classe, Pauillac",Bordeaux,2014,02/07/2021,10063222014,1006322
359,30/06/2021,368,89,324,35,44,09/06/2021,"Chateau Batailley 5eme Cru Classe, Pauillac",Bordeaux,2014,03/07/2021,10063222014,1006322
476,30/06/2021,522,40,364,112,158,12/05/2021,"Chateau Batailley 5eme Cru Classe, Pauillac",Bordeaux,2016,01/07/2021,10063222016,1006322
2375,02/06/2021,2917,153,2000,375,917,03/02/2020,"Chateau Angelus Premier Grand Cru Classe B, Saint-Emilion Grand Cru",Bordeaux,2011,03/06/2021,10060452011,1006045
789,02/06/2021,976,21,745,44,231,16/11/2020,"Chateau Calon Segur 3eme Cru Classe, Saint-Estephe",Bordeaux,2004,03/06/2021,10074752004,1007475
16200,02/06/2021,16577,0,18750,-2550,-2173,29/08/2018,"Jacques-Frederic Mugnier, Chambolle-Musigny Premier Cru, Les Amoureuses",Burgundy,2015,03/06/2021,10496422015,1049642
2375,02/06/2021,2918,152,2000,375,918,03/02/2020,"Chateau Angelus Premier Grand Cru Classe B, Saint-Emilion Grand Cru",Bordeaux,2011,05/06/2021,10060452011,1006045
5415,02/06/2021,5677,69,5238,177,439,17/05/2021,"Chateau Margaux Premier Cru Classe, Margaux",Bordeaux,2016,03/06/2021,10127812016,1012781
3900,02/06/2021,4700,78,3861,39,839,28/05/2021,"Chateau Margaux Premier Cru Classe, Margaux",Bordeaux,2006,03/06/2021,10127812006,1012781
1408,02/06/2021,1394,5,1238,170,156,02/11/2020,"Tignanello, Toscana",Tuscany,2006,03/06/2021,10953912006,1095391
1400,02/06/2021,1416,9,1276,124,140,05/03/2021,"Gaja, Barbaresco",Piedmont,2013,03/06/2021,10996052013,1099605
6291,31/05/2021,7467,63,6190,101,1277,23/05/2021,"Chateau Margaux Premier Cru Classe, Margaux",Bordeaux,2010,03/06/2021,10127812010,1012781
3740,02/06/2021,3986,53,3520,220,466,07/04/2021,"Chateau Margaux Premier Cru Classe, Margaux",Bordeaux,2013,03/06/2021,10127812013,1012781
860,02/06/2021,1021,71,940,-80,81,13/05/2021,"Tignanello, Toscana",Tuscany,2018,03/06/2021,10953912018,1095391
400,01/07/2021,433,7,355,45,78,15/04/2021,"Chateau Batailley 5eme Cru Classe, Pauillac",Bordeaux,2012,02/07/2021,10063222012,1006322
1350,02/06/2021,1432,7,1352,-2,80,23/09/2020,"Gaja, Barbaresco",Piedmont,2011,03/06/2021,10996052011,1099605
6750,02/06/2021,7637,44,6525,225,1112,23/05/2021,"Chateau Margaux Premier Cru Classe, Margaux",Bordeaux,2009,03/06/2021,10127812009,1012781
400,01/07/2021,433,7,355,45,78,15/04/2021,"Chateau Batailley 5eme Cru Classe, Pauillac",Bordeaux,2012,02/07/2021,10063222012,1006322
300,01/07/2021,302,110,304,-4,-2,10/01/2021,"Chateau Batailley 5eme Cru Classe, Pauillac",Bordeaux,2013,02/07/2021,10063222013,1006322
780,02/06/2021,893,119,740,40,153,21/05/2021,"Chateau Calon Segur 3eme Cru Classe, Saint-Estephe",Bordeaux,2017,03/06/2021,10074752017,1007475
1080,02/06/2021,1215,62,950,130,265,03/05/2021,"Chateau Calon Segur 3eme Cru Classe, Saint-Estephe",Bordeaux,2018,03/06/2021,10074752018,1007475
1024,02/06/2021,1198,10,1072,-48,126,20/01/2021,"Tignanello, Toscana",Tuscany,2009,03/06/2021,10953912009,1095391
476,01/07/2021,521,40,364,112,157,12/05/2021,"Chateau Batailley 5eme Cru Classe, Pauillac",Bordeaux,2016,02/07/2021,10063222016,1006322
907,02/06/2021,955,24,805,102,150,20/11/2019,"Chateau Calon Segur 3eme Cru Classe, Saint-Estephe",Bordeaux,2001,03/06/2021,10074752001,1007475
885,02/06/2021,939,19,781,104,158,16/11/2020,"Chateau Calon Segur 3eme Cru Classe, Saint-Estephe",Bordeaux,2008,03/06/2021,10074752008,1007475
2375,02/06/2021,2920,152,2000,375,920,03/02/2020,"Chateau Angelus Premier Grand Cru Classe B, Saint-Emilion Grand Cru",Bordeaux,2011,11/06/2021,10060452011,1006045
1024,02/06/2021,1198,10,1072,-48,126,20/01/2021,"Tignanello, Toscana",Tuscany,2009,03/06/2021,10953912009,1095391
2538,31/05/2021,2917,153,2000,538,917,03/02/2020,"Chateau Angelus Premier Grand Cru Classe B, Saint-Emilion Grand Cru",Bordeaux,2011,01/06/2021,10060452011,1006045
6557,28/05/2021,6557,0,3920,2637,2637,26/04/2017,"Domaine Leflaive, Chevalier-Montrachet Grand Cru",Burgundy,2006,29/05/2021,10734012006,1073401
4400,28/05/2021,4852,22,4400,0,452,29/09/2020,"Chateau Margaux Premier Cru Classe, Margaux",Bordeaux,2001,29/05/2021,10127812001,1012781
685,02/07/2021,886,4,470,215,416,29/03/2018,"Chateau Batailley 5eme Cru Classe, Pauillac",Bordeaux,2000,03/07/2021,10063222000,1006322
1350,28/05/2021,1432,7,1352,-2,80,23/09/2020,"Gaja, Barbaresco",Piedmont,2011,29/05/2021,10996052011,1099605
2538,31/05/2021,2917,153,2000,538,917,03/02/2020,"Chateau Angelus Premier Grand Cru Classe B, Saint-Emilion Grand Cru",Bordeaux,2011,01/06/2021,10060452011,1006045
3900,28/05/2021,4712,77,3861,39,851,28/05/2021,"Chateau Margaux Premier Cru Classe, Margaux",Bordeaux,2006,29/05/2021,10127812006,1012781
3758,28/05/2021,4011,98,3690,68,321,13/04/2021,"Chateau Margaux Premier Cru Classe, Margaux",Bordeaux,2011,29/05/2021,10127812011,1012781
1050,21/05/2021,1148,48,1036,14,112,27/05/2021,"Chateau Calon Segur 3eme Cru Classe, Saint-Estephe",Bordeaux,2016,29/05/2021,10074752016,1007475
950,28/05/2021,1003,59,863,87,140,10/05/2021,"Chateau Calon Segur 3eme Cru Classe, Saint-Estephe",Bordeaux,2006,29/05/2021,10074752006,1007475
5000,28/05/2021,5046,8,4160,840,886,19/03/2021,"Chateau Margaux Premier Cru Classe, Margaux",Bordeaux,2019,29/05/2021,10127812019,1012781
685,02/07/2021,886,4,470,215,416,29/03/2018,"Chateau Batailley 5eme Cru Classe, Pauillac",Bordeaux,2000,03/07/2021,10063222000,1006322
1200,18/05/2021,1225,9,1202,-2,23,10/05/2021,"Tignanello, Toscana",Tuscany,2015,29/05/2021,10953912015,1095391
2590,28/05/2021,2912,141,2000,590,912,03/02/2020,"Chateau Angelus Premier Grand Cru Classe B, Saint-Emilion Grand Cru",Bordeaux,2011,29/05/2021,10060452011,1006045
790,28/05/2021,942,143,816,-26,126,27/05/2021,"Tignanello, Toscana",Tuscany,2017,29/05/2021,10953912017,1095391
5460,28/05/2021,5587,90,5254,206,333,26/05/2021,"Chateau Margaux Premier Cru Classe, Margaux",Bordeaux,2018,29/05/2021,10127812018,1012781
780,28/05/2021,842,12,682,98,160,15/09/2020,"Chateau Calon Segur 3eme Cru Classe, Saint-Estephe",Bordeaux,2013,29/05/2021,10074752013,1007475
1050,28/05/2021,1137,7,860,190,277,08/03/2021,"Tignanello, Toscana",Tuscany,2013,29/05/2021,10953912013,1095391
2590,28/05/2021,2912,141,2000,590,912,03/02/2020,"Chateau Angelus Premier Grand Cru Classe B, Saint-Emilion Grand Cru",Bordeaux,2011,29/05/2021,10060452011,1006045
1200,28/05/2021,1256,39,1124,76,132,19/05/2021,"Tignanello, Toscana",Tuscany,2016,29/05/2021,10953912016,1095391
420,02/07/2021,430,3,220,200,210,17/06/2015,"Chateau Batailley 5eme Cru Classe, Pauillac",Bordeaux,2002,03/07/2021,10063222002,1006322
885,28/05/2021,936,18,781,104,155,16/11/2020,"Chateau Calon Segur 3eme Cru Classe, Saint-Estephe",Bordeaux,2008,29/05/2021,10074752008,1007475
530,02/07/2021,622,49,520,10,102,17/06/2021,"Chateau Batailley 5eme Cru Classe, Pauillac",Bordeaux,2005,03/07/2021,10063222005,1006322
4850,27/05/2021,5666,35,4842,8,824,19/05/2021,"Chateau Margaux Premier Cru Classe, Margaux",Bordeaux,2003,29/05/2021,10127812003,1012781
9600,27/05/2021,9884,2,8000,1600,1884,30/01/2020,"Domaine Leflaive, Chevalier-Montrachet Grand Cru",Burgundy,2014,29/05/2021,10734012014,1073401
2590,26/05/2021,2912,141,2000,590,912,03/02/2020,"Chateau Angelus Premier Grand Cru Classe B, Saint-Emilion Grand Cru",Bordeaux,2011,27/05/2021,10060452011,1006045
789,28/05/2021,976,21,745,44,231,16/11/2020,"Chateau Calon Segur 3eme Cru Classe, Saint-Estephe",Bordeaux,2004,29/05/2021,10074752004,1007475
3826,28/05/2021,4513,61,4116,-290,397,25/02/2021,"Chateau Margaux Premier Cru Classe, Margaux",Bordeaux,2004,29/05/2021,10127812004,1012781
2590,26/05/2021,2900,141,2000,590,900,03/02/2020,"Chateau Angelus Premier Grand Cru Classe B, Saint-Emilion Grand Cru",Bordeaux,2011,28/05/2021,10060452011,1006045
900,28/05/2021,1240,13,850,50,390,28/01/2021,"Tignanello, Toscana",Tuscany,2012,29/05/2021,10953912012,1095391
520,28/05/2021,563,5,460,60,103,05/05/2020,"Tua Rita, Giusto di Notri, Toscana",Tuscany,2008,29/05/2021,11058072008,1105807
2199,28/05/2021,2127,2,1340,859,787,13/03/2020,"Gaja, Barbaresco",Piedmont,2009,29/05/2021,10996052009,1099605
850,18/05/2021,945,10,705,145,240,01/02/2021,"Chateau Calon Segur 3eme Cru Classe, Saint-Estephe",Bordeaux,2002,29/05/2021,10074752002,1007475
3900,28/05/2021,4433,92,3800,100,633,12/05/2021,"Chateau Margaux Premier Cru Classe, Margaux",Bordeaux,2008,29/05/2021,10127812008,1012781
1000,28/05/2021,1158,42,1030,-30,128,25/05/2021,"Chateau Calon Segur 3eme Cru Classe, Saint-Estephe",Bordeaux,2009,29/05/2021,10074752009,1007475
8000,28/05/2021,8668,7,6974,1026,1694,14/03/2021,"Domaine Leflaive, Chevalier-Montrachet Grand Cru",Burgundy,2017,29/05/2021,10734012017,1073401
2872,28/05/2021,2872,1,2554,318,318,22/05/2020,"Gaja, Barbaresco",Piedmont,2006,29/05/2021,10996052006,1099605
16200,28/05/2021,16057,0,18750,-2550,-2693,29/08/2018,"Jacques-Frederic Mugnier, Chambolle-Musigny Premier Cru, Les Amoureuses",Burgundy,2015,29/05/2021,10496422015,1049642
5300,28/05/2021,5652,68,5238,62,414,17/05/2021,"Chateau Margaux Premier Cru Classe, Margaux",Bordeaux,2016,29/05/2021,10127812016,1012781
3740,28/05/2021,3991,52,3520,220,471,07/04/2021,"Chateau Margaux Premier Cru Classe, Margaux",Bordeaux,2013,29/05/2021,10127812013,1012781
2590,26/05/2021,2912,141,2000,590,912,03/02/2020,"Chateau Angelus Premier Grand Cru Classe B, Saint-Emilion Grand Cru",Bordeaux,2011,27/05/2021,10060452011,1006045
990,28/05/2021,1114,22,1000,-10,114,12/04/2021,"Chateau Calon Segur 3eme Cru Classe, Saint-Estephe",Bordeaux,2010,29/05/2021,10074752010,1007475
2590,26/05/2021,2900,141,2000,590,900,03/02/2020,"Chateau Angelus Premier Grand Cru Classe B, Saint-Emilion Grand Cru",Bordeaux,2011,28/05/2021,10060452011,1006045
2590,24/05/2021,2912,141,2000,590,912,03/02/2020,"Chateau Angelus Premier Grand Cru Classe B, Saint-Emilion Grand Cru",Bordeaux,2011,25/05/2021,10060452011,1006045
2232,28/05/2021,2358,5,2190,42,168,01/05/2021,"Gaja, Barbaresco",Piedmont,2004,29/05/2021,10996052004,1099605
2590,24/05/2021,2912,141,2000,590,912,03/02/2020,"Chateau Angelus Premier Grand Cru Classe B, Saint-Emilion Grand Cru",Bordeaux,2011,25/05/2021,10060452011,1006045
866,17/05/2021,1080,28,842,24,238,22/08/2020,"Chateau Calon Segur 3eme Cru Classe, Saint-Estephe",Bordeaux,2019,29/05/2021,10074752019,1007475
2590,20/05/2021,2911,142,2000,590,911,03/02/2020,"Chateau Angelus Premier Grand Cru Classe B, Saint-Emilion Grand Cru",Bordeaux,2011,21/05/2021,10060452011,1006045
2590,20/05/2021,2911,142,2000,590,911,03/02/2020,"Chateau Angelus Premier Grand Cru Classe B, Saint-Emilion Grand Cru",Bordeaux,2011,21/05/2021,10060452011,1006045
3750,28/05/2021,4098,36,3592,158,506,06/05/2021,"Chateau Margaux Premier Cru Classe, Margaux",Bordeaux,2007,29/05/2021,10127812007,1012781
430,28/05/2021,503,4,300,130,203,03/11/2011,"Tua Rita, Giusto di Notri, Toscana",Tuscany,2007,29/05/2021,11058072007,1105807
1020,26/05/2021,1050,9,860,160,190,08/03/2021,"Tignanello, Toscana",Tuscany,2011,29/05/2021,10953912011,1095391
1299,27/05/2021,1464,9,1010,289,454,18/12/2020,"Tignanello, Toscana",Tuscany,2008,29/05/2021,10953912008,1095391
1480,24/05/2021,1574,124,1358,122,216,12/05/2021,"Gaja, Barbaresco",Piedmont,2017,29/05/2021,10996052017,1099605
530,02/07/2021,622,49,520,10,102,17/06/2021,"Chateau Batailley 5eme Cru Classe, Pauillac",Bordeaux,2005,03/07/2021,10063222005,1006322
420,02/07/2021,445,3,400,20,45,11/05/2021,"Chateau Batailley 5eme Cru Classe, Pauillac",Bordeaux,2006,03/07/2021,10063222006,1006322
8040,28/05/2021,8474,23,7950,90,524,12/03/2021,"Chateau Margaux Premier Cru Classe, Margaux",Bordeaux,2000,29/05/2021,10127812000,1012781
420,02/07/2021,445,3,400,20,45,11/05/2021,"Chateau Batailley 5eme Cru Classe, Pauillac",Bordeaux,2006,03/07/2021,10063222006,1006322
450,02/07/2021,445,4,332,118,113,06/10/2020,"Chateau Batailley 5eme Cru Classe, Pauillac",Bordeaux,2008,04/07/2021,10063222008,1006322
1350,28/05/2021,1473,61,1260,90,213,18/02/2021,"Gaja, Barbaresco",Piedmont,2015,29/05/2021,10996052015,1099605
460,28/05/2021,486,149,420,40,66,28/05/2021,"Tua Rita, Giusto di Notri, Toscana",Tuscany,2016,29/05/2021,11058072016,1105807
490,02/07/2021,513,9,450,40,63,25/05/2021,"Chateau Batailley 5eme Cru Classe, Pauillac",Bordeaux,2009,03/07/2021,10063222009,1006322
10650,18/05/2021,10048,1,4000,6650,6048,25/04/2016,"Domaine Denis Mortet, Chambertin Grand Cru",Burgundy,2013,29/05/2021,10490202013,1049020
490,02/07/2021,513,9,450,40,63,25/05/2021,"Chateau Batailley 5eme Cru Classe, Pauillac",Bordeaux,2009,03/07/2021,10063222009,1006322
2590,18/05/2021,2911,141,2000,590,911,03/02/2020,"Chateau Angelus Premier Grand Cru Classe B, Saint-Emilion Grand Cru",Bordeaux,2011,19/05/2021,10060452011,1006045
990,28/05/2021,1153,97,988,2,165,28/05/2021,"Chateau Calon Segur 3eme Cru Classe, Saint-Estephe",Bordeaux,2005,29/05/2021,10074752005,1007475
907,28/05/2021,927,19,805,102,122,20/11/2019,"Chateau Calon Segur 3eme Cru Classe, Saint-Estephe",Bordeaux,2001,29/05/2021,10074752001,1007475
1050,28/05/2021,1213,22,940,110,273,18/03/2021,"Chateau Calon Segur 3eme Cru Classe, Saint-Estephe",Bordeaux,2000,29/05/2021,10074752000,1007475
3900,25/05/2021,4508,29,3684,216,824,10/06/2020,"Chateau Margaux Premier Cru Classe, Margaux",Bordeaux,2002,29/05/2021,10127812002,1012781
6750,28/05/2021,7626,45,6525,225,1101,23/05/2021,"Chateau Margaux Premier Cru Classe, Margaux",Bordeaux,2009,29/05/2021,10127812009,1012781
1290,28/05/2021,1368,8,1172,118,196,07/04/2021,"Tignanello, Toscana",Tuscany,2010,29/05/2021,10953912010,1095391
13037,27/05/2021,14962,7,13000,37,1962,29/04/2021,"Jacques-Frederic Mugnier, Chambolle-Musigny Premier Cru, Les Amoureuses",Burgundy,2017,29/05/2021,10496422017,1049642
5865,28/05/2021,7455,59,6190,-325,1265,23/05/2021,"Chateau Margaux Premier Cru Classe, Margaux",Bordeaux,2010,29/05/2021,10127812010,1012781
1700,28/05/2021,1658,4,1378,322,280,29/07/2020,"Tignanello, Toscana",Tuscany,2001,29/05/2021,10953912001,1095391
6250,28/05/2021,7278,54,6360,-110,918,24/05/2021,"Chateau Margaux Premier Cru Classe, Margaux",Bordeaux,2005,29/05/2021,10127812005,1012781
2590,18/05/2021,2911,141,2000,590,911,03/02/2020,"Chateau Angelus Premier Grand Cru Classe B, Saint-Emilion Grand Cru",Bordeaux,2011,19/05/2021,10060452011,1006045
880,28/05/2021,986,13,725,155,261,13/04/2021,"Chateau Calon Segur 3eme Cru Classe, Saint-Estephe",Bordeaux,2007,29/05/2021,10074752007,1007475
7800,28/05/2021,8198,8,7000,800,1198,26/04/2021,"Domaine Leflaive, Chevalier-Montrachet Grand Cru",Burgundy,2018,29/05/2021,10734012018,1073401
1800,28/05/2021,1703,2,1440,360,263,04/01/2018,"Gaja, Barbaresco",Piedmont,2010,29/05/2021,10996052010,1099605
1020,18/05/2021,1217,61,950,70,267,03/05/2021,"Chateau Calon Segur 3eme Cru Classe, Saint-Estephe",Bordeaux,2018,29/05/2021,10074752018,1007475
2590,14/05/2021,2911,141,2000,590,911,03/02/2020,"Chateau Angelus Premier Grand Cru Classe B, Saint-Emilion Grand Cru",Bordeaux,2011,15/05/2021,10060452011,1006045
525,02/07/2021,596,396,494,31,102,20/04/2021,"Chateau Batailley 5eme Cru Classe, Pauillac",Bordeaux,2010,03/07/2021,10063222010,1006322
10200,28/05/2021,12604,65,9844,356,2760,29/03/2021,"Chateau Margaux Premier Cru Classe, Margaux",Bordeaux,2015,29/05/2021,10127812015,1012781
2590,14/05/2021,2911,141,2000,590,911,03/02/2020,"Chateau Angelus Premier Grand Cru Classe B, Saint-Emilion Grand Cru",Bordeaux,2011,15/05/2021,10060452011,1006045
1500,28/05/2021,1687,50,1408,92,279,09/04/2021,"Gaja, Barbaresco",Piedmont,2016,29/05/2021,10996052016,1099605
3700,28/05/2021,4076,139,3700,0,376,06/05/2021,"Chateau Margaux Premier Cru Classe, Margaux",Bordeaux,2017,29/05/2021,10127812017,1012781
950,18/05/2021,1107,40,830,120,277,18/04/2021,"Tignanello, Toscana",Tuscany,2014,29/05/2021,10953912014,1095391
2590,12/05/2021,2916,152,2000,590,916,03/02/2020,"Chateau Angelus Premier Grand Cru Classe B, Saint-Emilion Grand Cru",Bordeaux,2011,13/05/2021,10060452011,1006045
525,02/07/2021,596,396,494,31,102,20/04/2021,"Chateau Batailley 5eme Cru Classe, Pauillac",Bordeaux,2010,03/07/2021,10063222010,1006322
400,02/07/2021,433,7,355,45,78,15/04/2021,"Chateau Batailley 5eme Cru Classe, Pauillac",Bordeaux,2012,03/07/2021,10063222012,1006322
1050,01/06/2021,1208,22,940,110,268,18/03/2021,"Chateau Calon Segur 3eme Cru Classe, Saint-Estephe",Bordeaux,2000,02/06/2021,10074752000,1007475
1598,01/06/2021,1598,0,1300,298,298,27/04/2021,"Gaja, Barbaresco",Piedmont,2012,02/06/2021,10996052012,1099605
4850,27/05/2021,5671,34,4842,8,829,19/05/2021,"Chateau Margaux Premier Cru Classe, Margaux",Bordeaux,2003,02/06/2021,10127812003,1012781
2590,12/05/2021,2911,141,2000,590,911,03/02/2020,"Chateau Angelus Premier Grand Cru Classe B, Saint-Emilion Grand Cru",Bordeaux,2011,14/05/2021,10060452011,1006045
1400,01/06/2021,1416,9,1276,124,140,05/03/2021,"Gaja, Barbaresco",Piedmont,2013,02/06/2021,10996052013,1099605
850,01/06/2021,1091,90,860,-10,231,19/04/2021,"Chateau Calon Segur 3eme Cru Classe, Saint-Estephe",Bordeaux,2015,02/06/2021,10074752015,1007475
400,02/07/2021,433,7,355,45,78,15/04/2021,"Chateau Batailley 5eme Cru Classe, Pauillac",Bordeaux,2012,03/07/2021,10063222012,1006322
660,01/06/2021,724,4,390,270,334,18/08/2017,"Tua Rita, Giusto di Notri, Toscana",Tuscany,2006,02/06/2021,11058072006,1105807
3740,01/06/2021,3991,52,3520,220,471,07/04/2021,"Chateau Margaux Premier Cru Classe, Margaux",Bordeaux,2013,02/06/2021,10127812013,1012781
2590,12/05/2021,2916,152,2000,590,916,03/02/2020,"Chateau Angelus Premier Grand Cru Classe B, Saint-Emilion Grand Cru",Bordeaux,2011,13/05/2021,10060452011,1006045
8040,01/06/2021,8497,22,7950,90,547,12/03/2021,"Chateau Margaux Premier Cru Classe, Margaux",Bordeaux,2000,02/06/2021,10127812000,1012781
2590,12/05/2021,2911,141,2000,590,911,03/02/2020,"Chateau Angelus Premier Grand Cru Classe B, Saint-Emilion Grand Cru",Bordeaux,2011,14/05/2021,10060452011,1006045
3720,01/06/2021,4213,87,3480,240,733,10/04/2021,"Chateau Margaux Premier Cru Classe, Margaux",Bordeaux,2014,02/06/2021,10127812014,1012781
300,02/07/2021,302,110,304,-4,-2,10/01/2021,"Chateau Batailley 5eme Cru Classe, Pauillac",Bordeaux,2013,03/07/2021,10063222013,1006322
2590,10/05/2021,2916,152,2000,590,916,03/02/2020,"Chateau Angelus Premier Grand Cru Classe B, Saint-Emilion Grand Cru",Bordeaux,2011,12/05/2021,10060452011,1006045
3900,01/06/2021,4703,77,3861,39,842,28/05/2021,"Chateau Margaux Premier Cru Classe, Margaux",Bordeaux,2006,02/06/2021,10127812006,1012781
15600,01/06/2021,15156,7,13000,2600,2156,29/04/2021,"Jacques-Frederic Mugnier, Chambolle-Musigny Premier Cru, Les Amoureuses",Burgundy,2017,02/06/2021,10496422017,1049642
8000,01/06/2021,8668,7,6974,1026,1694,14/03/2021,"Domaine Leflaive, Chevalier-Montrachet Grand Cru",Burgundy,2017,02/06/2021,10734012017,1073401
574,01/06/2021,574,1,351,223,223,25/07/2016,"Tua Rita, Giusto di Notri, Toscana",Tuscany,2004,02/06/2021,11058072004,1105807
5517,31/05/2021,5657,67,5238,279,419,17/05/2021,"Chateau Margaux Premier Cru Classe, Margaux",Bordeaux,2016,02/06/2021,10127812016,1012781
3900,01/06/2021,4425,90,3800,100,625,12/05/2021,"Chateau Margaux Premier Cru Classe, Margaux",Bordeaux,2008,02/06/2021,10127812008,1012781
3826,01/06/2021,4532,59,4116,-290,416,25/02/2021,"Chateau Margaux Premier Cru Classe, Margaux",Bordeaux,2004,02/06/2021,10127812004,1012781
16200,01/06/2021,16577,0,18750,-2550,-2173,29/08/2018,"Jacques-Frederic Mugnier, Chambolle-Musigny Premier Cru, Les Amoureuses",Burgundy,2015,02/06/2021,10496422015,1049642
13200,01/06/2021,12601,2,12850,350,-249,30/11/2020,"Jacques-Frederic Mugnier, Chambolle-Musigny Premier Cru, Les Amoureuses",Burgundy,2011,02/06/2021,10496422011,1049642
780,01/06/2021,893,119,740,40,153,21/05/2021,"Chateau Calon Segur 3eme Cru Classe, Saint-Estephe",Bordeaux,2017,02/06/2021,10074752017,1007475
960,31/05/2021,1110,40,830,130,280,18/04/2021,"Tignanello, Toscana",Tuscany,2014,02/06/2021,10953912014,1095391
476,02/07/2021,520,39,364,112,156,12/05/2021,"Chateau Batailley 5eme Cru Classe, Pauillac",Bordeaux,2016,05/07/2021,10063222016,1006322
1500,01/06/2021,1683,49,1408,92,275,09/04/2021,"Gaja, Barbaresco",Piedmont,2016,02/06/2021,10996052016,1099605
6250,31/05/2021,7283,54,6360,-110,923,24/05/2021,"Chateau Margaux Premier Cru Classe, Margaux",Bordeaux,2005,02/06/2021,10127812005,1012781
4400,01/06/2021,4852,22,4400,0,452,29/09/2020,"Chateau Margaux Premier Cru Classe, Margaux",Bordeaux,2001,02/06/2021,10127812001,1012781
2590,10/05/2021,2927,137,2000,590,927,03/02/2020,"Chateau Angelus Premier Grand Cru Classe B, Saint-Emilion Grand Cru",Bordeaux,2011,11/05/2021,10060452011,1006045
2590,10/05/2021,2916,152,2000,590,916,03/02/2020,"Chateau Angelus Premier Grand Cru Classe B, Saint-Emilion Grand Cru",Bordeaux,2011,12/05/2021,10060452011,1006045
1765,01/06/2021,1853,1,1768,-3,85,22/05/2020,"Gaja, Barbaresco",Piedmont,2000,02/06/2021,10996052000,1099605
780,01/06/2021,842,12,682,98,160,15/09/2020,"Chateau Calon Segur 3eme Cru Classe, Saint-Estephe",Bordeaux,2013,02/06/2021,10074752013,1007475
1000,31/05/2021,1161,41,1030,-30,131,25/05/2021,"Chateau Calon Segur 3eme Cru Classe, Saint-Estephe",Bordeaux,2009,02/06/2021,10074752009,1007475
1029,31/05/2021,1160,6,860,169,300,08/03/2021,"Tignanello, Toscana",Tuscany,2013,02/06/2021,10953912013,1095391
14520,01/06/2021,14387,1,12000,2520,2387,28/05/2020,"Jacques-Frederic Mugnier, Chambolle-Musigny Premier Cru, Les Amoureuses",Burgundy,2014,02/06/2021,10496422014,1049642
2590,10/05/2021,2927,137,2000,590,927,03/02/2020,"Chateau Angelus Premier Grand Cru Classe B, Saint-Emilion Grand Cru",Bordeaux,2011,11/05/2021,10060452011,1006045
1800,31/05/2021,1815,3,1300,500,515,30/05/2019,"Gaja, Barbaresco",Piedmont,2007,02/06/2021,10996052007,1099605
476,02/07/2021,521,40,364,112,157,12/05/2021,"Chateau Batailley 5eme Cru Classe, Pauillac",Bordeaux,2016,03/07/2021,10063222016,1006322
789,01/06/2021,976,21,745,44,231,16/11/2020,"Chateau Calon Segur 3eme Cru Classe, Saint-Estephe",Bordeaux,2004,02/06/2021,10074752004,1007475
2232,01/06/2021,2358,5,2190,42,168,01/05/2021,"Gaja, Barbaresco",Piedmont,2004,02/06/2021,10996052004,1099605
3694,31/05/2021,4147,135,3700,-6,447,06/05/2021,"Chateau Margaux Premier Cru Classe, Margaux",Bordeaux,2017,02/06/2021,10127812017,1012781
2590,07/05/2021,2929,139,2000,590,929,03/02/2020,"Chateau Angelus Premier Grand Cru Classe B, Saint-Emilion Grand Cru",Bordeaux,2011,08/05/2021,10060452011,1006045
1080,01/06/2021,1215,62,950,130,265,03/05/2021,"Chateau Calon Segur 3eme Cru Classe, Saint-Estephe",Bordeaux,2018,02/06/2021,10074752018,1007475
398,02/07/2021,412,28,357,41,55,06/05/2021,"Chateau Batailley 5eme Cru Classe, Pauillac",Bordeaux,2018,03/07/2021,10063222018,1006322
2872,01/06/2021,2872,1,2554,318,318,22/05/2020,"Gaja, Barbaresco",Piedmont,2006,02/06/2021,10996052006,1099605
950,01/06/2021,1080,28,842,108,238,22/08/2020,"Chateau Calon Segur 3eme Cru Classe, Saint-Estephe",Bordeaux,2019,02/06/2021,10074752019,1007475
685,05/07/2021,886,4,470,215,416,29/03/2018,"Chateau Batailley 5eme Cru Classe, Pauillac",Bordeaux,2000,06/07/2021,10063222000,1006322
6750,01/06/2021,7629,42,6525,225,1104,23/05/2021,"Chateau Margaux Premier Cru Classe, Margaux",Bordeaux,2009,02/06/2021,10127812009,1012781
900,31/05/2021,1093,30,800,100,293,21/11/2019,"Chateau Calon Segur 3eme Cru Classe, Saint-Estephe",Bordeaux,2003,02/06/2021,10074752003,1007475
880,01/06/2021,986,13,725,155,261,13/04/2021,"Chateau Calon Segur 3eme Cru Classe, Saint-Estephe",Bordeaux,2007,02/06/2021,10074752007,1007475
870,01/06/2021,945,10,705,165,240,01/02/2021,"Chateau Calon Segur 3eme Cru Classe, Saint-Estephe",Bordeaux,2002,02/06/2021,10074752002,1007475
885,01/06/2021,936,18,781,104,155,16/11/2020,"Chateau Calon Segur 3eme Cru Classe, Saint-Estephe",Bordeaux,2008,02/06/2021,10074752008,1007475
685,05/07/2021,886,4,470,215,416,29/03/2018,"Chateau Batailley 5eme Cru Classe, Pauillac",Bordeaux,2000,06/07/2021,10063222000,1006322
2590,07/05/2021,2927,137,2000,590,927,03/02/2020,"Chateau Angelus Premier Grand Cru Classe B, Saint-Emilion Grand Cru",Bordeaux,2011,10/05/2021,10060452011,1006045
460,01/06/2021,492,182,420,40,72,28/05/2021,"Tua Rita, Giusto di Notri, Toscana",Tuscany,2016,02/06/2021,11058072016,1105807
550,05/07/2021,547,6,420,130,127,09/07/2019,"Chateau Batailley 5eme Cru Classe, Pauillac",Bordeaux,2003,06/07/2021,10063222003,1006322
600,05/07/2021,556,2,300,300,256,15/12/2019,"Chateau Batailley 5eme Cru Classe, Pauillac",Bordeaux,2004,06/07/2021,10063222004,1006322
520,01/06/2021,563,5,460,60,103,05/05/2020,"Tua Rita, Giusto di Notri, Toscana",Tuscany,2008,02/06/2021,11058072008,1105807
950,01/06/2021,1003,59,863,87,140,10/05/2021,"Chateau Calon Segur 3eme Cru Classe, Saint-Estephe",Bordeaux,2006,02/06/2021,10074752006,1007475
530,05/07/2021,622,49,520,10,102,17/06/2021,"Chateau Batailley 5eme Cru Classe, Pauillac",Bordeaux,2005,06/07/2021,10063222005,1006322
1000,01/06/2021,1153,97,988,12,165,28/05/2021,"Chateau Calon Segur 3eme Cru Classe, Saint-Estephe",Bordeaux,2005,02/06/2021,10074752005,1007475
6291,31/05/2021,7448,58,6190,101,1258,23/05/2021,"Chateau Margaux Premier Cru Classe, Margaux",Bordeaux,2010,02/06/2021,10127812010,1012781
3758,01/06/2021,4047,98,3690,68,357,13/04/2021,"Chateau Margaux Premier Cru Classe, Margaux",Bordeaux,2011,02/06/2021,10127812011,1012781
2590,07/05/2021,2927,137,2000,590,927,03/02/2020,"Chateau Angelus Premier Grand Cru Classe B, Saint-Emilion Grand Cru",Bordeaux,2011,10/05/2021,10060452011,1006045
2590,07/05/2021,2929,139,2000,590,929,03/02/2020,"Chateau Angelus Premier Grand Cru Classe B, Saint-Emilion Grand Cru",Bordeaux,2011,08/05/2021,10060452011,1006045
2590,05/05/2021,2931,139,2000,590,931,03/02/2020,"Chateau Angelus Premier Grand Cru Classe B, Saint-Emilion Grand Cru",Bordeaux,2011,07/05/2021,10060452011,1006045
530,05/07/2021,622,49,520,10,102,17/06/2021,"Chateau Batailley 5eme Cru Classe, Pauillac",Bordeaux,2005,06/07/2021,10063222005,1006322
2590,05/05/2021,2936,149,2000,590,936,03/02/2020,"Chateau Angelus Premier Grand Cru Classe B, Saint-Emilion Grand Cru",Bordeaux,2011,06/05/2021,10060452011,1006045
990,01/06/2021,1113,22,1000,-10,113,12/04/2021,"Chateau Calon Segur 3eme Cru Classe, Saint-Estephe",Bordeaux,2010,02/06/2021,10074752010,1007475
420,05/07/2021,445,3,400,20,45,11/05/2021,"Chateau Batailley 5eme Cru Classe, Pauillac",Bordeaux,2006,06/07/2021,10063222006,1006322
1480,24/05/2021,1556,171,1358,122,198,12/05/2021,"Gaja, Barbaresco",Piedmont,2017,02/06/2021,10996052017,1099605
7800,01/06/2021,8198,7,7000,800,1198,26/04/2021,"Domaine Leflaive, Chevalier-Montrachet Grand Cru",Burgundy,2018,02/06/2021,10734012018,1073401
952,26/05/2021,958,6,735,217,223,09/09/2020,"Chateau Calon Segur 3eme Cru Classe, Saint-Estephe",Bordeaux,2012,02/06/2021,10074752012,1007475
1350,01/06/2021,1432,7,1352,-2,80,23/09/2020,"Gaja, Barbaresco",Piedmont,2011,02/06/2021,10996052011,1099605
2590,05/05/2021,2936,149,2000,590,936,03/02/2020,"Chateau Angelus Premier Grand Cru Classe B, Saint-Emilion Grand Cru",Bordeaux,2011,06/05/2021,10060452011,1006045
3800,06/08/2021,4346,129,3600,200,746,02/08/2021,"Chateau Margaux Premier Cru Classe, Margaux",Bordeaux,2014,07/08/2021,10127812014,1012781
420,05/07/2021,445,3,400,20,45,11/05/2021,"Chateau Batailley 5eme Cru Classe, Pauillac",Bordeaux,2006,06/07/2021,10063222006,1006322
950,04/06/2021,1086,27,842,108,244,22/08/2020,"Chateau Calon Segur 3eme Cru Classe, Saint-Estephe",Bordeaux,2019,07/06/2021,10074752019,1007475
450,05/07/2021,445,4,332,118,113,06/10/2020,"Chateau Batailley 5eme Cru Classe, Pauillac",Bordeaux,2008,06/07/2021,10063222008,1006322
3700,03/06/2021,4219,119,3660,40,559,02/06/2021,"Chateau Margaux Premier Cru Classe, Margaux",Bordeaux,2017,07/06/2021,10127812017,1012781
2590,05/05/2021,2931,139,2000,590,931,03/02/2020,"Chateau Angelus Premier Grand Cru Classe B, Saint-Emilion Grand Cru",Bordeaux,2011,07/05/2021,10060452011,1006045
6396,27/05/2021,6847,2,7900,-1504,-1053,29/04/2019,"Domaine Leflaive, Chevalier-Montrachet Grand Cru",Burgundy,2015,07/06/2021,10734012015,1073401
1299,27/05/2021,1502,7,1010,289,492,18/12/2020,"Tignanello, Toscana",Tuscany,2008,07/06/2021,10953912008,1095391
3560,02/06/2021,4095,35,3592,-32,503,06/05/2021,"Chateau Margaux Premier Cru Classe, Margaux",Bordeaux,2007,07/06/2021,10127812007,1012781
760,03/06/2021,917,109,740,20,177,21/05/2021,"Chateau Calon Segur 3eme Cru Classe, Saint-Estephe",Bordeaux,2017,07/06/2021,10074752017,1007475
3900,04/06/2021,4447,99,3800,100,647,12/05/2021,"Chateau Margaux Premier Cru Classe, Margaux",Bordeaux,2008,07/06/2021,10127812008,1012781
490,05/07/2021,513,9,450,40,63,25/05/2021,"Chateau Batailley 5eme Cru Classe, Pauillac",Bordeaux,2009,06/07/2021,10063222009,1006322
860,02/06/2021,1025,69,916,-56,109,04/06/2021,"Tignanello, Toscana",Tuscany,2018,07/06/2021,10953912018,1095391
3720,04/06/2021,4295,145,3480,240,815,10/04/2021,"Chateau Margaux Premier Cru Classe, Margaux",Bordeaux,2014,07/06/2021,10127812014,1012781
3560,02/06/2021,4095,35,3592,-32,503,06/05/2021,"Chateau Margaux Premier Cru Classe, Margaux",Bordeaux,2007,07/06/2021,10127812007,1012781
490,05/07/2021,513,9,450,40,63,25/05/2021,"Chateau Batailley 5eme Cru Classe, Pauillac",Bordeaux,2009,06/07/2021,10063222009,1006322
2804,04/06/2021,3496,3,1200,1604,2296,16/05/2012,"Gaja, Barbaresco",Piedmont,2001,05/06/2021,10996052001,1099605
2590,03/05/2021,2941,160,2000,590,941,03/02/2020,"Chateau Angelus Premier Grand Cru Classe B, Saint-Emilion Grand Cru",Bordeaux,2011,04/05/2021,10060452011,1006045
1765,01/06/2021,1948,2,1768,-3,180,22/05/2020,"Gaja, Barbaresco",Piedmont,2000,05/06/2021,10996052000,1099605
2590,03/05/2021,2936,149,2000,590,936,03/02/2020,"Chateau Angelus Premier Grand Cru Classe B, Saint-Emilion Grand Cru",Bordeaux,2011,05/05/2021,10060452011,1006045
1398,03/06/2021,1420,10,1276,122,144,05/03/2021,"Gaja, Barbaresco",Piedmont,2013,05/06/2021,10996052013,1099605
9600,27/05/2021,9821,2,8000,1600,1821,30/01/2020,"Domaine Leflaive, Chevalier-Montrachet Grand Cru",Burgundy,2014,05/06/2021,10734012014,1073401
990,04/06/2021,1110,21,1000,-10,110,12/04/2021,"Chateau Calon Segur 3eme Cru Classe, Saint-Estephe",Bordeaux,2010,05/06/2021,10074752010,1007475
14520,01/06/2021,14270,1,12000,2520,2270,28/05/2020,"Jacques-Frederic Mugnier, Chambolle-Musigny Premier Cru, Les Amoureuses",Burgundy,2014,05/06/2021,10496422014,1049642
2590,03/05/2021,2941,160,2000,590,941,03/02/2020,"Chateau Angelus Premier Grand Cru Classe B, Saint-Emilion Grand Cru",Bordeaux,2011,04/05/2021,10060452011,1006045
780,04/06/2021,840,12,682,98,158,15/09/2020,"Chateau Calon Segur 3eme Cru Classe, Saint-Estephe",Bordeaux,2013,05/06/2021,10074752013,1007475
490,05/07/2021,511,9,450,40,61,25/05/2021,"Chateau Batailley 5eme Cru Classe, Pauillac",Bordeaux,2009,17/07/2021,10063222009,1006322
790,03/06/2021,982,21,745,45,237,16/11/2020,"Chateau Calon Segur 3eme Cru Classe, Saint-Estephe",Bordeaux,2004,05/06/2021,10074752004,1007475
1290,03/06/2021,1352,8,1172,118,180,07/04/2021,"Tignanello, Toscana",Tuscany,2010,05/06/2021,10953912010,1095391
1028,27/05/2021,1044,9,860,168,184,08/03/2021,"Tignanello, Toscana",Tuscany,2011,05/06/2021,10953912011,1095391
540,27/05/2021,571,1,544,-4,27,18/09/2020,"Tua Rita, Giusto di Notri, Toscana",Tuscany,2013,05/06/2021,11058072013,1105807
2590,03/05/2021,2936,149,2000,590,936,03/02/2020,"Chateau Angelus Premier Grand Cru Classe B, Saint-Emilion Grand Cru",Bordeaux,2011,05/05/2021,10060452011,1006045
3800,10/08/2021,4359,42,3605,195,754,26/07/2021,"Chateau Angelus Premier Grand Cru Classe A, Saint-Emilion Grand Cru",Bordeaux,2012,11/08/2021,10060452012,1006045
3720,04/06/2021,4300,146,3480,240,820,10/04/2021,"Chateau Margaux Premier Cru Classe, Margaux",Bordeaux,2014,05/06/2021,10127812014,1012781
490,05/07/2021,503,6,450,40,53,25/05/2021,"Chateau Batailley 5eme Cru Classe, Pauillac",Bordeaux,2009,20/07/2021,10063222009,1006322
4386,02/06/2021,4723,25,4400,-14,323,29/09/2020,"Chateau Margaux Premier Cru Classe, Margaux",Bordeaux,2001,05/06/2021,10127812001,1012781
660,04/06/2021,724,4,390,270,334,18/08/2017,"Tua Rita, Giusto di Notri, Toscana",Tuscany,2006,05/06/2021,11058072006,1105807
3800,10/08/2021,4359,42,3605,195,754,26/07/2021,"Chateau Angelus Premier Grand Cru Classe A, Saint-Emilion Grand Cru",Bordeaux,2012,11/08/2021,10060452012,1006045
6557,04/06/2021,6557,0,3920,2637,2637,26/04/2017,"Domaine Leflaive, Chevalier-Montrachet Grand Cru",Burgundy,2006,05/06/2021,10734012006,1073401
10500,02/06/2021,12151,50,9844,656,2307,29/03/2021,"Chateau Margaux Premier Cru Classe, Margaux",Bordeaux,2015,05/06/2021,10127812015,1012781
3800,09/08/2021,4359,42,3605,195,754,26/07/2021,"Chateau Angelus Premier Grand Cru Classe A, Saint-Emilion Grand Cru",Bordeaux,2012,10/08/2021,10060452012,1006045
15600,01/06/2021,15094,6,13000,2600,2094,29/04/2021,"Jacques-Frederic Mugnier, Chambolle-Musigny Premier Cru, Les Amoureuses",Burgundy,2017,05/06/2021,10496422017,1049642
490,05/07/2021,509,11,450,40,59,25/05/2021,"Chateau Batailley 5eme Cru Classe, Pauillac",Bordeaux,2009,07/07/2021,10063222009,1006322
5415,03/06/2021,5682,92,5238,177,444,17/05/2021,"Chateau Margaux Premier Cru Classe, Margaux",Bordeaux,2016,05/06/2021,10127812016,1012781
6300,04/06/2021,7484,58,6190,110,1294,23/05/2021,"Chateau Margaux Premier Cru Classe, Margaux",Bordeaux,2010,05/06/2021,10127812010,1012781
16200,04/06/2021,16577,0,18750,-2550,-2173,29/08/2018,"Jacques-Frederic Mugnier, Chambolle-Musigny Premier Cru, Les Amoureuses",Burgundy,2015,05/06/2021,10496422015,1049642
1000,03/06/2021,1163,42,1030,-30,133,25/05/2021,"Chateau Calon Segur 3eme Cru Classe, Saint-Estephe",Bordeaux,2009,05/06/2021,10074752009,1007475
5000,03/06/2021,5058,6,4160,840,898,19/03/2021,"Chateau Margaux Premier Cru Classe, Margaux",Bordeaux,2019,05/06/2021,10127812019,1012781
900,02/06/2021,1090,29,800,100,290,21/11/2019,"Chateau Calon Segur 3eme Cru Classe, Saint-Estephe",Bordeaux,2003,05/06/2021,10074752003,1007475
490,05/07/2021,509,11,450,40,59,25/05/2021,"Chateau Batailley 5eme Cru Classe, Pauillac",Bordeaux,2009,07/07/2021,10063222009,1006322
3750,04/06/2021,4146,41,3560,190,586,20/11/2020,"Chateau Margaux Premier Cru Classe, Margaux",Bordeaux,2012,05/06/2021,10127812012,1012781
8000,04/06/2021,8614,6,6974,1026,1640,14/03/2021,"Domaine Leflaive, Chevalier-Montrachet Grand Cru",Burgundy,2017,05/06/2021,10734012017,1073401
3700,03/06/2021,4225,120,3660,40,565,02/06/2021,"Chateau Margaux Premier Cru Classe, Margaux",Bordeaux,2017,05/06/2021,10127812017,1012781
3740,04/06/2021,3981,52,3520,220,461,07/04/2021,"Chateau Margaux Premier Cru Classe, Margaux",Bordeaux,2013,05/06/2021,10127812013,1012781
1550,04/06/2021,1557,1,1300,250,257,27/04/2021,"Gaja, Barbaresco",Piedmont,2012,05/06/2021,10996052012,1099605
1000,04/06/2021,1153,98,988,12,165,28/05/2021,"Chateau Calon Segur 3eme Cru Classe, Saint-Estephe",Bordeaux,2005,05/06/2021,10074752005,1007475
3800,09/08/2021,4359,42,3605,195,754,26/07/2021,"Chateau Angelus Premier Grand Cru Classe A, Saint-Emilion Grand Cru",Bordeaux,2012,10/08/2021,10060452012,1006045
7812,04/06/2021,7812,0,8540,-728,-728,02/12/2019,"Domaine Leflaive, Chevalier-Montrachet Grand Cru",Burgundy,2001,05/06/2021,10734012001,1073401
3800,06/08/2021,4348,37,3605,195,743,26/07/2021,"Chateau Angelus Premier Grand Cru Classe A, Saint-Emilion Grand Cru",Bordeaux,2012,07/08/2021,10060452012,1006045
420,24/05/2021,510,9,342,78,168,21/08/2020,"Tua Rita, Giusto di Notri, Toscana",Tuscany,2011,05/06/2021,11058072011,1105807
7800,04/06/2021,8226,8,7330,470,896,02/06/2021,"Domaine Leflaive, Chevalier-Montrachet Grand Cru",Burgundy,2018,05/06/2021,10734012018,1073401
3560,02/06/2021,4084,36,3592,-32,492,06/05/2021,"Chateau Margaux Premier Cru Classe, Margaux",Bordeaux,2007,05/06/2021,10127812007,1012781
3758,04/06/2021,4048,97,3690,68,358,13/04/2021,"Chateau Margaux Premier Cru Classe, Margaux",Bordeaux,2011,05/06/2021,10127812011,1012781
7906,27/05/2021,7946,1,7124,782,822,15/02/2019,"Domaine Leflaive, Chevalier-Montrachet Grand Cru",Burgundy,2016,05/06/2021,10734012016,1073401
490,27/05/2021,555,19,388,102,167,29/09/2020,"Tua Rita, Giusto di Notri, Toscana",Tuscany,2015,05/06/2021,11058072015,1105807
870,03/06/2021,948,10,705,165,243,01/02/2021,"Chateau Calon Segur 3eme Cru Classe, Saint-Estephe",Bordeaux,2002,05/06/2021,10074752002,1007475
490,05/07/2021,511,9,450,40,61,25/05/2021,"Chateau Batailley 5eme Cru Classe, Pauillac",Bordeaux,2009,17/07/2021,10063222009,1006322
4850,04/06/2021,5640,35,4842,8,798,19/05/2021,"Chateau Margaux Premier Cru Classe, Margaux",Bordeaux,2003,05/06/2021,10127812003,1012781
860,02/06/2021,1024,70,916,-56,108,04/06/2021,"Tignanello, Toscana",Tuscany,2018,05/06/2021,10953912018,1095391
1800,04/06/2021,1691,2,1440,360,251,04/01/2018,"Gaja, Barbaresco",Piedmont,2010,05/06/2021,10996052010,1099605
600,04/06/2021,600,14,408,192,192,09/04/2019,"Tua Rita, Giusto di Notri, Toscana",Tuscany,2012,05/06/2021,11058072012,1105807
790,03/06/2021,1087,80,860,-70,227,19/04/2021,"Chateau Calon Segur 3eme Cru Classe, Saint-Estephe",Bordeaux,2015,05/06/2021,10074752015,1007475
490,05/07/2021,510,8,450,40,60,25/05/2021,"Chateau Batailley 5eme Cru Classe, Pauillac",Bordeaux,2009,18/07/2021,10063222009,1006322
3800,06/08/2021,4348,37,3605,195,743,26/07/2021,"Chateau Angelus Premier Grand Cru Classe A, Saint-Emilion Grand Cru",Bordeaux,2012,07/08/2021,10060452012,1006045
3800,05/08/2021,4348,37,3605,195,743,26/07/2021,"Chateau Angelus Premier Grand Cru Classe A, Saint-Emilion Grand Cru",Bordeaux,2012,06/08/2021,10060452012,1006045
490,05/07/2021,503,6,450,40,53,25/05/2021,"Chateau Batailley 5eme Cru Classe, Pauillac",Bordeaux,2009,20/07/2021,10063222009,1006322
790,04/06/2021,926,29,801,-11,125,31/05/2021,"Chateau Calon Segur 3eme Cru Classe, Saint-Estephe",Bordeaux,2014,05/06/2021,10074752014,1007475
1300,04/06/2021,1333,5,1200,100,133,06/03/2021,"Tignanello, Toscana",Tuscany,2007,05/06/2021,10953912007,1095391
490,05/07/2021,510,8,450,40,60,25/05/2021,"Chateau Batailley 5eme Cru Classe, Pauillac",Bordeaux,2009,18/07/2021,10063222009,1006322
1010,03/06/2021,1215,63,950,60,265,03/05/2021,"Chateau Calon Segur 3eme Cru Classe, Saint-Estephe",Bordeaux,2018,05/06/2021,10074752018,1007475
907,04/06/2021,956,23,805,102,151,20/11/2019,"Chateau Calon Segur 3eme Cru Classe, Saint-Estephe",Bordeaux,2001,05/06/2021,10074752001,1007475
1050,01/06/2021,1212,23,940,110,272,18/03/2021,"Chateau Calon Segur 3eme Cru Classe, Saint-Estephe",Bordeaux,2000,05/06/2021,10074752000,1007475
1245,27/05/2021,1545,3,882,363,663,26/04/2019,"Tignanello, Toscana",Tuscany,2003,05/06/2021,10953912003,1095391
2232,01/06/2021,2369,5,2190,42,179,01/05/2021,"Gaja, Barbaresco",Piedmont,2004,05/06/2021,10996052004,1099605
525,05/07/2021,596,395,494,31,102,20/04/2021,"Chateau Batailley 5eme Cru Classe, Pauillac",Bordeaux,2010,06/07/2021,10063222010,1006322
3800,05/08/2021,4348,37,3605,195,743,26/07/2021,"Chateau Angelus Premier Grand Cru Classe A, Saint-Emilion Grand Cru",Bordeaux,2012,06/08/2021,10060452012,1006045
525,05/07/2021,596,395,494,31,102,20/04/2021,"Chateau Batailley 5eme Cru Classe, Pauillac",Bordeaux,2010,06/07/2021,10063222010,1006322
3900,04/06/2021,4441,100,3800,100,641,12/05/2021,"Chateau Margaux Premier Cru Classe, Margaux",Bordeaux,2008,05/06/2021,10127812008,1012781
3900,04/06/2021,4693,78,3861,39,832,28/05/2021,"Chateau Margaux Premier Cru Classe, Margaux",Bordeaux,2006,05/06/2021,10127812006,1012781
1080,04/06/2021,1158,59,1036,44,122,27/05/2021,"Chateau Calon Segur 3eme Cru Classe, Saint-Estephe",Bordeaux,2016,05/06/2021,10074752016,1007475
1678,27/05/2021,1648,4,1180,498,468,25/06/2020,"Tignanello, Toscana",Tuscany,2004,05/06/2021,10953912004,1095391
880,03/06/2021,932,14,781,99,151,16/11/2020,"Chateau Calon Segur 3eme Cru Classe, Saint-Estephe",Bordeaux,2008,05/06/2021,10074752008,1007475
1480,04/06/2021,1559,177,1358,122,201,12/05/2021,"Gaja, Barbaresco",Piedmont,2017,05/06/2021,10996052017,1099605
950,04/06/2021,1080,28,842,108,238,22/08/2020,"Chateau Calon Segur 3eme Cru Classe, Saint-Estephe",Bordeaux,2019,05/06/2021,10074752019,1007475
900,04/06/2021,1245,13,850,50,395,28/01/2021,"Tignanello, Toscana",Tuscany,2012,05/06/2021,10953912012,1095391
3800,04/08/2021,4350,37,3605,195,745,26/07/2021,"Chateau Angelus Premier Grand Cru Classe A, Saint-Emilion Grand Cru",Bordeaux,2012,05/08/2021,10060452012,1006045
3800,04/08/2021,4350,37,3605,195,745,26/07/2021,"Chateau Angelus Premier Grand Cru Classe A, Saint-Emilion Grand Cru",Bordeaux,2012,05/08/2021,10060452012,1006045
6396,27/05/2021,6880,2,7900,-1504,-1020,29/04/2019,"Domaine Leflaive, Chevalier-Montrachet Grand Cru",Burgundy,2015,05/06/2021,10734012015,1073401
8100,03/06/2021,8513,22,7950,150,563,12/03/2021,"Chateau Margaux Premier Cru Classe, Margaux",Bordeaux,2000,05/06/2021,10127812000,1012781
1150,03/06/2021,1231,12,1202,-52,29,10/05/2021,"Tignanello, Toscana",Tuscany,2015,05/06/2021,10953912015,1095391
3900,02/06/2021,4471,28,3684,216,787,10/06/2020,"Chateau Margaux Premier Cru Classe, Margaux",Bordeaux,2002,05/06/2021,10127812002,1012781
400,05/07/2021,445,5,300,100,145,05/11/2020,"Chateau Batailley 5eme Cru Classe, Pauillac",Bordeaux,2011,06/07/2021,10063222011,1006322
3800,03/08/2021,4350,37,3605,195,745,26/07/2021,"Chateau Angelus Premier Grand Cru Classe A, Saint-Emilion Grand Cru",Bordeaux,2012,03/08/2021,10060452012,1006045
430,27/05/2021,460,124,380,50,80,25/03/2021,"Tua Rita, Giusto di Notri, Toscana",Tuscany,2018,05/06/2021,11058072018,1105807
520,04/06/2021,557,4,460,60,97,05/05/2020,"Tua Rita, Giusto di Notri, Toscana",Tuscany,2008,05/06/2021,11058072008,1105807
400,05/07/2021,445,5,300,100,145,05/11/2020,"Chateau Batailley 5eme Cru Classe, Pauillac",Bordeaux,2011,06/07/2021,10063222011,1006322
3800,03/08/2021,4350,37,3605,195,745,26/07/2021,"Chateau Angelus Premier Grand Cru Classe A, Saint-Emilion Grand Cru",Bordeaux,2012,04/08/2021,10060452012,1006045
400,05/07/2021,431,4,320,80,111,09/07/2021,"Chateau Batailley 5eme Cru Classe, Pauillac",Bordeaux,2011,10/07/2021,10063222011,1006322
750,02/06/2021,1007,50,790,-40,217,01/06/2020,"Chateau Calon Segur 3eme Cru Classe, Saint-Estephe",Bordeaux,2011,05/06/2021,10074752011,1007475
850,03/06/2021,937,167,816,34,121,27/05/2021,"Tignanello, Toscana",Tuscany,2017,05/06/2021,10953912017,1095391
1103,03/06/2021,1260,37,1124,-21,136,19/05/2021,"Tignanello, Toscana",Tuscany,2016,05/06/2021,10953912016,1095391
5490,03/06/2021,5801,96,5254,236,547,26/05/2021,"Chateau Margaux Premier Cru Classe, Margaux",Bordeaux,2018,05/06/2021,10127812018,1012781
2199,03/06/2021,2219,2,1340,859,879,13/03/2020,"Gaja, Barbaresco",Piedmont,2009,05/06/2021,10996052009,1099605
1350,04/06/2021,1445,7,1352,-2,93,23/09/2020,"Gaja, Barbaresco",Piedmont,2011,05/06/2021,10996052011,1099605
12700,03/06/2021,12681,1,12850,-150,-169,30/11/2020,"Jacques-Frederic Mugnier, Chambolle-Musigny Premier Cru, Les Amoureuses",Burgundy,2011,05/06/2021,10496422011,1049642
6250,04/06/2021,7376,44,6360,-110,1016,24/05/2021,"Chateau Margaux Premier Cru Classe, Margaux",Bordeaux,2005,05/06/2021,10127812005,1012781
1500,04/06/2021,1682,49,1408,92,274,09/04/2021,"Gaja, Barbaresco",Piedmont,2016,05/06/2021,10996052016,1099605
6750,03/06/2021,7627,40,6525,225,1102,23/05/2021,"Chateau Margaux Premier Cru Classe, Margaux",Bordeaux,2009,05/06/2021,10127812009,1012781
760,03/06/2021,918,110,740,20,178,21/05/2021,"Chateau Calon Segur 3eme Cru Classe, Saint-Estephe",Bordeaux,2017,05/06/2021,10074752017,1007475
3826,04/06/2021,4521,57,4116,-290,405,25/02/2021,"Chateau Margaux Premier Cru Classe, Margaux",Bordeaux,2004,05/06/2021,10127812004,1012781
780,04/06/2021,840,12,682,98,158,15/09/2020,"Chateau Calon Segur 3eme Cru Classe, Saint-Estephe",Bordeaux,2013,05/06/2021,10074752013,1007475
3800,02/08/2021,4350,37,3605,195,745,26/07/2021,"Chateau Angelus Premier Grand Cru Classe A, Saint-Emilion Grand Cru",Bordeaux,2012,03/08/2021,10060452012,1006045
686,30/06/2021,826,7,682,4,144,15/09/2020,"Chateau Calon Segur 3eme Cru Classe, Saint-Estephe",Bordeaux,2013,01/07/2021,10074752013,1007475
850,03/06/2021,937,167,800,50,137,05/06/2021,"Tignanello, Toscana",Tuscany,2017,06/06/2021,10953912017,1095391
6830,03/06/2021,7627,40,6525,305,1102,23/05/2021,"Chateau Margaux Premier Cru Classe, Margaux",Bordeaux,2009,06/06/2021,10127812009,1012781
1103,03/06/2021,1260,37,1102,1,158,05/06/2021,"Tignanello, Toscana",Tuscany,2016,06/06/2021,10953912016,1095391
1299,27/05/2021,1494,7,1010,289,484,18/12/2020,"Tignanello, Toscana",Tuscany,2008,06/06/2021,10953912008,1095391
1408,27/05/2021,1368,1,1150,258,218,21/04/2019,"Tignanello, Toscana",Tuscany,2005,06/06/2021,10953912005,1095391
3700,03/08/2021,4171,46,3520,180,651,07/04/2021,"Chateau Margaux Premier Cru Classe, Margaux",Bordeaux,2013,04/08/2021,10127812013,1012781
750,06/08/2021,950,47,790,-40,160,01/06/2020,"Chateau Calon Segur 3eme Cru Classe, Saint-Estephe",Bordeaux,2011,07/08/2021,10074752011,1007475
895,05/08/2021,966,53,863,32,103,10/05/2021,"Chateau Calon Segur 3eme Cru Classe, Saint-Estephe",Bordeaux,2006,06/08/2021,10074752006,1007475
3900,04/08/2021,4432,22,3684,216,748,10/06/2020,"Chateau Margaux Premier Cru Classe, Margaux",Bordeaux,2002,05/08/2021,10127812002,1012781
4850,04/06/2021,5601,32,4842,8,759,19/05/2021,"Chateau Margaux Premier Cru Classe, Margaux",Bordeaux,2003,11/06/2021,10127812003,1012781
5490,09/06/2021,5829,104,5254,236,575,26/05/2021,"Chateau Margaux Premier Cru Classe, Margaux",Bordeaux,2018,11/06/2021,10127812018,1012781
3826,10/06/2021,4531,54,4116,-290,415,25/02/2021,"Chateau Margaux Premier Cru Classe, Margaux",Bordeaux,2004,11/06/2021,10127812004,1012781
400,05/07/2021,431,4,320,80,111,09/07/2021,"Chateau Batailley 5eme Cru Classe, Pauillac",Bordeaux,2011,10/07/2021,10063222011,1006322
1200,04/06/2021,1261,37,1050,150,211,10/06/2021,"Tignanello, Toscana",Tuscany,2016,11/06/2021,10953912016,1095391
5800,09/06/2021,6617,0,4400,1400,2217,06/11/2017,"Domaine Leflaive, Chevalier-Montrachet Grand Cru",Burgundy,2013,11/06/2021,10734012013,1073401
3800,02/08/2021,4350,37,3605,195,745,26/07/2021,"Chateau Angelus Premier Grand Cru Classe A, Saint-Emilion Grand Cru",Bordeaux,2012,03/08/2021,10060452012,1006045
3800,30/07/2021,4335,54,3605,195,730,26/07/2021,"Chateau Angelus Premier Grand Cru Classe A, Saint-Emilion Grand Cru",Bordeaux,2012,31/07/2021,10060452012,1006045
14520,10/06/2021,14270,1,12000,2520,2270,28/05/2020,"Jacques-Frederic Mugnier, Chambolle-Musigny Premier Cru, Les Amoureuses",Burgundy,2014,11/06/2021,10496422014,1049642
2232,10/06/2021,2369,5,2190,42,179,01/05/2021,"Gaja, Barbaresco",Piedmont,2004,11/06/2021,10996052004,1099605
460,10/06/2021,491,179,420,40,71,28/05/2021,"Tua Rita, Giusto di Notri, Toscana",Tuscany,2016,11/06/2021,11058072016,1105807
3800,30/07/2021,4335,54,3605,195,730,26/07/2021,"Chateau Angelus Premier Grand Cru Classe A, Saint-Emilion Grand Cru",Bordeaux,2012,31/07/2021,10060452012,1006045
520,10/06/2021,557,4,460,60,97,05/05/2020,"Tua Rita, Giusto di Notri, Toscana",Tuscany,2008,11/06/2021,11058072008,1105807
1080,10/06/2021,1162,58,1036,44,126,27/05/2021,"Chateau Calon Segur 3eme Cru Classe, Saint-Estephe",Bordeaux,2016,11/06/2021,10074752016,1007475
1350,10/06/2021,1445,7,1352,-2,93,23/09/2020,"Gaja, Barbaresco",Piedmont,2011,11/06/2021,10996052011,1099605
1000,10/06/2021,1053,8,860,140,193,08/03/2021,"Tignanello, Toscana",Tuscany,2011,11/06/2021,10953912011,1095391
1310,09/06/2021,1375,6,1172,138,203,07/04/2021,"Tignanello, Toscana",Tuscany,2010,11/06/2021,10953912010,1095391
6300,10/06/2021,7477,63,6190,110,1287,23/05/2021,"Chateau Margaux Premier Cru Classe, Margaux",Bordeaux,2010,11/06/2021,10127812010,1012781
3800,29/07/2021,4335,54,3605,195,730,26/07/2021,"Chateau Angelus Premier Grand Cru Classe A, Saint-Emilion Grand Cru",Bordeaux,2012,30/07/2021,10060452012,1006045
400,05/07/2021,434,4,320,80,114,09/07/2021,"Chateau Batailley 5eme Cru Classe, Pauillac",Bordeaux,2011,12/07/2021,10063222011,1006322
3800,29/07/2021,4335,54,3605,195,730,26/07/2021,"Chateau Angelus Premier Grand Cru Classe A, Saint-Emilion Grand Cru",Bordeaux,2012,30/07/2021,10060452012,1006045
3800,28/07/2021,4333,55,3605,195,728,26/07/2021,"Chateau Angelus Premier Grand Cru Classe A, Saint-Emilion Grand Cru",Bordeaux,2012,29/07/2021,10060452012,1006045
3750,04/06/2021,4192,40,3560,190,632,20/11/2020,"Chateau Margaux Premier Cru Classe, Margaux",Bordeaux,2012,11/06/2021,10127812012,1012781
3700,10/06/2021,4220,119,3660,40,560,02/06/2021,"Chateau Margaux Premier Cru Classe, Margaux",Bordeaux,2017,11/06/2021,10127812017,1012781
3800,28/07/2021,4333,55,3605,195,728,26/07/2021,"Chateau Angelus Premier Grand Cru Classe A, Saint-Emilion Grand Cru",Bordeaux,2012,29/07/2021,10060452012,1006045
3800,27/07/2021,4275,43,3605,195,670,26/07/2021,"Chateau Angelus Premier Grand Cru Classe A, Saint-Emilion Grand Cru",Bordeaux,2012,28/07/2021,10060452012,1006045
950,10/06/2021,1020,53,863,87,157,10/05/2021,"Chateau Calon Segur 3eme Cru Classe, Saint-Estephe",Bordeaux,2006,11/06/2021,10074752006,1007475
3800,27/07/2021,4275,43,3605,195,670,26/07/2021,"Chateau Angelus Premier Grand Cru Classe A, Saint-Emilion Grand Cru",Bordeaux,2012,28/07/2021,10060452012,1006045
3800,26/07/2021,4275,43,3605,195,670,26/07/2021,"Chateau Angelus Premier Grand Cru Classe A, Saint-Emilion Grand Cru",Bordeaux,2012,27/07/2021,10060452012,1006045
3800,26/07/2021,4275,43,3605,195,670,26/07/2021,"Chateau Angelus Premier Grand Cru Classe A, Saint-Emilion Grand Cru",Bordeaux,2012,27/07/2021,10060452012,1006045
3800,23/07/2021,4240,35,3854,-54,386,21/06/2021,"Chateau Angelus Premier Grand Cru Classe A, Saint-Emilion Grand Cru",Bordeaux,2012,24/07/2021,10060452012,1006045
880,03/06/2021,945,14,781,99,164,16/11/2020,"Chateau Calon Segur 3eme Cru Classe, Saint-Estephe",Bordeaux,2008,11/06/2021,10074752008,1007475
900,04/06/2021,1221,14,850,50,371,28/01/2021,"Tignanello, Toscana",Tuscany,2012,11/06/2021,10953912012,1095391
3800,23/07/2021,4240,35,3854,-54,386,21/06/2021,"Chateau Angelus Premier Grand Cru Classe A, Saint-Emilion Grand Cru",Bordeaux,2012,24/07/2021,10060452012,1006045
1800,10/06/2021,1815,3,1300,500,515,30/05/2019,"Gaja, Barbaresco",Piedmont,2007,11/06/2021,10996052007,1099605
1299,08/06/2021,1493,7,1010,289,483,18/12/2020,"Tignanello, Toscana",Tuscany,2008,11/06/2021,10953912008,1095391
3800,22/07/2021,4240,35,3854,-54,386,21/06/2021,"Chateau Angelus Premier Grand Cru Classe A, Saint-Emilion Grand Cru",Bordeaux,2012,23/07/2021,10060452012,1006045
6250,04/06/2021,7437,49,6776,-526,661,10/06/2021,"Chateau Margaux Premier Cru Classe, Margaux",Bordeaux,2005,11/06/2021,10127812005,1012781
2500,10/06/2021,3334,3,1200,1300,2134,16/05/2012,"Gaja, Barbaresco",Piedmont,2001,11/06/2021,10996052001,1099605
400,05/07/2021,433,4,320,80,113,09/07/2021,"Chateau Batailley 5eme Cru Classe, Pauillac",Bordeaux,2011,13/07/2021,10063222011,1006322
686,10/06/2021,828,13,682,4,146,15/09/2020,"Chateau Calon Segur 3eme Cru Classe, Saint-Estephe",Bordeaux,2013,11/06/2021,10074752013,1007475
907,10/06/2021,957,24,805,102,152,20/11/2019,"Chateau Calon Segur 3eme Cru Classe, Saint-Estephe",Bordeaux,2001,11/06/2021,10074752001,1007475
400,05/07/2021,434,4,320,80,114,09/07/2021,"Chateau Batailley 5eme Cru Classe, Pauillac",Bordeaux,2011,12/07/2021,10063222011,1006322
7906,08/06/2021,7817,2,7124,782,693,15/02/2019,"Domaine Leflaive, Chevalier-Montrachet Grand Cru",Burgundy,2016,11/06/2021,10734012016,1073401
1500,10/06/2021,1682,49,1408,92,274,09/04/2021,"Gaja, Barbaresco",Piedmont,2016,11/06/2021,10996052016,1099605
1150,03/06/2021,1225,11,1202,-52,23,10/05/2021,"Tignanello, Toscana",Tuscany,2015,11/06/2021,10953912015,1095391
3758,10/06/2021,4050,97,3690,68,360,13/04/2021,"Chateau Margaux Premier Cru Classe, Margaux",Bordeaux,2011,11/06/2021,10127812011,1012781
7000,10/05/2021,6201,0,5360,1640,841,18/09/2020,"Domaine Leflaive, Chevalier-Montrachet Grand Cru",Burgundy,2009,11/06/2021,10734012009,1073401
790,03/06/2021,1088,78,860,-70,228,19/04/2021,"Chateau Calon Segur 3eme Cru Classe, Saint-Estephe",Bordeaux,2015,11/06/2021,10074752015,1007475
487,07/06/2021,537,33,320,167,217,24/03/2021,"Tua Rita, Giusto di Notri, Toscana",Tuscany,2017,11/06/2021,11058072017,1105807
3800,22/07/2021,4240,35,3854,-54,386,21/06/2021,"Chateau Angelus Premier Grand Cru Classe A, Saint-Emilion Grand Cru",Bordeaux,2012,23/07/2021,10060452012,1006045
400,05/07/2021,433,4,320,80,113,09/07/2021,"Chateau Batailley 5eme Cru Classe, Pauillac",Bordeaux,2011,13/07/2021,10063222011,1006322
1592,08/06/2021,1523,12,1300,292,223,28/09/2020,"Gaja, Barbaresco",Piedmont,2014,11/06/2021,10996052014,1099605
1000,10/06/2021,1145,83,988,12,157,28/05/2021,"Chateau Calon Segur 3eme Cru Classe, Saint-Estephe",Bordeaux,2005,11/06/2021,10074752005,1007475
3800,21/07/2021,4240,35,3854,-54,386,21/06/2021,"Chateau Angelus Premier Grand Cru Classe A, Saint-Emilion Grand Cru",Bordeaux,2012,22/07/2021,10060452012,1006045
870,10/06/2021,948,10,705,165,243,01/02/2021,"Chateau Calon Segur 3eme Cru Classe, Saint-Estephe",Bordeaux,2002,11/06/2021,10074752002,1007475
660,10/06/2021,726,5,390,270,336,18/08/2017,"Tua Rita, Giusto di Notri, Toscana",Tuscany,2006,11/06/2021,11058072006,1105807
480,04/06/2021,456,106,380,100,76,25/03/2021,"Tua Rita, Giusto di Notri, Toscana",Tuscany,2018,11/06/2021,11058072018,1105807
3560,09/06/2021,4076,32,3592,-32,484,06/05/2021,"Chateau Margaux Premier Cru Classe, Margaux",Bordeaux,2007,11/06/2021,10127812007,1012781
990,10/06/2021,1110,21,1000,-10,110,12/04/2021,"Chateau Calon Segur 3eme Cru Classe, Saint-Estephe",Bordeaux,2010,11/06/2021,10074752010,1007475
760,03/06/2021,921,111,740,20,181,21/05/2021,"Chateau Calon Segur 3eme Cru Classe, Saint-Estephe",Bordeaux,2017,11/06/2021,10074752017,1007475
7800,10/06/2021,8230,8,7330,470,900,02/06/2021,"Domaine Leflaive, Chevalier-Montrachet Grand Cru",Burgundy,2018,11/06/2021,10734012018,1073401
3900,10/06/2021,4422,110,3700,200,722,07/06/2021,"Chateau Margaux Premier Cru Classe, Margaux",Bordeaux,2008,11/06/2021,10127812008,1012781
400,05/07/2021,433,7,355,45,78,15/04/2021,"Chateau Batailley 5eme Cru Classe, Pauillac",Bordeaux,2012,06/07/2021,10063222012,1006322
880,10/06/2021,986,13,725,155,261,13/04/2021,"Chateau Calon Segur 3eme Cru Classe, Saint-Estephe",Bordeaux,2007,11/06/2021,10074752007,1007475
8064,24/05/2021,8064,0,3000,5064,5064,03/08/2011,"Domaine Leflaive, Chevalier-Montrachet Grand Cru",Burgundy,2000,11/06/2021,10734012000,1073401
828,09/06/2021,937,164,800,28,137,05/06/2021,"Tignanello, Toscana",Tuscany,2017,11/06/2021,10953912017,1095391
7800,03/06/2021,6847,2,7900,-100,-1053,29/04/2019,"Domaine Leflaive, Chevalier-Montrachet Grand Cru",Burgundy,2015,11/06/2021,10734012015,1073401
400,05/07/2021,433,7,355,45,78,15/04/2021,"Chateau Batailley 5eme Cru Classe, Pauillac",Bordeaux,2012,06/07/2021,10063222012,1006322
320,05/07/2021,321,110,304,16,17,10/01/2021,"Chateau Batailley 5eme Cru Classe, Pauillac",Bordeaux,2013,06/07/2021,10063222013,1006322
1550,10/06/2021,1557,1,1300,250,257,27/04/2021,"Gaja, Barbaresco",Piedmont,2012,11/06/2021,10996052012,1099605
3740,10/06/2021,3977,53,3520,220,457,07/04/2021,"Chateau Margaux Premier Cru Classe, Margaux",Bordeaux,2013,11/06/2021,10127812013,1012781
2348,10/06/2021,2348,1,2554,-206,-206,22/05/2020,"Gaja, Barbaresco",Piedmont,2006,11/06/2021,10996052006,1099605
8000,10/06/2021,8614,6,6974,1026,1640,14/03/2021,"Domaine Leflaive, Chevalier-Montrachet Grand Cru",Burgundy,2017,11/06/2021,10734012017,1073401
3900,10/06/2021,4610,94,3861,39,749,28/05/2021,"Chateau Margaux Premier Cru Classe, Margaux",Bordeaux,2006,11/06/2021,10127812006,1012781
1350,10/06/2021,1473,61,1260,90,213,18/02/2021,"Gaja, Barbaresco",Piedmont,2015,11/06/2021,10996052015,1099605
790,04/06/2021,902,24,801,-11,101,31/05/2021,"Chateau Calon Segur 3eme Cru Classe, Saint-Estephe",Bordeaux,2014,11/06/2021,10074752014,1007475
10500,10/06/2021,11988,53,9844,656,2144,29/03/2021,"Chateau Margaux Premier Cru Classe, Margaux",Bordeaux,2015,11/06/2021,10127812015,1012781
8098,10/06/2021,9941,3,7290,808,2651,21/08/2020,"Domaine Denis Mortet, Chambertin Grand Cru",Burgundy,2017,11/06/2021,10490202017,1049020
5415,03/06/2021,5689,91,5238,177,451,17/05/2021,"Chateau Margaux Premier Cru Classe, Margaux",Bordeaux,2016,12/06/2021,10127812016,1012781
3800,21/07/2021,4240,35,3854,-54,386,21/06/2021,"Chateau Angelus Premier Grand Cru Classe A, Saint-Emilion Grand Cru",Bordeaux,2012,22/07/2021,10060452012,1006045
3800,20/07/2021,4240,35,3854,-54,386,21/06/2021,"Chateau Angelus Premier Grand Cru Classe A, Saint-Emilion Grand Cru",Bordeaux,2012,21/07/2021,10060452012,1006045
895,03/08/2021,950,9,781,114,169,16/11/2020,"Chateau Calon Segur 3eme Cru Classe, Saint-Estephe",Bordeaux,2008,04/08/2021,10074752008,1007475
880,05/08/2021,967,9,725,155,242,13/04/2021,"Chateau Calon Segur 3eme Cru Classe, Saint-Estephe",Bordeaux,2007,06/08/2021,10074752007,1007475
980,06/08/2021,1164,11,910,70,254,04/08/2021,"Tignanello, Toscana",Tuscany,2012,07/08/2021,10953912012,1095391
3900,06/08/2021,4639,96,3822,78,817,20/06/2021,"Chateau Margaux Premier Cru Classe, Margaux",Bordeaux,2006,07/08/2021,10127812006,1012781
3750,17/06/2021,4056,78,3690,60,366,13/04/2021,"Chateau Margaux Premier Cru Classe, Margaux",Bordeaux,2011,22/06/2021,10127812011,1012781
359,05/07/2021,368,89,324,35,44,09/06/2021,"Chateau Batailley 5eme Cru Classe, Pauillac",Bordeaux,2014,06/07/2021,10063222014,1006322
3826,04/08/2021,4624,44,4116,-290,508,25/02/2021,"Chateau Margaux Premier Cru Classe, Margaux",Bordeaux,2004,05/08/2021,10127812004,1012781
6400,04/08/2021,7596,65,6188,212,1408,16/07/2021,"Chateau Margaux Premier Cru Classe, Margaux",Bordeaux,2010,05/08/2021,10127812010,1012781
1120,26/07/2021,1140,7,952,168,188,04/08/2021,"Tignanello, Toscana",Tuscany,2013,05/08/2021,10953912013,1095391
8300,04/08/2021,9401,16,8200,100,1201,26/07/2021,"Chateau Margaux Premier Cru Classe, Margaux",Bordeaux,2000,05/08/2021,10127812000,1012781
3800,20/07/2021,4240,35,3854,-54,386,21/06/2021,"Chateau Angelus Premier Grand Cru Classe A, Saint-Emilion Grand Cru",Bordeaux,2012,21/07/2021,10060452012,1006045
3800,19/07/2021,4240,35,3854,-54,386,21/06/2021,"Chateau Angelus Premier Grand Cru Classe A, Saint-Emilion Grand Cru",Bordeaux,2012,20/07/2021,10060452012,1006045
476,05/07/2021,520,39,364,112,156,12/05/2021,"Chateau Batailley 5eme Cru Classe, Pauillac",Bordeaux,2016,06/07/2021,10063222016,1006322
660,17/06/2021,726,5,390,270,336,18/08/2017,"Tua Rita, Giusto di Notri, Toscana",Tuscany,2006,18/06/2021,11058072006,1105807
3800,19/07/2021,4240,35,3854,-54,386,21/06/2021,"Chateau Angelus Premier Grand Cru Classe A, Saint-Emilion Grand Cru",Bordeaux,2012,20/07/2021,10060452012,1006045
3800,16/07/2021,4240,35,3854,-54,386,21/06/2021,"Chateau Angelus Premier Grand Cru Classe A, Saint-Emilion Grand Cru",Bordeaux,2012,17/07/2021,10060452012,1006045
7800,17/06/2021,8250,8,7330,470,920,02/06/2021,"Domaine Leflaive, Chevalier-Montrachet Grand Cru",Burgundy,2018,18/06/2021,10734012018,1073401
574,17/06/2021,574,1,351,223,223,25/07/2016,"Tua Rita, Giusto di Notri, Toscana",Tuscany,2004,18/06/2021,11058072004,1105807
3800,16/07/2021,4240,35,3854,-54,386,21/06/2021,"Chateau Angelus Premier Grand Cru Classe A, Saint-Emilion Grand Cru",Bordeaux,2012,17/07/2021,10060452012,1006045
900,11/06/2021,1257,12,850,50,407,28/01/2021,"Tignanello, Toscana",Tuscany,2012,18/06/2021,10953912012,1095391
1050,17/06/2021,1144,6,860,190,284,08/03/2021,"Tignanello, Toscana",Tuscany,2013,18/06/2021,10953912013,1095391
740,17/06/2021,1002,51,790,-50,212,01/06/2020,"Chateau Calon Segur 3eme Cru Classe, Saint-Estephe",Bordeaux,2011,18/06/2021,10074752011,1007475
3800,15/07/2021,4240,35,3854,-54,386,21/06/2021,"Chateau Angelus Premier Grand Cru Classe A, Saint-Emilion Grand Cru",Bordeaux,2012,16/07/2021,10060452012,1006045
1700,17/06/2021,1658,4,1378,322,280,29/07/2020,"Tignanello, Toscana",Tuscany,2001,18/06/2021,10953912001,1095391
17300,17/06/2021,17300,0,6538,10762,10762,05/07/2016,"Jacques-Frederic Mugnier, Chambolle-Musigny Premier Cru, Les Amoureuses",Burgundy,2012,18/06/2021,10496422012,1049642
3560,17/06/2021,4047,33,3592,-32,455,06/05/2021,"Chateau Margaux Premier Cru Classe, Margaux",Bordeaux,2007,18/06/2021,10127812007,1012781
14520,17/06/2021,14520,1,12000,2520,2520,28/05/2020,"Jacques-Frederic Mugnier, Chambolle-Musigny Premier Cru, Les Amoureuses",Burgundy,2014,18/06/2021,10496422014,1049642
450,06/07/2021,521,3,300,150,221,15/12/2019,"Chateau Batailley 5eme Cru Classe, Pauillac",Bordeaux,2004,07/07/2021,10063222004,1006322
1408,17/06/2021,1386,5,1238,170,148,02/11/2020,"Tignanello, Toscana",Tuscany,2006,18/06/2021,10953912006,1095391
6250,17/06/2021,7412,49,6776,-526,636,10/06/2021,"Chateau Margaux Premier Cru Classe, Margaux",Bordeaux,2005,18/06/2021,10127812005,1012781
3800,15/07/2021,4240,35,3854,-54,386,21/06/2021,"Chateau Angelus Premier Grand Cru Classe A, Saint-Emilion Grand Cru",Bordeaux,2012,16/07/2021,10060452012,1006045
1130,16/06/2021,1227,9,1202,-72,25,10/05/2021,"Tignanello, Toscana",Tuscany,2015,18/06/2021,10953912015,1095391
3826,16/06/2021,4517,55,4116,-290,401,25/02/2021,"Chateau Margaux Premier Cru Classe, Margaux",Bordeaux,2004,18/06/2021,10127812004,1012781
857,15/06/2021,949,151,830,27,119,16/06/2021,"Tignanello, Toscana",Tuscany,2017,18/06/2021,10953912017,1095391
400,06/07/2021,433,7,355,45,78,15/04/2021,"Chateau Batailley 5eme Cru Classe, Pauillac",Bordeaux,2012,07/07/2021,10063222012,1006322
460,17/06/2021,492,185,420,40,72,28/05/2021,"Tua Rita, Giusto di Notri, Toscana",Tuscany,2016,18/06/2021,11058072016,1105807
400,06/07/2021,433,7,355,45,78,15/04/2021,"Chateau Batailley 5eme Cru Classe, Pauillac",Bordeaux,2012,07/07/2021,10063222012,1006322
840,17/06/2021,1088,79,860,-20,228,19/04/2021,"Chateau Calon Segur 3eme Cru Classe, Saint-Estephe",Bordeaux,2015,18/06/2021,10074752015,1007475
6099,08/06/2021,6273,1,6500,-401,-227,26/05/2021,"Domaine Leflaive, Chevalier-Montrachet Grand Cru",Burgundy,2011,18/06/2021,10734012011,1073401
10100,11/06/2021,11991,55,9800,300,2191,11/06/2021,"Chateau Margaux Premier Cru Classe, Margaux",Bordeaux,2015,18/06/2021,10127812015,1012781
1300,17/06/2021,1442,7,1352,-52,90,23/09/2020,"Gaja, Barbaresco",Piedmont,2011,18/06/2021,10996052011,1099605
3800,14/07/2021,4240,34,3854,-54,386,21/06/2021,"Chateau Angelus Premier Grand Cru Classe A, Saint-Emilion Grand Cru",Bordeaux,2012,15/07/2021,10060452012,1006045
830,17/06/2021,989,6,735,95,254,09/09/2020,"Chateau Calon Segur 3eme Cru Classe, Saint-Estephe",Bordeaux,2012,18/06/2021,10074752012,1007475
900,17/06/2021,1090,29,800,100,290,21/11/2019,"Chateau Calon Segur 3eme Cru Classe, Saint-Estephe",Bordeaux,2003,18/06/2021,10074752003,1007475
870,17/06/2021,957,8,705,165,252,01/02/2021,"Chateau Calon Segur 3eme Cru Classe, Saint-Estephe",Bordeaux,2002,18/06/2021,10074752002,1007475
3800,14/07/2021,4240,34,3854,-54,386,21/06/2021,"Chateau Angelus Premier Grand Cru Classe A, Saint-Emilion Grand Cru",Bordeaux,2012,15/07/2021,10060452012,1006045
8240,09/06/2021,8720,1,5960,2280,2760,01/08/2017,"Domaine Leflaive, Chevalier-Montrachet Grand Cru",Burgundy,2010,18/06/2021,10734012010,1073401
320,06/07/2021,321,110,304,16,17,10/01/2021,"Chateau Batailley 5eme Cru Classe, Pauillac",Bordeaux,2013,07/07/2021,10063222013,1006322
359,06/07/2021,368,89,324,35,44,09/06/2021,"Chateau Batailley 5eme Cru Classe, Pauillac",Bordeaux,2014,07/07/2021,10063222014,1006322
476,06/07/2021,520,39,364,112,156,12/05/2021,"Chateau Batailley 5eme Cru Classe, Pauillac",Bordeaux,2016,07/07/2021,10063222016,1006322
12700,17/06/2021,12681,1,12850,-150,-169,30/11/2020,"Jacques-Frederic Mugnier, Chambolle-Musigny Premier Cru, Les Amoureuses",Burgundy,2011,18/06/2021,10496422011,1049642
3900,17/06/2021,4608,91,3861,39,747,28/05/2021,"Chateau Margaux Premier Cru Classe, Margaux",Bordeaux,2006,18/06/2021,10127812006,1012781
5490,17/06/2021,5834,104,5254,236,580,26/05/2021,"Chateau Margaux Premier Cru Classe, Margaux",Bordeaux,2018,18/06/2021,10127812018,1012781
3720,17/06/2021,4286,146,3480,240,806,17/06/2021,"Chateau Margaux Premier Cru Classe, Margaux",Bordeaux,2014,18/06/2021,10127812014,1012781
3800,13/07/2021,4240,34,3854,-54,386,21/06/2021,"Chateau Angelus Premier Grand Cru Classe A, Saint-Emilion Grand Cru",Bordeaux,2012,14/07/2021,10060452012,1006045
750,17/06/2021,923,110,740,10,183,21/05/2021,"Chateau Calon Segur 3eme Cru Classe, Saint-Estephe",Bordeaux,2017,18/06/2021,10074752017,1007475
540,17/06/2021,533,3,300,240,233,03/11/2011,"Tua Rita, Giusto di Notri, Toscana",Tuscany,2007,18/06/2021,11058072007,1105807
3750,17/06/2021,4051,95,3690,60,361,13/04/2021,"Chateau Margaux Premier Cru Classe, Margaux",Bordeaux,2011,18/06/2021,10127812011,1012781
4850,11/06/2021,5651,30,4842,8,809,19/05/2021,"Chateau Margaux Premier Cru Classe, Margaux",Bordeaux,2003,18/06/2021,10127812003,1012781
8000,17/06/2021,8639,6,6974,1026,1665,14/03/2021,"Domaine Leflaive, Chevalier-Montrachet Grand Cru",Burgundy,2017,18/06/2021,10734012017,1073401
3800,13/07/2021,4240,34,3854,-54,386,21/06/2021,"Chateau Angelus Premier Grand Cru Classe A, Saint-Emilion Grand Cru",Bordeaux,2012,14/07/2021,10060452012,1006045
1200,17/06/2021,1259,38,1050,150,209,10/06/2021,"Tignanello, Toscana",Tuscany,2016,18/06/2021,10953912016,1095391
950,17/06/2021,1020,53,863,87,157,10/05/2021,"Chateau Calon Segur 3eme Cru Classe, Saint-Estephe",Bordeaux,2006,18/06/2021,10074752006,1007475
4400,17/06/2021,4731,27,4400,0,331,29/09/2020,"Chateau Margaux Premier Cru Classe, Margaux",Bordeaux,2001,18/06/2021,10127812001,1012781
3826,16/06/2021,4525,55,4116,-290,409,25/02/2021,"Chateau Margaux Premier Cru Classe, Margaux",Bordeaux,2004,17/06/2021,10127812004,1012781
857,15/06/2021,946,154,830,27,116,16/06/2021,"Tignanello, Toscana",Tuscany,2017,17/06/2021,10953912017,1095391
3800,12/07/2021,4235,34,3854,-54,381,21/06/2021,"Chateau Angelus Premier Grand Cru Classe A, Saint-Emilion Grand Cru",Bordeaux,2012,13/07/2021,10060452012,1006045
1040,16/06/2021,1212,23,940,100,272,18/03/2021,"Chateau Calon Segur 3eme Cru Classe, Saint-Estephe",Bordeaux,2000,17/06/2021,10074752000,1007475
2098,16/06/2021,2331,5,2190,-92,141,01/05/2021,"Gaja, Barbaresco",Piedmont,2004,17/06/2021,10996052004,1099605
3720,16/06/2021,4290,146,3480,240,810,10/04/2021,"Chateau Margaux Premier Cru Classe, Margaux",Bordeaux,2014,17/06/2021,10127812014,1012781
7800,16/06/2021,8250,8,7330,470,920,02/06/2021,"Domaine Leflaive, Chevalier-Montrachet Grand Cru",Burgundy,2018,17/06/2021,10734012018,1073401
9600,16/06/2021,9798,2,8000,1600,1798,30/01/2020,"Domaine Leflaive, Chevalier-Montrachet Grand Cru",Burgundy,2014,17/06/2021,10734012014,1073401
6557,16/06/2021,6557,0,3920,2637,2637,26/04/2017,"Domaine Leflaive, Chevalier-Montrachet Grand Cru",Burgundy,2006,17/06/2021,10734012006,1073401
3700,16/06/2021,4223,118,3646,54,577,16/06/2021,"Chateau Margaux Premier Cru Classe, Margaux",Bordeaux,2017,17/06/2021,10127812017,1012781
3800,12/07/2021,4235,34,3854,-54,381,21/06/2021,"Chateau Angelus Premier Grand Cru Classe A, Saint-Emilion Grand Cru",Bordeaux,2012,13/07/2021,10060452012,1006045
1550,16/06/2021,1557,1,1300,250,257,27/04/2021,"Gaja, Barbaresco",Piedmont,2012,17/06/2021,10996052012,1099605
1350,16/06/2021,1445,7,1352,-2,93,23/09/2020,"Gaja, Barbaresco",Piedmont,2011,17/06/2021,10996052011,1099605
1800,16/06/2021,1815,3,1300,500,515,30/05/2019,"Gaja, Barbaresco",Piedmont,2007,17/06/2021,10996052007,1099605
1350,16/06/2021,1474,61,1260,90,214,18/02/2021,"Gaja, Barbaresco",Piedmont,2015,17/06/2021,10996052015,1099605
6300,16/06/2021,7464,63,6190,110,1274,23/05/2021,"Chateau Margaux Premier Cru Classe, Margaux",Bordeaux,2010,17/06/2021,10127812010,1012781
1200,16/06/2021,1260,38,1050,150,210,10/06/2021,"Tignanello, Toscana",Tuscany,2016,17/06/2021,10953912016,1095391
685,07/07/2021,886,4,470,215,416,29/03/2018,"Chateau Batailley 5eme Cru Classe, Pauillac",Bordeaux,2000,08/07/2021,10063222000,1006322
3900,16/06/2021,4616,93,3861,39,755,28/05/2021,"Chateau Margaux Premier Cru Classe, Margaux",Bordeaux,2006,17/06/2021,10127812006,1012781
685,07/07/2021,886,4,470,215,416,29/03/2018,"Chateau Batailley 5eme Cru Classe, Pauillac",Bordeaux,2000,08/07/2021,10063222000,1006322
2500,16/06/2021,3208,4,2220,280,988,14/06/2021,"Gaja, Barbaresco",Piedmont,2001,17/06/2021,10996052001,1099605
460,16/06/2021,492,185,420,40,72,28/05/2021,"Tua Rita, Giusto di Notri, Toscana",Tuscany,2016,17/06/2021,11058072016,1105807
3740,16/06/2021,3977,53,3520,220,457,07/04/2021,"Chateau Margaux Premier Cru Classe, Margaux",Bordeaux,2013,17/06/2021,10127812013,1012781
1260,16/06/2021,1375,7,1172,88,203,07/04/2021,"Tignanello, Toscana",Tuscany,2010,17/06/2021,10953912010,1095391
3800,09/07/2021,4232,34,3854,-54,378,21/06/2021,"Chateau Angelus Premier Grand Cru Classe A, Saint-Emilion Grand Cru",Bordeaux,2012,10/07/2021,10060452012,1006045
686,16/06/2021,844,13,682,4,162,15/09/2020,"Chateau Calon Segur 3eme Cru Classe, Saint-Estephe",Bordeaux,2013,17/06/2021,10074752013,1007475
950,16/06/2021,1020,53,863,87,157,10/05/2021,"Chateau Calon Segur 3eme Cru Classe, Saint-Estephe",Bordeaux,2006,17/06/2021,10074752006,1007475
7600,16/06/2021,7792,2,7124,476,668,15/02/2019,"Domaine Leflaive, Chevalier-Montrachet Grand Cru",Burgundy,2016,17/06/2021,10734012016,1073401
10100,11/06/2021,11989,55,9800,300,2189,11/06/2021,"Chateau Margaux Premier Cru Classe, Margaux",Bordeaux,2015,17/06/2021,10127812015,1012781
480,07/07/2021,533,4,465,15,68,04/05/2020,"Chateau Batailley 5eme Cru Classe, Pauillac",Bordeaux,2001,08/07/2021,10063222001,1006322
1000,16/06/2021,1147,82,988,12,159,28/05/2021,"Chateau Calon Segur 3eme Cru Classe, Saint-Estephe",Bordeaux,2005,17/06/2021,10074752005,1007475
3800,09/07/2021,4232,34,3854,-54,378,21/06/2021,"Chateau Angelus Premier Grand Cru Classe A, Saint-Emilion Grand Cru",Bordeaux,2012,10/07/2021,10060452012,1006045
860,15/06/2021,1027,72,940,-80,87,16/06/2021,"Tignanello, Toscana",Tuscany,2018,17/06/2021,10953912018,1095391
870,16/06/2021,945,10,705,165,240,01/02/2021,"Chateau Calon Segur 3eme Cru Classe, Saint-Estephe",Bordeaux,2002,17/06/2021,10074752002,1007475
15600,16/06/2021,15099,6,13000,2600,2099,29/04/2021,"Jacques-Frederic Mugnier, Chambolle-Musigny Premier Cru, Les Amoureuses",Burgundy,2017,17/06/2021,10496422017,1049642
450,07/07/2021,521,3,300,150,221,15/12/2019,"Chateau Batailley 5eme Cru Classe, Pauillac",Bordeaux,2004,08/07/2021,10063222004,1006322
3700,08/07/2021,4230,34,3854,-154,376,21/06/2021,"Chateau Angelus Premier Grand Cru Classe A, Saint-Emilion Grand Cru",Bordeaux,2012,09/07/2021,10060452012,1006045
3700,08/07/2021,4230,34,3854,-154,376,21/06/2021,"Chateau Angelus Premier Grand Cru Classe A, Saint-Emilion Grand Cru",Bordeaux,2012,09/07/2021,10060452012,1006045
907,16/06/2021,957,24,805,102,152,20/11/2019,"Chateau Calon Segur 3eme Cru Classe, Saint-Estephe",Bordeaux,2001,17/06/2021,10074752001,1007475
3650,07/07/2021,4314,46,3854,-204,460,21/06/2021,"Chateau Angelus Premier Grand Cru Classe A, Saint-Emilion Grand Cru",Bordeaux,2012,08/07/2021,10060452012,1006045
1130,16/06/2021,1223,9,1202,-72,21,10/05/2021,"Tignanello, Toscana",Tuscany,2015,17/06/2021,10953912015,1095391
3758,16/06/2021,4049,97,3690,68,359,13/04/2021,"Chateau Margaux Premier Cru Classe, Margaux",Bordeaux,2011,17/06/2021,10127812011,1012781
1299,15/06/2021,1480,8,1010,289,470,18/12/2020,"Tignanello, Toscana",Tuscany,2008,17/06/2021,10953912008,1095391
530,07/07/2021,622,49,520,10,102,17/06/2021,"Chateau Batailley 5eme Cru Classe, Pauillac",Bordeaux,2005,08/07/2021,10063222005,1006322
880,16/06/2021,986,13,725,155,261,13/04/2021,"Chateau Calon Segur 3eme Cru Classe, Saint-Estephe",Bordeaux,2007,17/06/2021,10074752007,1007475
3650,07/07/2021,4314,46,3854,-204,460,21/06/2021,"Chateau Angelus Premier Grand Cru Classe A, Saint-Emilion Grand Cru",Bordeaux,2012,08/07/2021,10060452012,1006045
3900,16/06/2021,4428,110,3700,200,728,07/06/2021,"Chateau Margaux Premier Cru Classe, Margaux",Bordeaux,2008,17/06/2021,10127812008,1012781
530,07/07/2021,622,49,520,10,102,17/06/2021,"Chateau Batailley 5eme Cru Classe, Pauillac",Bordeaux,2005,08/07/2021,10063222005,1006322
880,03/06/2021,1103,42,830,50,273,18/04/2021,"Tignanello, Toscana",Tuscany,2014,17/06/2021,10953912014,1095391
3800,06/07/2021,4328,45,3854,-54,474,21/06/2021,"Chateau Angelus Premier Grand Cru Classe A, Saint-Emilion Grand Cru",Bordeaux,2012,07/07/2021,10060452012,1006045
1100,14/06/2021,1162,58,1036,64,126,27/05/2021,"Chateau Calon Segur 3eme Cru Classe, Saint-Estephe",Bordeaux,2016,17/06/2021,10074752016,1007475
8000,16/06/2021,8639,6,6974,1026,1665,14/03/2021,"Domaine Leflaive, Chevalier-Montrachet Grand Cru",Burgundy,2017,17/06/2021,10734012017,1073401
3800,06/07/2021,4328,45,3854,-54,474,21/06/2021,"Chateau Angelus Premier Grand Cru Classe A, Saint-Emilion Grand Cru",Bordeaux,2012,07/07/2021,10060452012,1006045
6250,16/06/2021,7421,48,6776,-526,645,10/06/2021,"Chateau Margaux Premier Cru Classe, Margaux",Bordeaux,2005,17/06/2021,10127812005,1012781
3800,05/07/2021,4328,45,3854,-54,474,21/06/2021,"Chateau Angelus Premier Grand Cru Classe A, Saint-Emilion Grand Cru",Bordeaux,2012,06/07/2021,10060452012,1006045
14520,16/06/2021,14270,1,12000,2520,2270,28/05/2020,"Jacques-Frederic Mugnier, Chambolle-Musigny Premier Cru, Les Amoureuses",Burgundy,2014,17/06/2021,10496422014,1049642
4400,03/06/2021,4731,27,4400,0,331,29/09/2020,"Chateau Margaux Premier Cru Classe, Margaux",Bordeaux,2001,17/06/2021,10127812001,1012781
660,16/06/2021,726,5,390,270,336,18/08/2017,"Tua Rita, Giusto di Notri, Toscana",Tuscany,2006,17/06/2021,11058072006,1105807
3800,05/07/2021,4328,45,3854,-54,474,21/06/2021,"Chateau Angelus Premier Grand Cru Classe A, Saint-Emilion Grand Cru",Bordeaux,2012,06/07/2021,10060452012,1006045
990,16/06/2021,1109,20,990,0,119,16/06/2021,"Chateau Calon Segur 3eme Cru Classe, Saint-Estephe",Bordeaux,2010,17/06/2021,10074752010,1007475
420,07/07/2021,445,3,400,20,45,11/05/2021,"Chateau Batailley 5eme Cru Classe, Pauillac",Bordeaux,2006,08/07/2021,10063222006,1006322
1408,06/07/2021,1729,2,1150,258,579,21/04/2019,"Tignanello, Toscana",Tuscany,2005,07/08/2021,10953912005,1095391
1584,06/08/2021,1670,4,1378,206,292,29/07/2020,"Tignanello, Toscana",Tuscany,2001,07/08/2021,10953912001,1095391
3900,18/06/2021,4226,75,3700,200,526,07/06/2021,"Chateau Margaux Premier Cru Classe, Margaux",Bordeaux,2008,19/06/2021,10127812008,1012781
6830,17/06/2021,7680,47,7086,-256,594,11/06/2021,"Chateau Margaux Premier Cru Classe, Margaux",Bordeaux,2009,19/06/2021,10127812009,1012781
6400,18/06/2021,7375,43,6776,-376,599,10/06/2021,"Chateau Margaux Premier Cru Classe, Margaux",Bordeaux,2005,19/06/2021,10127812005,1012781
3900,18/06/2021,4607,88,3861,39,746,28/05/2021,"Chateau Margaux Premier Cru Classe, Margaux",Bordeaux,2006,19/06/2021,10127812006,1012781
990,18/06/2021,1107,20,990,0,117,16/06/2021,"Chateau Calon Segur 3eme Cru Classe, Saint-Estephe",Bordeaux,2010,19/06/2021,10074752010,1007475
3800,02/07/2021,4343,52,3854,-54,489,21/06/2021,"Chateau Angelus Premier Grand Cru Classe A, Saint-Emilion Grand Cru",Bordeaux,2012,03/07/2021,10060452012,1006045
420,07/07/2021,445,3,400,20,45,11/05/2021,"Chateau Batailley 5eme Cru Classe, Pauillac",Bordeaux,2006,08/07/2021,10063222006,1006322
450,07/07/2021,445,4,332,118,113,06/10/2020,"Chateau Batailley 5eme Cru Classe, Pauillac",Bordeaux,2008,08/07/2021,10063222008,1006322
3800,02/07/2021,4326,44,3854,-54,472,21/06/2021,"Chateau Angelus Premier Grand Cru Classe A, Saint-Emilion Grand Cru",Bordeaux,2012,04/07/2021,10060452012,1006045
840,17/06/2021,1090,77,860,-20,230,19/04/2021,"Chateau Calon Segur 3eme Cru Classe, Saint-Estephe",Bordeaux,2015,19/06/2021,10074752015,1007475
870,18/06/2021,935,5,705,165,230,01/02/2021,"Chateau Calon Segur 3eme Cru Classe, Saint-Estephe",Bordeaux,2002,19/06/2021,10074752002,1007475
460,18/06/2021,492,185,420,40,72,28/05/2021,"Tua Rita, Giusto di Notri, Toscana",Tuscany,2016,19/06/2021,11058072016,1105807
1080,18/06/2021,1223,48,950,130,273,03/05/2021,"Chateau Calon Segur 3eme Cru Classe, Saint-Estephe",Bordeaux,2018,19/06/2021,10074752018,1007475
1500,18/06/2021,1681,49,1408,92,273,09/04/2021,"Gaja, Barbaresco",Piedmont,2016,19/06/2021,10996052016,1099605
17300,17/06/2021,16710,0,6538,10762,10172,05/07/2016,"Jacques-Frederic Mugnier, Chambolle-Musigny Premier Cru, Les Amoureuses",Burgundy,2012,19/06/2021,10496422012,1049642
1570,15/06/2021,1352,4,1200,370,152,06/03/2021,"Tignanello, Toscana",Tuscany,2007,19/06/2021,10953912007,1095391
14520,18/06/2021,14520,1,12000,2520,2520,28/05/2020,"Jacques-Frederic Mugnier, Chambolle-Musigny Premier Cru, Les Amoureuses",Burgundy,2014,19/06/2021,10496422014,1049642
3700,18/06/2021,4224,116,3646,54,578,16/06/2021,"Chateau Margaux Premier Cru Classe, Margaux",Bordeaux,2017,19/06/2021,10127812017,1012781
1800,18/06/2021,1841,2,1300,500,541,30/05/2019,"Gaja, Barbaresco",Piedmont,2007,19/06/2021,10996052007,1099605
3800,02/07/2021,4343,52,3854,-54,489,21/06/2021,"Chateau Angelus Premier Grand Cru Classe A, Saint-Emilion Grand Cru",Bordeaux,2012,03/07/2021,10060452012,1006045
1350,18/06/2021,1474,61,1260,90,214,18/02/2021,"Gaja, Barbaresco",Piedmont,2015,19/06/2021,10996052015,1099605
3800,02/07/2021,4326,44,3854,-54,472,21/06/2021,"Chateau Angelus Premier Grand Cru Classe A, Saint-Emilion Grand Cru",Bordeaux,2012,04/07/2021,10060452012,1006045
1100,17/06/2021,1154,37,1030,70,124,25/05/2021,"Chateau Calon Segur 3eme Cru Classe, Saint-Estephe",Bordeaux,2009,19/06/2021,10074752009,1007475
5800,09/06/2021,6623,0,4400,1400,2223,06/11/2017,"Domaine Leflaive, Chevalier-Montrachet Grand Cru",Burgundy,2013,19/06/2021,10734012013,1073401
3800,01/07/2021,4343,52,3854,-54,489,21/06/2021,"Chateau Angelus Premier Grand Cru Classe A, Saint-Emilion Grand Cru",Bordeaux,2012,02/07/2021,10060452012,1006045
3800,01/07/2021,4343,52,3854,-54,489,21/06/2021,"Chateau Angelus Premier Grand Cru Classe A, Saint-Emilion Grand Cru",Bordeaux,2012,02/07/2021,10060452012,1006045
740,17/06/2021,987,40,790,-50,197,01/06/2020,"Chateau Calon Segur 3eme Cru Classe, Saint-Estephe",Bordeaux,2011,19/06/2021,10074752011,1007475
3800,30/06/2021,4338,53,3854,-54,484,21/06/2021,"Chateau Angelus Premier Grand Cru Classe A, Saint-Emilion Grand Cru",Bordeaux,2012,01/07/2021,10060452012,1006045
3900,17/06/2021,4474,28,3684,216,790,10/06/2020,"Chateau Margaux Premier Cru Classe, Margaux",Bordeaux,2002,19/06/2021,10127812002,1012781
6557,18/06/2021,6557,0,3920,2637,2637,26/04/2017,"Domaine Leflaive, Chevalier-Montrachet Grand Cru",Burgundy,2006,19/06/2021,10734012006,1073401
3800,30/06/2021,4338,53,3854,-54,484,21/06/2021,"Chateau Angelus Premier Grand Cru Classe A, Saint-Emilion Grand Cru",Bordeaux,2012,01/07/2021,10060452012,1006045
790,18/06/2021,904,22,801,-11,103,31/05/2021,"Chateau Calon Segur 3eme Cru Classe, Saint-Estephe",Bordeaux,2014,19/06/2021,10074752014,1007475
3740,18/06/2021,3975,54,3520,220,455,07/04/2021,"Chateau Margaux Premier Cru Classe, Margaux",Bordeaux,2013,19/06/2021,10127812013,1012781
2500,18/06/2021,3158,4,2220,280,938,14/06/2021,"Gaja, Barbaresco",Piedmont,2001,19/06/2021,10996052001,1099605
1408,17/06/2021,1385,5,1238,170,147,02/11/2020,"Tignanello, Toscana",Tuscany,2006,19/06/2021,10953912006,1095391
1550,18/06/2021,1557,1,1300,250,257,27/04/2021,"Gaja, Barbaresco",Piedmont,2012,19/06/2021,10996052012,1099605
1000,18/06/2021,1143,78,988,12,155,28/05/2021,"Chateau Calon Segur 3eme Cru Classe, Saint-Estephe",Bordeaux,2005,19/06/2021,10074752005,1007475
3800,29/06/2021,4338,53,3854,-54,484,21/06/2021,"Chateau Angelus Premier Grand Cru Classe A, Saint-Emilion Grand Cru",Bordeaux,2012,30/06/2021,10060452012,1006045
9600,18/06/2021,9798,2,8000,1600,1798,30/01/2020,"Domaine Leflaive, Chevalier-Montrachet Grand Cru",Burgundy,2014,19/06/2021,10734012014,1073401
510,07/07/2021,596,396,494,16,102,20/04/2021,"Chateau Batailley 5eme Cru Classe, Pauillac",Bordeaux,2010,08/07/2021,10063222010,1006322
3800,29/06/2021,4338,53,3854,-54,484,21/06/2021,"Chateau Angelus Premier Grand Cru Classe A, Saint-Emilion Grand Cru",Bordeaux,2012,30/06/2021,10060452012,1006045
830,17/06/2021,966,5,735,95,231,09/09/2020,"Chateau Calon Segur 3eme Cru Classe, Saint-Estephe",Bordeaux,2012,19/06/2021,10074752012,1007475
10500,18/06/2021,11892,55,9800,700,2092,11/06/2021,"Chateau Margaux Premier Cru Classe, Margaux",Bordeaux,2015,19/06/2021,10127812015,1012781
5380,18/06/2021,5045,8,4160,1220,885,19/03/2021,"Chateau Margaux Premier Cru Classe, Margaux",Bordeaux,2019,19/06/2021,10127812019,1012781
1408,15/06/2021,1370,1,1150,258,220,21/04/2019,"Tignanello, Toscana",Tuscany,2005,18/06/2021,10953912005,1095391
510,07/07/2021,596,396,494,16,102,20/04/2021,"Chateau Batailley 5eme Cru Classe, Pauillac",Bordeaux,2010,08/07/2021,10063222010,1006322
8100,17/06/2021,8478,19,7950,150,528,12/03/2021,"Chateau Margaux Premier Cru Classe, Margaux",Bordeaux,2000,18/06/2021,10127812000,1012781
360,07/07/2021,423,8,355,5,68,15/04/2021,"Chateau Batailley 5eme Cru Classe, Pauillac",Bordeaux,2012,08/07/2021,10063222012,1006322
1040,16/06/2021,1204,22,940,100,264,18/03/2021,"Chateau Calon Segur 3eme Cru Classe, Saint-Estephe",Bordeaux,2000,18/06/2021,10074752000,1007475
1765,17/06/2021,1948,2,1768,-3,180,22/05/2020,"Gaja, Barbaresco",Piedmont,2000,18/06/2021,10996052000,1099605
2500,17/06/2021,3208,4,2220,280,988,14/06/2021,"Gaja, Barbaresco",Piedmont,2001,18/06/2021,10996052001,1099605
9600,17/06/2021,9798,2,8000,1600,1798,30/01/2020,"Domaine Leflaive, Chevalier-Montrachet Grand Cru",Burgundy,2014,18/06/2021,10734012014,1073401
2098,17/06/2021,2331,5,2190,-92,141,01/05/2021,"Gaja, Barbaresco",Piedmont,2004,18/06/2021,10996052004,1099605
750,17/06/2021,945,26,745,5,200,16/11/2020,"Chateau Calon Segur 3eme Cru Classe, Saint-Estephe",Bordeaux,2004,18/06/2021,10074752004,1007475
840,09/06/2021,1129,22,842,-2,287,22/08/2020,"Chateau Calon Segur 3eme Cru Classe, Saint-Estephe",Bordeaux,2019,18/06/2021,10074752019,1007475
7600,17/06/2021,7792,2,7124,476,668,15/02/2019,"Domaine Leflaive, Chevalier-Montrachet Grand Cru",Burgundy,2016,18/06/2021,10734012016,1073401
3800,28/06/2021,4338,53,3854,-54,484,21/06/2021,"Chateau Angelus Premier Grand Cru Classe A, Saint-Emilion Grand Cru",Bordeaux,2012,29/06/2021,10060452012,1006045
3800,28/06/2021,4338,53,3854,-54,484,21/06/2021,"Chateau Angelus Premier Grand Cru Classe A, Saint-Emilion Grand Cru",Bordeaux,2012,29/06/2021,10060452012,1006045
2199,17/06/2021,2219,3,1340,859,879,13/03/2020,"Gaja, Barbaresco",Piedmont,2009,18/06/2021,10996052009,1099605
1000,17/06/2021,1147,82,988,12,159,28/05/2021,"Chateau Calon Segur 3eme Cru Classe, Saint-Estephe",Bordeaux,2005,18/06/2021,10074752005,1007475
360,07/07/2021,427,7,355,5,72,15/04/2021,"Chateau Batailley 5eme Cru Classe, Pauillac",Bordeaux,2012,09/07/2021,10063222012,1006322
686,17/06/2021,852,11,682,4,170,15/09/2020,"Chateau Calon Segur 3eme Cru Classe, Saint-Estephe",Bordeaux,2013,18/06/2021,10074752013,1007475
3800,25/06/2021,4343,53,3854,-54,489,21/06/2021,"Chateau Angelus Premier Grand Cru Classe A, Saint-Emilion Grand Cru",Bordeaux,2012,28/06/2021,10060452012,1006045
1024,17/06/2021,1213,6,1072,-48,141,20/01/2021,"Tignanello, Toscana",Tuscany,2009,18/06/2021,10953912009,1095391
990,17/06/2021,1109,20,990,0,119,16/06/2021,"Chateau Calon Segur 3eme Cru Classe, Saint-Estephe",Bordeaux,2010,18/06/2021,10074752010,1007475
940,17/06/2021,1106,42,830,110,276,18/04/2021,"Tignanello, Toscana",Tuscany,2014,18/06/2021,10953912014,1095391
3900,17/06/2021,4421,111,3700,200,721,07/06/2021,"Chateau Margaux Premier Cru Classe, Margaux",Bordeaux,2008,18/06/2021,10127812008,1012781
1100,17/06/2021,1177,44,1030,70,147,25/05/2021,"Chateau Calon Segur 3eme Cru Classe, Saint-Estephe",Bordeaux,2009,18/06/2021,10074752009,1007475
1080,17/06/2021,1222,48,950,130,272,03/05/2021,"Chateau Calon Segur 3eme Cru Classe, Saint-Estephe",Bordeaux,2018,18/06/2021,10074752018,1007475
6450,17/06/2021,7447,63,6190,260,1257,23/05/2021,"Chateau Margaux Premier Cru Classe, Margaux",Bordeaux,2010,18/06/2021,10127812010,1012781
360,07/07/2021,423,8,355,5,68,15/04/2021,"Chateau Batailley 5eme Cru Classe, Pauillac",Bordeaux,2012,08/07/2021,10063222012,1006322
10650,17/06/2021,10048,1,4000,6650,6048,25/04/2016,"Domaine Denis Mortet, Chambertin Grand Cru",Burgundy,2013,18/06/2021,10490202013,1049020
880,17/06/2021,986,13,725,155,261,13/04/2021,"Chateau Calon Segur 3eme Cru Classe, Saint-Estephe",Bordeaux,2007,18/06/2021,10074752007,1007475
860,17/06/2021,1027,72,896,-36,131,17/06/2021,"Tignanello, Toscana",Tuscany,2018,18/06/2021,10953912018,1095391
3900,17/06/2021,4472,28,3684,216,788,10/06/2020,"Chateau Margaux Premier Cru Classe, Margaux",Bordeaux,2002,18/06/2021,10127812002,1012781
3740,17/06/2021,3975,54,3520,220,455,07/04/2021,"Chateau Margaux Premier Cru Classe, Margaux",Bordeaux,2013,18/06/2021,10127812013,1012781
880,17/06/2021,975,11,781,99,194,16/11/2020,"Chateau Calon Segur 3eme Cru Classe, Saint-Estephe",Bordeaux,2008,18/06/2021,10074752008,1007475
5578,17/06/2021,5680,98,5238,340,442,17/05/2021,"Chateau Margaux Premier Cru Classe, Margaux",Bordeaux,2016,18/06/2021,10127812016,1012781
1000,17/06/2021,1053,8,860,140,193,08/03/2021,"Tignanello, Toscana",Tuscany,2011,18/06/2021,10953912011,1095391
3800,25/06/2021,4343,53,3854,-54,489,21/06/2021,"Chateau Angelus Premier Grand Cru Classe A, Saint-Emilion Grand Cru",Bordeaux,2012,28/06/2021,10060452012,1006045
1550,17/06/2021,1557,1,1300,250,257,27/04/2021,"Gaja, Barbaresco",Piedmont,2012,18/06/2021,10996052012,1099605
3800,25/06/2021,4333,54,3854,-54,479,21/06/2021,"Chateau Angelus Premier Grand Cru Classe A, Saint-Emilion Grand Cru",Bordeaux,2012,26/06/2021,10060452012,1006045
360,07/07/2021,427,7,355,5,72,15/04/2021,"Chateau Batailley 5eme Cru Classe, Pauillac",Bordeaux,2012,09/07/2021,10063222012,1006322
1310,17/06/2021,1378,7,1172,138,206,07/04/2021,"Tignanello, Toscana",Tuscany,2010,18/06/2021,10953912010,1095391
3800,25/06/2021,4333,54,3854,-54,479,21/06/2021,"Chateau Angelus Premier Grand Cru Classe A, Saint-Emilion Grand Cru",Bordeaux,2012,26/06/2021,10060452012,1006045
860,17/06/2021,1032,69,896,-36,136,17/06/2021,"Tignanello, Toscana",Tuscany,2018,19/06/2021,10953912018,1095391
475,08/06/2021,541,21,388,87,153,29/09/2020,"Tua Rita, Giusto di Notri, Toscana",Tuscany,2015,19/06/2021,11058072015,1105807
1100,14/06/2021,1216,69,1036,64,180,27/05/2021,"Chateau Calon Segur 3eme Cru Classe, Saint-Estephe",Bordeaux,2016,19/06/2021,10074752016,1007475
1516,15/06/2021,1558,172,1358,158,200,12/05/2021,"Gaja, Barbaresco",Piedmont,2017,19/06/2021,10996052017,1099605
3900,04/08/2021,4639,96,3822,78,817,20/06/2021,"Chateau Margaux Premier Cru Classe, Margaux",Bordeaux,2006,05/08/2021,10127812006,1012781
5490,17/06/2021,5831,99,5254,236,577,26/05/2021,"Chateau Margaux Premier Cru Classe, Margaux",Bordeaux,2018,19/06/2021,10127812018,1012781
5578,17/06/2021,5823,106,5238,340,585,17/05/2021,"Chateau Margaux Premier Cru Classe, Margaux",Bordeaux,2016,19/06/2021,10127812016,1012781
574,18/06/2021,574,1,351,223,223,25/07/2016,"Tua Rita, Giusto di Notri, Toscana",Tuscany,2004,19/06/2021,11058072004,1105807
6396,27/05/2021,7088,1,7900,-1504,-812,29/04/2019,"Domaine Leflaive, Chevalier-Montrachet Grand Cru",Burgundy,2015,19/06/2021,10734012015,1073401
880,17/06/2021,967,9,725,155,242,13/04/2021,"Chateau Calon Segur 3eme Cru Classe, Saint-Estephe",Bordeaux,2007,19/06/2021,10074752007,1007475
3800,24/06/2021,4333,54,3854,-54,479,21/06/2021,"Chateau Angelus Premier Grand Cru Classe A, Saint-Emilion Grand Cru",Bordeaux,2012,25/06/2021,10060452012,1006045
3800,24/06/2021,4333,54,3854,-54,479,21/06/2021,"Chateau Angelus Premier Grand Cru Classe A, Saint-Emilion Grand Cru",Bordeaux,2012,25/06/2021,10060452012,1006045
8000,18/06/2021,8689,5,6974,1026,1715,14/03/2021,"Domaine Leflaive, Chevalier-Montrachet Grand Cru",Burgundy,2017,19/06/2021,10734012017,1073401
3800,23/06/2021,4333,54,3854,-54,479,21/06/2021,"Chateau Angelus Premier Grand Cru Classe A, Saint-Emilion Grand Cru",Bordeaux,2012,24/06/2021,10060452012,1006045
3800,23/06/2021,4333,54,3854,-54,479,21/06/2021,"Chateau Angelus Premier Grand Cru Classe A, Saint-Emilion Grand Cru",Bordeaux,2012,24/06/2021,10060452012,1006045
360,07/07/2021,427,7,400,-40,27,09/07/2021,"Chateau Batailley 5eme Cru Classe, Pauillac",Bordeaux,2012,10/07/2021,10063222012,1006322
1300,18/06/2021,1439,8,1352,-52,87,23/09/2020,"Gaja, Barbaresco",Piedmont,2011,19/06/2021,10996052011,1099605
3750,17/06/2021,4034,90,3690,60,344,13/04/2021,"Chateau Margaux Premier Cru Classe, Margaux",Bordeaux,2011,19/06/2021,10127812011,1012781
3800,22/06/2021,4333,54,3854,-54,479,21/06/2021,"Chateau Angelus Premier Grand Cru Classe A, Saint-Emilion Grand Cru",Bordeaux,2012,23/06/2021,10060452012,1006045
907,18/06/2021,957,24,805,102,152,20/11/2019,"Chateau Calon Segur 3eme Cru Classe, Saint-Estephe",Bordeaux,2001,19/06/2021,10074752001,1007475
1299,15/06/2021,1445,8,1010,289,435,18/12/2020,"Tignanello, Toscana",Tuscany,2008,19/06/2021,10953912008,1095391
1765,18/06/2021,1948,2,1768,-3,180,22/05/2020,"Gaja, Barbaresco",Piedmont,2000,19/06/2021,10996052000,1099605
3800,22/06/2021,4333,54,3854,-54,479,21/06/2021,"Chateau Angelus Premier Grand Cru Classe A, Saint-Emilion Grand Cru",Bordeaux,2012,23/06/2021,10060452012,1006045
750,17/06/2021,933,23,745,5,188,16/11/2020,"Chateau Calon Segur 3eme Cru Classe, Saint-Estephe",Bordeaux,2004,19/06/2021,10074752004,1007475
660,18/06/2021,727,5,390,270,337,18/08/2017,"Tua Rita, Giusto di Notri, Toscana",Tuscany,2006,19/06/2021,11058072006,1105807
2098,18/06/2021,2331,5,2190,-92,141,01/05/2021,"Gaja, Barbaresco",Piedmont,2004,19/06/2021,10996052004,1099605
686,18/06/2021,855,10,682,4,173,15/09/2020,"Chateau Calon Segur 3eme Cru Classe, Saint-Estephe",Bordeaux,2013,19/06/2021,10074752013,1007475
6450,17/06/2021,7403,58,6190,260,1213,23/05/2021,"Chateau Margaux Premier Cru Classe, Margaux",Bordeaux,2010,19/06/2021,10127812010,1012781
15600,16/06/2021,15193,6,13000,2600,2193,29/04/2021,"Jacques-Frederic Mugnier, Chambolle-Musigny Premier Cru, Les Amoureuses",Burgundy,2017,19/06/2021,10496422017,1049642
920,08/06/2021,1238,15,850,70,388,28/01/2021,"Tignanello, Toscana",Tuscany,2012,19/06/2021,10953912012,1095391
3560,17/06/2021,4032,32,3525,35,507,18/06/2021,"Chateau Margaux Premier Cru Classe, Margaux",Bordeaux,2007,19/06/2021,10127812007,1012781
3800,21/06/2021,4321,52,3854,-54,467,21/06/2021,"Chateau Angelus Premier Grand Cru Classe A, Saint-Emilion Grand Cru",Bordeaux,2012,22/06/2021,10060452012,1006045
1800,18/06/2021,1691,2,1440,360,251,04/01/2018,"Gaja, Barbaresco",Piedmont,2010,19/06/2021,10996052010,1099605
7800,18/06/2021,8268,6,7330,470,938,02/06/2021,"Domaine Leflaive, Chevalier-Montrachet Grand Cru",Burgundy,2018,19/06/2021,10734012018,1073401
360,07/07/2021,427,7,400,-40,27,09/07/2021,"Chateau Batailley 5eme Cru Classe, Pauillac",Bordeaux,2012,10/07/2021,10063222012,1006322
1390,09/06/2021,1535,14,1276,114,259,05/03/2021,"Gaja, Barbaresco",Piedmont,2013,19/06/2021,10996052013,1099605
360,07/07/2021,426,6,400,-40,26,09/07/2021,"Chateau Batailley 5eme Cru Classe, Pauillac",Bordeaux,2012,13/07/2021,10063222012,1006322
4850,18/06/2021,5651,30,4842,8,809,19/05/2021,"Chateau Margaux Premier Cru Classe, Margaux",Bordeaux,2003,19/06/2021,10127812003,1012781
7812,18/06/2021,7812,0,8540,-728,-728,02/12/2019,"Domaine Leflaive, Chevalier-Montrachet Grand Cru",Burgundy,2001,19/06/2021,10734012001,1073401
1223,07/06/2021,1267,37,1050,173,217,10/06/2021,"Tignanello, Toscana",Tuscany,2016,19/06/2021,10953912016,1095391
857,15/06/2021,923,150,830,27,93,16/06/2021,"Tignanello, Toscana",Tuscany,2017,19/06/2021,10953912017,1095391
7600,18/06/2021,7792,2,7124,476,668,15/02/2019,"Domaine Leflaive, Chevalier-Montrachet Grand Cru",Burgundy,2016,19/06/2021,10734012016,1073401
950,17/06/2021,1019,52,863,87,156,10/05/2021,"Chateau Calon Segur 3eme Cru Classe, Saint-Estephe",Bordeaux,2006,19/06/2021,10074752006,1007475
3800,21/06/2021,4321,52,3854,-54,467,21/06/2021,"Chateau Angelus Premier Grand Cru Classe A, Saint-Emilion Grand Cru",Bordeaux,2012,22/06/2021,10060452012,1006045
360,07/07/2021,426,6,400,-40,26,09/07/2021,"Chateau Batailley 5eme Cru Classe, Pauillac",Bordeaux,2012,13/07/2021,10063222012,1006322
8300,02/08/2021,9343,17,8200,100,1143,26/07/2021,"Chateau Margaux Premier Cru Classe, Margaux",Bordeaux,2000,04/08/2021,10127812000,1012781
990,05/08/2021,1177,63,1029,-39,148,21/07/2021,"Chateau Calon Segur 3eme Cru Classe, Saint-Estephe",Bordeaux,2005,06/08/2021,10074752005,1007475
1800,18/06/2021,1810,2,1300,500,510,30/05/2019,"Gaja, Barbaresco",Piedmont,2007,20/06/2021,10996052007,1099605
3800,18/06/2021,4321,52,3854,-54,467,11/05/2021,"Chateau Angelus Premier Grand Cru Classe A, Saint-Emilion Grand Cru",Bordeaux,2012,19/06/2021,10060452012,1006045
320,07/07/2021,321,110,304,16,17,10/01/2021,"Chateau Batailley 5eme Cru Classe, Pauillac",Bordeaux,2013,08/07/2021,10063222013,1006322
3900,18/06/2021,4224,72,3700,200,524,07/06/2021,"Chateau Margaux Premier Cru Classe, Margaux",Bordeaux,2008,20/06/2021,10127812008,1012781
1570,15/06/2021,1321,3,1200,370,121,06/03/2021,"Tignanello, Toscana",Tuscany,2007,20/06/2021,10953912007,1095391
359,07/07/2021,368,89,324,35,44,09/06/2021,"Chateau Batailley 5eme Cru Classe, Pauillac",Bordeaux,2014,08/07/2021,10063222014,1006322
3800,18/06/2021,4321,52,3854,-54,467,11/05/2021,"Chateau Angelus Premier Grand Cru Classe A, Saint-Emilion Grand Cru",Bordeaux,2012,19/06/2021,10060452012,1006045
8100,17/06/2021,8466,17,7950,150,516,12/03/2021,"Chateau Margaux Premier Cru Classe, Margaux",Bordeaux,2000,20/06/2021,10127812000,1012781
3900,17/06/2021,4475,27,3684,216,791,10/06/2020,"Chateau Margaux Premier Cru Classe, Margaux",Bordeaux,2002,20/06/2021,10127812002,1012781
3800,17/06/2021,4321,52,3854,-54,467,11/05/2021,"Chateau Angelus Premier Grand Cru Classe A, Saint-Emilion Grand Cru",Bordeaux,2012,18/06/2021,10060452012,1006045
2500,18/06/2021,2636,2,2220,280,416,14/06/2021,"Gaja, Barbaresco",Piedmont,2001,20/06/2021,10996052001,1099605
1100,17/06/2021,1153,33,1030,70,123,25/05/2021,"Chateau Calon Segur 3eme Cru Classe, Saint-Estephe",Bordeaux,2009,20/06/2021,10074752009,1007475
1024,17/06/2021,1207,5,1072,-48,135,20/01/2021,"Tignanello, Toscana",Tuscany,2009,20/06/2021,10953912009,1095391
476,07/07/2021,520,39,364,112,156,12/05/2021,"Chateau Batailley 5eme Cru Classe, Pauillac",Bordeaux,2016,08/07/2021,10063222016,1006322
2098,18/06/2021,2345,5,2190,-92,155,01/05/2021,"Gaja, Barbaresco",Piedmont,2004,20/06/2021,10996052004,1099605
3750,17/06/2021,4030,84,3690,60,340,13/04/2021,"Chateau Margaux Premier Cru Classe, Margaux",Bordeaux,2011,20/06/2021,10127812011,1012781
1000,18/06/2021,1143,77,988,12,155,28/05/2021,"Chateau Calon Segur 3eme Cru Classe, Saint-Estephe",Bordeaux,2005,20/06/2021,10074752005,1007475
6450,17/06/2021,7424,56,6190,260,1234,23/05/2021,"Chateau Margaux Premier Cru Classe, Margaux",Bordeaux,2010,20/06/2021,10127812010,1012781
8240,09/06/2021,8400,1,5960,2280,2440,01/08/2017,"Domaine Leflaive, Chevalier-Montrachet Grand Cru",Burgundy,2010,20/06/2021,10734012010,1073401
3750,14/06/2021,4207,39,3560,190,647,20/11/2020,"Chateau Margaux Premier Cru Classe, Margaux",Bordeaux,2012,20/06/2021,10127812012,1012781
4850,18/06/2021,5664,28,4842,8,822,19/05/2021,"Chateau Margaux Premier Cru Classe, Margaux",Bordeaux,2003,20/06/2021,10127812003,1012781
900,17/06/2021,1054,22,800,100,254,21/11/2019,"Chateau Calon Segur 3eme Cru Classe, Saint-Estephe",Bordeaux,2003,20/06/2021,10074752003,1007475
990,18/06/2021,1102,17,990,0,112,16/06/2021,"Chateau Calon Segur 3eme Cru Classe, Saint-Estephe",Bordeaux,2010,20/06/2021,10074752010,1007475
480,08/07/2021,555,3,465,15,90,04/05/2020,"Chateau Batailley 5eme Cru Classe, Pauillac",Bordeaux,2001,09/07/2021,10063222001,1006322
4400,17/06/2021,4729,26,4400,0,329,29/09/2020,"Chateau Margaux Premier Cru Classe, Margaux",Bordeaux,2001,20/06/2021,10127812001,1012781
3900,18/06/2021,4616,87,3861,39,755,28/05/2021,"Chateau Margaux Premier Cru Classe, Margaux",Bordeaux,2006,20/06/2021,10127812006,1012781
3826,18/06/2021,4515,51,4116,-290,399,25/02/2021,"Chateau Margaux Premier Cru Classe, Margaux",Bordeaux,2004,20/06/2021,10127812004,1012781
3560,17/06/2021,4024,30,3525,35,499,18/06/2021,"Chateau Margaux Premier Cru Classe, Margaux",Bordeaux,2007,20/06/2021,10127812007,1012781
880,17/06/2021,963,9,781,99,182,16/11/2020,"Chateau Calon Segur 3eme Cru Classe, Saint-Estephe",Bordeaux,2008,20/06/2021,10074752008,1007475
3900,18/06/2021,4224,72,3700,200,524,07/06/2021,"Chateau Margaux Premier Cru Classe, Margaux",Bordeaux,2008,20/06/2021,10127812008,1012781
2500,21/06/2021,2636,2,2220,280,416,14/06/2021,"Gaja, Barbaresco",Piedmont,2001,22/06/2021,10996052001,1099605
3560,21/06/2021,3992,29,3525,35,467,18/06/2021,"Chateau Margaux Premier Cru Classe, Margaux",Bordeaux,2007,22/06/2021,10127812007,1012781
3826,21/06/2021,4507,50,4116,-290,391,25/02/2021,"Chateau Margaux Premier Cru Classe, Margaux",Bordeaux,2004,22/06/2021,10127812004,1012781
5570,21/06/2021,5856,99,5254,316,602,26/05/2021,"Chateau Margaux Premier Cru Classe, Margaux",Bordeaux,2018,22/06/2021,10127812018,1012781
1800,21/06/2021,1814,1,1300,500,514,30/05/2019,"Gaja, Barbaresco",Piedmont,2007,22/06/2021,10996052007,1099605
3740,21/06/2021,3975,52,3520,220,455,07/04/2021,"Chateau Margaux Premier Cru Classe, Margaux",Bordeaux,2013,22/06/2021,10127812013,1012781
750,17/06/2021,925,110,740,10,185,21/05/2021,"Chateau Calon Segur 3eme Cru Classe, Saint-Estephe",Bordeaux,2017,22/06/2021,10074752017,1007475
6400,18/06/2021,7419,40,6776,-376,643,10/06/2021,"Chateau Margaux Premier Cru Classe, Margaux",Bordeaux,2005,22/06/2021,10127812005,1012781
1220,21/06/2021,1237,37,1050,170,187,10/06/2021,"Tignanello, Toscana",Tuscany,2016,22/06/2021,10953912016,1095391
1000,21/06/2021,1144,76,988,12,156,28/05/2021,"Chateau Calon Segur 3eme Cru Classe, Saint-Estephe",Bordeaux,2005,22/06/2021,10074752005,1007475
990,21/06/2021,1108,16,990,0,118,16/06/2021,"Chateau Calon Segur 3eme Cru Classe, Saint-Estephe",Bordeaux,2010,22/06/2021,10074752010,1007475
3900,21/06/2021,4493,25,3684,216,809,10/06/2020,"Chateau Margaux Premier Cru Classe, Margaux",Bordeaux,2002,22/06/2021,10127812002,1012781
540,21/06/2021,532,3,300,240,232,03/11/2011,"Tua Rita, Giusto di Notri, Toscana",Tuscany,2007,22/06/2021,11058072007,1105807
4850,18/06/2021,5656,27,4650,200,1006,21/06/2021,"Chateau Margaux Premier Cru Classe, Margaux",Bordeaux,2003,22/06/2021,10127812003,1012781
3700,21/06/2021,4227,111,3646,54,581,16/06/2021,"Chateau Margaux Premier Cru Classe, Margaux",Bordeaux,2017,22/06/2021,10127812017,1012781
2199,21/06/2021,2225,2,1340,859,885,13/03/2020,"Gaja, Barbaresco",Piedmont,2009,22/06/2021,10996052009,1099605
686,21/06/2021,838,8,682,4,156,15/09/2020,"Chateau Calon Segur 3eme Cru Classe, Saint-Estephe",Bordeaux,2013,22/06/2021,10074752013,1007475
860,21/06/2021,1032,69,896,-36,136,17/06/2021,"Tignanello, Toscana",Tuscany,2018,22/06/2021,10953912018,1095391
12700,17/06/2021,12867,1,12850,-150,17,30/11/2020,"Jacques-Frederic Mugnier, Chambolle-Musigny Premier Cru, Les Amoureuses",Burgundy,2011,22/06/2021,10496422011,1049642
1570,15/06/2021,1344,3,1200,370,144,06/03/2021,"Tignanello, Toscana",Tuscany,2007,22/06/2021,10953912007,1095391
1678,15/06/2021,1683,4,1180,498,503,25/06/2020,"Tignanello, Toscana",Tuscany,2004,22/06/2021,10953912004,1095391
487,21/06/2021,524,45,320,167,204,24/03/2021,"Tua Rita, Giusto di Notri, Toscana",Tuscany,2017,22/06/2021,11058072017,1105807
5539,21/06/2021,5826,100,5238,301,588,17/05/2021,"Chateau Margaux Premier Cru Classe, Margaux",Bordeaux,2016,22/06/2021,10127812016,1012781
450,08/07/2021,521,3,300,150,221,15/12/2019,"Chateau Batailley 5eme Cru Classe, Pauillac",Bordeaux,2004,09/07/2021,10063222004,1006322
3800,17/06/2021,4321,52,3854,-54,467,11/05/2021,"Chateau Angelus Premier Grand Cru Classe A, Saint-Emilion Grand Cru",Bordeaux,2012,18/06/2021,10060452012,1006045
3900,21/06/2021,4214,66,3700,200,514,07/06/2021,"Chateau Margaux Premier Cru Classe, Margaux",Bordeaux,2008,22/06/2021,10127812008,1012781
3800,16/06/2021,4321,52,3854,-54,467,11/05/2021,"Chateau Angelus Premier Grand Cru Classe A, Saint-Emilion Grand Cru",Bordeaux,2012,17/06/2021,10060452012,1006045
510,08/07/2021,596,396,494,16,102,20/04/2021,"Chateau Batailley 5eme Cru Classe, Pauillac",Bordeaux,2010,09/07/2021,10063222010,1006322
510,08/07/2021,596,396,494,16,102,20/04/2021,"Chateau Batailley 5eme Cru Classe, Pauillac",Bordeaux,2010,09/07/2021,10063222010,1006322
1024,21/06/2021,1233,5,1072,-48,161,20/01/2021,"Tignanello, Toscana",Tuscany,2009,22/06/2021,10953912009,1095391
7527,21/06/2021,9789,3,7290,237,2499,21/08/2020,"Domaine Denis Mortet, Chambertin Grand Cru",Burgundy,2017,22/06/2021,10490202017,1049020
14520,21/06/2021,14520,1,12000,2520,2520,28/05/2020,"Jacques-Frederic Mugnier, Chambolle-Musigny Premier Cru, Les Amoureuses",Burgundy,2014,22/06/2021,10496422014,1049642
4400,17/06/2021,4724,25,4400,0,324,29/09/2020,"Chateau Margaux Premier Cru Classe, Margaux",Bordeaux,2001,22/06/2021,10127812001,1012781
3800,16/06/2021,4321,52,3854,-54,467,11/05/2021,"Chateau Angelus Premier Grand Cru Classe A, Saint-Emilion Grand Cru",Bordeaux,2012,17/06/2021,10060452012,1006045
1245,15/06/2021,1615,2,882,363,733,26/04/2019,"Tignanello, Toscana",Tuscany,2003,22/06/2021,10953912003,1095391
3800,15/06/2021,4321,52,3854,-54,467,11/05/2021,"Chateau Angelus Premier Grand Cru Classe A, Saint-Emilion Grand Cru",Bordeaux,2012,16/06/2021,10060452012,1006045
400,08/07/2021,407,5,408,-8,-1,14/07/2021,"Chateau Batailley 5eme Cru Classe, Pauillac",Bordeaux,2012,17/07/2021,10063222012,1006322
826,21/06/2021,948,4,705,121,243,01/02/2021,"Chateau Calon Segur 3eme Cru Classe, Saint-Estephe",Bordeaux,2002,22/06/2021,10074752002,1007475
1350,21/06/2021,1474,61,1260,90,214,18/02/2021,"Gaja, Barbaresco",Piedmont,2015,22/06/2021,10996052015,1099605
3800,15/06/2021,4321,52,3854,-54,467,11/05/2021,"Chateau Angelus Premier Grand Cru Classe A, Saint-Emilion Grand Cru",Bordeaux,2012,16/06/2021,10060452012,1006045
3800,14/06/2021,4321,52,3854,-54,467,11/05/2021,"Chateau Angelus Premier Grand Cru Classe A, Saint-Emilion Grand Cru",Bordeaux,2012,15/06/2021,10060452012,1006045
400,08/07/2021,423,6,408,-8,15,14/07/2021,"Chateau Batailley 5eme Cru Classe, Pauillac",Bordeaux,2012,16/07/2021,10063222012,1006322
6557,21/06/2021,6557,0,3920,2637,2637,26/04/2017,"Domaine Leflaive, Chevalier-Montrachet Grand Cru",Burgundy,2006,22/06/2021,10734012006,1073401
1080,21/06/2021,1223,46,950,130,273,03/05/2021,"Chateau Calon Segur 3eme Cru Classe, Saint-Estephe",Bordeaux,2018,22/06/2021,10074752018,1007475
10328,21/06/2021,11935,51,9800,528,2135,11/06/2021,"Chateau Margaux Premier Cru Classe, Margaux",Bordeaux,2015,22/06/2021,10127812015,1012781
1299,15/06/2021,1459,7,1010,289,449,18/12/2020,"Tignanello, Toscana",Tuscany,2008,22/06/2021,10953912008,1095391
1700,21/06/2021,1652,3,1378,322,274,29/07/2020,"Tignanello, Toscana",Tuscany,2001,22/06/2021,10953912001,1095391
400,08/07/2021,423,6,408,-8,15,14/07/2021,"Chateau Batailley 5eme Cru Classe, Pauillac",Bordeaux,2012,16/07/2021,10063222012,1006322
400,08/07/2021,407,5,408,-8,-1,14/07/2021,"Chateau Batailley 5eme Cru Classe, Pauillac",Bordeaux,2012,17/07/2021,10063222012,1006322
880,17/06/2021,971,8,781,99,190,16/11/2020,"Chateau Calon Segur 3eme Cru Classe, Saint-Estephe",Bordeaux,2008,22/06/2021,10074752008,1007475
3800,14/06/2021,4321,52,3854,-54,467,11/05/2021,"Chateau Angelus Premier Grand Cru Classe A, Saint-Emilion Grand Cru",Bordeaux,2012,15/06/2021,10060452012,1006045
1390,09/06/2021,1536,14,1276,114,260,05/03/2021,"Gaja, Barbaresco",Piedmont,2013,22/06/2021,10996052013,1099605
950,21/06/2021,1019,52,863,87,156,10/05/2021,"Chateau Calon Segur 3eme Cru Classe, Saint-Estephe",Bordeaux,2006,22/06/2021,10074752006,1007475
1408,27/05/2021,1410,1,996,412,414,14/06/2019,"Tignanello, Toscana",Tuscany,2000,22/06/2021,10953912000,1095391
3800,11/06/2021,4321,52,3854,-54,467,11/05/2021,"Chateau Angelus Premier Grand Cru Classe A, Saint-Emilion Grand Cru",Bordeaux,2012,12/06/2021,10060452012,1006045
1300,08/07/2021,1381,3,1200,100,181,06/03/2021,"Tignanello, Toscana",Tuscany,2007,07/08/2021,10953912007,1095391
3800,11/06/2021,4321,52,3854,-54,467,11/05/2021,"Chateau Angelus Premier Grand Cru Classe A, Saint-Emilion Grand Cru",Bordeaux,2012,12/06/2021,10060452012,1006045
960,30/06/2021,1272,13,850,110,422,28/01/2021,"Tignanello, Toscana",Tuscany,2012,01/07/2021,10953912012,1095391
3800,10/06/2021,4321,52,3854,-54,467,11/05/2021,"Chateau Angelus Premier Grand Cru Classe A, Saint-Emilion Grand Cru",Bordeaux,2012,11/06/2021,10060452012,1006045
3720,30/06/2021,4320,146,3480,240,840,17/06/2021,"Chateau Margaux Premier Cru Classe, Margaux",Bordeaux,2014,01/07/2021,10127812014,1012781
6930,03/08/2021,7719,70,7086,-156,633,11/06/2021,"Chateau Margaux Premier Cru Classe, Margaux",Bordeaux,2009,04/08/2021,10127812009,1012781
3800,10/06/2021,4321,52,3854,-54,467,11/05/2021,"Chateau Angelus Premier Grand Cru Classe A, Saint-Emilion Grand Cru",Bordeaux,2012,11/06/2021,10060452012,1006045
3800,09/06/2021,4319,52,3854,-54,465,11/05/2021,"Chateau Angelus Premier Grand Cru Classe A, Saint-Emilion Grand Cru",Bordeaux,2012,10/06/2021,10060452012,1006045
1304,23/06/2021,1402,4,1170,134,232,24/06/2021,"Tignanello, Toscana",Tuscany,2010,25/06/2021,10953912010,1095391
3720,24/06/2021,4311,146,3480,240,831,17/06/2021,"Chateau Margaux Premier Cru Classe, Margaux",Bordeaux,2014,25/06/2021,10127812014,1012781
950,24/06/2021,1019,52,863,87,156,10/05/2021,"Chateau Calon Segur 3eme Cru Classe, Saint-Estephe",Bordeaux,2006,25/06/2021,10074752006,1007475
487,21/06/2021,535,26,388,99,147,29/09/2020,"Tua Rita, Giusto di Notri, Toscana",Tuscany,2015,25/06/2021,11058072015,1105807
14520,24/06/2021,14520,1,12000,2520,2520,28/05/2020,"Jacques-Frederic Mugnier, Chambolle-Musigny Premier Cru, Les Amoureuses",Burgundy,2014,25/06/2021,10496422014,1049642
320,08/07/2021,321,110,304,16,17,10/01/2021,"Chateau Batailley 5eme Cru Classe, Pauillac",Bordeaux,2013,09/07/2021,10063222013,1006322
1380,23/06/2021,1443,7,1352,28,91,23/09/2020,"Gaja, Barbaresco",Piedmont,2011,25/06/2021,10996052011,1099605
7527,21/06/2021,9745,3,7290,237,2455,21/08/2020,"Domaine Denis Mortet, Chambertin Grand Cru",Burgundy,2017,25/06/2021,10490202017,1049020
880,17/06/2021,989,9,781,99,208,16/11/2020,"Chateau Calon Segur 3eme Cru Classe, Saint-Estephe",Bordeaux,2008,25/06/2021,10074752008,1007475
3740,24/06/2021,4028,62,3520,220,508,07/04/2021,"Chateau Margaux Premier Cru Classe, Margaux",Bordeaux,2013,25/06/2021,10127812013,1012781
3826,24/06/2021,4499,55,4116,-290,383,25/02/2021,"Chateau Margaux Premier Cru Classe, Margaux",Bordeaux,2004,25/06/2021,10127812004,1012781
6400,22/06/2021,7416,42,6776,-376,640,10/06/2021,"Chateau Margaux Premier Cru Classe, Margaux",Bordeaux,2005,25/06/2021,10127812005,1012781
359,08/07/2021,368,89,324,35,44,09/06/2021,"Chateau Batailley 5eme Cru Classe, Pauillac",Bordeaux,2014,09/07/2021,10063222014,1006322
3750,24/06/2021,4219,40,3560,190,659,20/11/2020,"Chateau Margaux Premier Cru Classe, Margaux",Bordeaux,2012,25/06/2021,10127812012,1012781
1070,24/06/2021,1219,51,950,120,269,03/05/2021,"Chateau Calon Segur 3eme Cru Classe, Saint-Estephe",Bordeaux,2018,25/06/2021,10074752018,1007475
476,08/07/2021,520,39,364,112,156,12/05/2021,"Chateau Batailley 5eme Cru Classe, Pauillac",Bordeaux,2016,09/07/2021,10063222016,1006322
3800,09/06/2021,4319,52,3854,-54,465,11/05/2021,"Chateau Angelus Premier Grand Cru Classe A, Saint-Emilion Grand Cru",Bordeaux,2012,10/06/2021,10060452012,1006045
2500,24/06/2021,2636,2,2220,280,416,14/06/2021,"Gaja, Barbaresco",Piedmont,2001,25/06/2021,10996052001,1099605
3800,08/06/2021,4319,52,3854,-54,465,11/05/2021,"Chateau Angelus Premier Grand Cru Classe A, Saint-Emilion Grand Cru",Bordeaux,2012,09/06/2021,10060452012,1006045
5578,24/06/2021,5833,100,5238,340,595,17/05/2021,"Chateau Margaux Premier Cru Classe, Margaux",Bordeaux,2016,25/06/2021,10127812016,1012781
3900,24/06/2021,4629,95,3822,78,807,20/06/2021,"Chateau Margaux Premier Cru Classe, Margaux",Bordeaux,2006,25/06/2021,10127812006,1012781
1350,24/06/2021,1474,61,1260,90,214,18/02/2021,"Gaja, Barbaresco",Piedmont,2015,25/06/2021,10996052015,1099605
1000,24/06/2021,1157,92,988,12,169,28/05/2021,"Chateau Calon Segur 3eme Cru Classe, Saint-Estephe",Bordeaux,2005,25/06/2021,10074752005,1007475
540,23/06/2021,527,2,300,240,227,03/11/2011,"Tua Rita, Giusto di Notri, Toscana",Tuscany,2007,25/06/2021,11058072007,1105807
3800,08/06/2021,4319,52,3854,-54,465,11/05/2021,"Chateau Angelus Premier Grand Cru Classe A, Saint-Emilion Grand Cru",Bordeaux,2012,09/06/2021,10060452012,1006045
3800,07/06/2021,4319,52,3854,-54,465,11/05/2021,"Chateau Angelus Premier Grand Cru Classe A, Saint-Emilion Grand Cru",Bordeaux,2012,08/06/2021,10060452012,1006045
990,24/06/2021,1108,16,990,0,118,16/06/2021,"Chateau Calon Segur 3eme Cru Classe, Saint-Estephe",Bordeaux,2010,25/06/2021,10074752010,1007475
8000,24/06/2021,8692,5,6974,1026,1718,14/03/2021,"Domaine Leflaive, Chevalier-Montrachet Grand Cru",Burgundy,2017,25/06/2021,10734012017,1073401
3560,23/06/2021,4171,44,3525,35,646,18/06/2021,"Chateau Margaux Premier Cru Classe, Margaux",Bordeaux,2007,25/06/2021,10127812007,1012781
686,24/06/2021,838,8,682,4,156,15/09/2020,"Chateau Calon Segur 3eme Cru Classe, Saint-Estephe",Bordeaux,2013,25/06/2021,10074752013,1007475
5290,24/06/2021,5092,7,4160,1130,932,19/03/2021,"Chateau Margaux Premier Cru Classe, Margaux",Bordeaux,2019,25/06/2021,10127812019,1012781
460,24/06/2021,493,188,420,40,73,28/05/2021,"Tua Rita, Giusto di Notri, Toscana",Tuscany,2016,25/06/2021,11058072016,1105807
3800,07/06/2021,4319,52,3854,-54,465,11/05/2021,"Chateau Angelus Premier Grand Cru Classe A, Saint-Emilion Grand Cru",Bordeaux,2012,08/06/2021,10060452012,1006045
3800,04/06/2021,4319,52,3854,-54,465,11/05/2021,"Chateau Angelus Premier Grand Cru Classe A, Saint-Emilion Grand Cru",Bordeaux,2012,05/06/2021,10060452012,1006045
2098,24/06/2021,2300,4,2190,-92,110,01/05/2021,"Gaja, Barbaresco",Piedmont,2004,25/06/2021,10996052004,1099605
1000,24/06/2021,1245,49,1026,-26,219,24/06/2021,"Chateau Calon Segur 3eme Cru Classe, Saint-Estephe",Bordeaux,2009,25/06/2021,10074752009,1007475
15600,23/06/2021,15114,6,13000,2600,2114,29/04/2021,"Jacques-Frederic Mugnier, Chambolle-Musigny Premier Cru, Les Amoureuses",Burgundy,2017,25/06/2021,10496422017,1049642
3800,04/06/2021,4319,52,3854,-54,465,11/05/2021,"Chateau Angelus Premier Grand Cru Classe A, Saint-Emilion Grand Cru",Bordeaux,2012,05/06/2021,10060452012,1006045
857,15/06/2021,944,153,828,29,116,21/06/2021,"Tignanello, Toscana",Tuscany,2017,25/06/2021,10953912017,1095391
1800,24/06/2021,1814,1,1300,500,514,30/05/2019,"Gaja, Barbaresco",Piedmont,2007,25/06/2021,10996052007,1099605
3800,03/06/2021,4781,66,3854,-54,927,11/05/2021,"Chateau Angelus Premier Grand Cru Classe A, Saint-Emilion Grand Cru",Bordeaux,2012,04/06/2021,10060452012,1006045
1238,23/06/2021,1266,37,1050,188,216,10/06/2021,"Tignanello, Toscana",Tuscany,2016,25/06/2021,10953912016,1095391
880,24/06/2021,967,9,725,155,242,13/04/2021,"Chateau Calon Segur 3eme Cru Classe, Saint-Estephe",Bordeaux,2007,25/06/2021,10074752007,1007475
16200,24/06/2021,16040,0,18750,-2550,-2710,29/08/2018,"Jacques-Frederic Mugnier, Chambolle-Musigny Premier Cru, Les Amoureuses",Burgundy,2015,25/06/2021,10496422015,1049642
1100,24/06/2021,1216,67,1036,64,180,27/05/2021,"Chateau Calon Segur 3eme Cru Classe, Saint-Estephe",Bordeaux,2016,25/06/2021,10074752016,1007475
3770,23/06/2021,4220,110,3646,124,574,16/06/2021,"Chateau Margaux Premier Cru Classe, Margaux",Bordeaux,2017,25/06/2021,10127812017,1012781
740,17/06/2021,1001,34,790,-50,211,01/06/2020,"Chateau Calon Segur 3eme Cru Classe, Saint-Estephe",Bordeaux,2011,25/06/2021,10074752011,1007475
1850,24/06/2021,1831,1,1180,670,651,10/03/2017,"Gaja, Barbaresco",Piedmont,2005,25/06/2021,10996052005,1099605
3800,03/06/2021,4781,66,3854,-54,927,11/05/2021,"Chateau Angelus Premier Grand Cru Classe A, Saint-Emilion Grand Cru",Bordeaux,2012,04/06/2021,10060452012,1006045
420,24/05/2021,606,4,342,78,264,21/08/2020,"Tua Rita, Giusto di Notri, Toscana",Tuscany,2011,25/06/2021,11058072011,1105807
10500,23/06/2021,11933,53,9800,700,2133,11/06/2021,"Chateau Margaux Premier Cru Classe, Margaux",Bordeaux,2015,25/06/2021,10127812015,1012781
1500,24/06/2021,1681,49,1408,92,273,09/04/2021,"Gaja, Barbaresco",Piedmont,2016,25/06/2021,10996052016,1099605
7906,22/06/2021,7792,2,7124,782,668,15/02/2019,"Domaine Leflaive, Chevalier-Montrachet Grand Cru",Burgundy,2016,25/06/2021,10734012016,1073401
1398,17/06/2021,1528,15,1276,122,252,05/03/2021,"Gaja, Barbaresco",Piedmont,2013,25/06/2021,10996052013,1099605
870,24/06/2021,955,4,705,165,250,01/02/2021,"Chateau Calon Segur 3eme Cru Classe, Saint-Estephe",Bordeaux,2002,25/06/2021,10074752002,1007475
685,09/07/2021,886,4,470,215,416,29/03/2018,"Chateau Batailley 5eme Cru Classe, Pauillac",Bordeaux,2000,10/07/2021,10063222000,1006322
1550,24/06/2021,1557,1,1300,250,257,27/04/2021,"Gaja, Barbaresco",Piedmont,2012,25/06/2021,10996052012,1099605
3800,02/06/2021,4783,66,3854,-54,929,11/05/2021,"Chateau Angelus Premier Grand Cru Classe A, Saint-Emilion Grand Cru",Bordeaux,2012,03/06/2021,10060452012,1006045
685,09/07/2021,886,4,470,215,416,29/03/2018,"Chateau Batailley 5eme Cru Classe, Pauillac",Bordeaux,2000,10/07/2021,10063222000,1006322
1040,23/06/2021,1210,21,940,100,270,18/03/2021,"Chateau Calon Segur 3eme Cru Classe, Saint-Estephe",Bordeaux,2000,25/06/2021,10074752000,1007475
750,17/06/2021,929,106,740,10,189,21/05/2021,"Chateau Calon Segur 3eme Cru Classe, Saint-Estephe",Bordeaux,2017,25/06/2021,10074752017,1007475
950,23/06/2021,1272,13,850,100,422,28/01/2021,"Tignanello, Toscana",Tuscany,2012,25/06/2021,10953912012,1095391
5600,23/06/2021,5860,98,5254,346,606,26/05/2021,"Chateau Margaux Premier Cru Classe, Margaux",Bordeaux,2018,25/06/2021,10127812018,1012781
6830,23/06/2021,7715,50,7086,-256,629,11/06/2021,"Chateau Margaux Premier Cru Classe, Margaux",Bordeaux,2009,25/06/2021,10127812009,1012781
660,24/06/2021,727,5,390,270,337,18/08/2017,"Tua Rita, Giusto di Notri, Toscana",Tuscany,2006,25/06/2021,11058072006,1105807
7800,24/06/2021,8255,5,7330,470,925,02/06/2021,"Domaine Leflaive, Chevalier-Montrachet Grand Cru",Burgundy,2018,25/06/2021,10734012018,1073401
685,09/07/2021,1033,3,470,215,563,29/03/2018,"Chateau Batailley 5eme Cru Classe, Pauillac",Bordeaux,2000,12/07/2021,10063222000,1006322
3900,24/06/2021,4264,77,3700,200,564,07/06/2021,"Chateau Margaux Premier Cru Classe, Margaux",Bordeaux,2008,25/06/2021,10127812008,1012781
6400,24/06/2021,7446,55,5950,450,1496,23/06/2021,"Chateau Margaux Premier Cru Classe, Margaux",Bordeaux,2010,25/06/2021,10127812010,1012781
3800,02/06/2021,4783,66,3854,-54,929,11/05/2021,"Chateau Angelus Premier Grand Cru Classe A, Saint-Emilion Grand Cru",Bordeaux,2012,03/06/2021,10060452012,1006045
3800,01/06/2021,4783,66,3854,-54,929,11/05/2021,"Chateau Angelus Premier Grand Cru Classe A, Saint-Emilion Grand Cru",Bordeaux,2012,02/06/2021,10060452012,1006045
685,09/07/2021,1033,3,470,215,563,29/03/2018,"Chateau Batailley 5eme Cru Classe, Pauillac",Bordeaux,2000,12/07/2021,10063222000,1006322
3800,01/06/2021,4783,66,3854,-54,929,11/05/2021,"Chateau Angelus Premier Grand Cru Classe A, Saint-Emilion Grand Cru",Bordeaux,2012,02/06/2021,10060452012,1006045
3700,04/08/2021,4171,46,3520,180,651,07/04/2021,"Chateau Margaux Premier Cru Classe, Margaux",Bordeaux,2013,05/08/2021,10127812013,1012781
686,06/08/2021,773,23,682,4,91,15/09/2020,"Chateau Calon Segur 3eme Cru Classe, Saint-Estephe",Bordeaux,2013,07/08/2021,10074752013,1007475
8300,06/08/2021,9337,17,8200,100,1137,26/07/2021,"Chateau Margaux Premier Cru Classe, Margaux",Bordeaux,2000,07/08/2021,10127812000,1012781
990,06/08/2021,1177,63,1029,-39,148,21/07/2021,"Chateau Calon Segur 3eme Cru Classe, Saint-Estephe",Bordeaux,2005,07/08/2021,10074752005,1007475
3800,31/05/2021,4783,66,3854,-54,929,11/05/2021,"Chateau Angelus Premier Grand Cru Classe A, Saint-Emilion Grand Cru",Bordeaux,2012,01/06/2021,10060452012,1006045
840,17/06/2021,1078,85,822,18,256,28/06/2021,"Chateau Calon Segur 3eme Cru Classe, Saint-Estephe",Bordeaux,2015,29/06/2021,10074752015,1007475
3720,28/06/2021,4315,141,3480,240,835,17/06/2021,"Chateau Margaux Premier Cru Classe, Margaux",Bordeaux,2014,29/06/2021,10127812014,1012781
3800,31/05/2021,4783,66,3854,-54,929,11/05/2021,"Chateau Angelus Premier Grand Cru Classe A, Saint-Emilion Grand Cru",Bordeaux,2012,01/06/2021,10060452012,1006045
1080,29/06/2021,1216,48,950,130,266,03/05/2021,"Chateau Calon Segur 3eme Cru Classe, Saint-Estephe",Bordeaux,2018,30/06/2021,10074752018,1007475
3750,05/08/2021,4325,54,3650,100,675,27/07/2021,"Chateau Margaux Premier Cru Classe, Margaux",Bordeaux,2012,06/08/2021,10127812012,1012781
3800,28/05/2021,4783,66,3854,-54,929,11/05/2021,"Chateau Angelus Premier Grand Cru Classe A, Saint-Emilion Grand Cru",Bordeaux,2012,29/05/2021,10060452012,1006045
11298,02/08/2021,10860,2,8000,3298,2860,30/01/2020,"Domaine Leflaive, Chevalier-Montrachet Grand Cru",Burgundy,2014,04/08/2021,10734012014,1073401
820,04/08/2021,925,4,735,85,190,09/09/2020,"Chateau Calon Segur 3eme Cru Classe, Saint-Estephe",Bordeaux,2012,05/08/2021,10074752012,1007475
907,04/08/2021,953,23,805,102,148,20/11/2019,"Chateau Calon Segur 3eme Cru Classe, Saint-Estephe",Bordeaux,2001,05/08/2021,10074752001,1007475
866,23/06/2021,949,144,844,22,105,25/06/2021,"Tignanello, Toscana",Tuscany,2017,30/06/2021,10953912017,1095391
487,29/06/2021,526,46,320,167,206,24/03/2021,"Tua Rita, Giusto di Notri, Toscana",Tuscany,2017,30/06/2021,11058072017,1105807
7800,29/06/2021,8255,5,7330,470,925,02/06/2021,"Domaine Leflaive, Chevalier-Montrachet Grand Cru",Burgundy,2018,30/06/2021,10734012018,1073401
685,09/07/2021,921,4,470,215,451,29/03/2018,"Chateau Batailley 5eme Cru Classe, Pauillac",Bordeaux,2000,11/07/2021,10063222000,1006322
1516,29/06/2021,1565,174,1300,216,265,28/06/2021,"Gaja, Barbaresco",Piedmont,2017,30/06/2021,10996052017,1099605
3950,05/08/2021,4469,108,3780,170,689,23/07/2021,"Chateau Margaux Premier Cru Classe, Margaux",Bordeaux,2008,06/08/2021,10127812008,1012781
3750,05/08/2021,4330,53,3650,100,680,27/07/2021,"Chateau Margaux Premier Cru Classe, Margaux",Bordeaux,2012,07/08/2021,10127812012,1012781
4850,25/06/2021,5898,20,4650,200,1248,21/06/2021,"Chateau Margaux Premier Cru Classe, Margaux",Bordeaux,2003,30/06/2021,10127812003,1012781
3800,28/05/2021,4783,66,3854,-54,929,11/05/2021,"Chateau Angelus Premier Grand Cru Classe A, Saint-Emilion Grand Cru",Bordeaux,2012,29/05/2021,10060452012,1006045
800,29/06/2021,921,19,745,55,176,16/11/2020,"Chateau Calon Segur 3eme Cru Classe, Saint-Estephe",Bordeaux,2004,30/06/2021,10074752004,1007475
685,09/07/2021,921,4,470,215,451,29/03/2018,"Chateau Batailley 5eme Cru Classe, Pauillac",Bordeaux,2000,11/07/2021,10063222000,1006322
3800,27/05/2021,4783,66,3854,-54,929,11/05/2021,"Chateau Angelus Premier Grand Cru Classe A, Saint-Emilion Grand Cru",Bordeaux,2012,28/05/2021,10060452012,1006045
6400,29/06/2021,7230,26,6776,-376,454,10/06/2021,"Chateau Margaux Premier Cru Classe, Margaux",Bordeaux,2005,30/06/2021,10127812005,1012781
3800,27/05/2021,4783,66,3854,-54,929,11/05/2021,"Chateau Angelus Premier Grand Cru Classe A, Saint-Emilion Grand Cru",Bordeaux,2012,28/05/2021,10060452012,1006045
480,09/07/2021,555,3,465,15,90,04/05/2020,"Chateau Batailley 5eme Cru Classe, Pauillac",Bordeaux,2001,10/07/2021,10063222001,1006322
3800,26/05/2021,4801,65,3854,-54,947,11/05/2021,"Chateau Angelus Premier Grand Cru Classe A, Saint-Emilion Grand Cru",Bordeaux,2012,27/05/2021,10060452012,1006045
900,29/06/2021,1017,53,863,37,154,10/05/2021,"Chateau Calon Segur 3eme Cru Classe, Saint-Estephe",Bordeaux,2006,30/06/2021,10074752006,1007475
3900,29/06/2021,4638,94,3822,78,816,20/06/2021,"Chateau Margaux Premier Cru Classe, Margaux",Bordeaux,2006,30/06/2021,10127812006,1012781
880,29/06/2021,967,9,725,155,242,13/04/2021,"Chateau Calon Segur 3eme Cru Classe, Saint-Estephe",Bordeaux,2007,30/06/2021,10074752007,1007475
3800,26/05/2021,4801,65,3854,-54,947,11/05/2021,"Chateau Angelus Premier Grand Cru Classe A, Saint-Emilion Grand Cru",Bordeaux,2012,27/05/2021,10060452012,1006045
3800,25/05/2021,4801,65,3854,-54,947,11/05/2021,"Chateau Angelus Premier Grand Cru Classe A, Saint-Emilion Grand Cru",Bordeaux,2012,26/05/2021,10060452012,1006045
3900,29/06/2021,4256,79,3750,150,506,28/06/2021,"Chateau Margaux Premier Cru Classe, Margaux",Bordeaux,2008,30/06/2021,10127812008,1012781
895,29/06/2021,980,10,781,114,199,16/11/2020,"Chateau Calon Segur 3eme Cru Classe, Saint-Estephe",Bordeaux,2008,30/06/2021,10074752008,1007475
420,09/07/2021,470,4,220,200,250,17/06/2015,"Chateau Batailley 5eme Cru Classe, Pauillac",Bordeaux,2002,10/07/2021,10063222002,1006322
6830,28/06/2021,7732,48,7086,-256,646,11/06/2021,"Chateau Margaux Premier Cru Classe, Margaux",Bordeaux,2009,30/06/2021,10127812009,1012781
1299,29/06/2021,1265,45,1026,273,239,24/06/2021,"Chateau Calon Segur 3eme Cru Classe, Saint-Estephe",Bordeaux,2009,30/06/2021,10074752009,1007475
450,09/07/2021,521,3,300,150,221,15/12/2019,"Chateau Batailley 5eme Cru Classe, Pauillac",Bordeaux,2004,10/07/2021,10063222004,1006322
3800,25/05/2021,4801,65,3854,-54,947,11/05/2021,"Chateau Angelus Premier Grand Cru Classe A, Saint-Emilion Grand Cru",Bordeaux,2012,26/05/2021,10060452012,1006045
1850,29/06/2021,1831,1,1180,670,651,10/03/2017,"Gaja, Barbaresco",Piedmont,2005,30/06/2021,10996052005,1099605
1408,29/06/2021,1436,1,1150,258,286,21/04/2019,"Tignanello, Toscana",Tuscany,2005,30/06/2021,10953912005,1095391
2500,29/06/2021,2636,2,2220,280,416,14/06/2021,"Gaja, Barbaresco",Piedmont,2001,30/06/2021,10996052001,1099605
2098,29/06/2021,2300,4,2190,-92,110,01/05/2021,"Gaja, Barbaresco",Piedmont,2004,30/06/2021,10996052004,1099605
520,29/06/2021,556,4,460,60,96,05/05/2020,"Tua Rita, Giusto di Notri, Toscana",Tuscany,2008,30/06/2021,11058072008,1105807
660,29/06/2021,727,5,390,270,337,18/08/2017,"Tua Rita, Giusto di Notri, Toscana",Tuscany,2006,30/06/2021,11058072006,1105807
1700,28/06/2021,1847,4,1378,322,469,29/07/2020,"Tignanello, Toscana",Tuscany,2001,30/06/2021,10953912001,1095391
1299,29/06/2021,1555,5,1010,289,545,18/12/2020,"Tignanello, Toscana",Tuscany,2008,30/06/2021,10953912008,1095391
1245,29/06/2021,1615,2,882,363,733,26/04/2019,"Tignanello, Toscana",Tuscany,2003,30/06/2021,10953912003,1095391
1408,29/06/2021,1389,4,1238,170,151,02/11/2020,"Tignanello, Toscana",Tuscany,2006,30/06/2021,10953912006,1095391
1678,29/06/2021,1683,4,1420,258,263,29/06/2021,"Tignanello, Toscana",Tuscany,2004,30/06/2021,10953912004,1095391
1570,29/06/2021,1385,2,1200,370,185,06/03/2021,"Tignanello, Toscana",Tuscany,2007,30/06/2021,10953912007,1095391
6400,29/06/2021,7572,51,5950,450,1622,23/06/2021,"Chateau Margaux Premier Cru Classe, Margaux",Bordeaux,2010,30/06/2021,10127812010,1012781
530,09/07/2021,622,49,520,10,102,17/06/2021,"Chateau Batailley 5eme Cru Classe, Pauillac",Bordeaux,2005,10/07/2021,10063222005,1006322
990,29/06/2021,1116,15,990,0,126,16/06/2021,"Chateau Calon Segur 3eme Cru Classe, Saint-Estephe",Bordeaux,2010,30/06/2021,10074752010,1007475
3851,24/05/2021,4837,63,3854,-3,983,11/05/2021,"Chateau Angelus Premier Grand Cru Classe A, Saint-Emilion Grand Cru",Bordeaux,2012,25/05/2021,10060452012,1006045
750,28/06/2021,995,35,790,-40,205,01/06/2020,"Chateau Calon Segur 3eme Cru Classe, Saint-Estephe",Bordeaux,2011,30/06/2021,10074752011,1007475
1320,28/06/2021,1472,3,1170,150,302,24/06/2021,"Tignanello, Toscana",Tuscany,2010,30/06/2021,10953912010,1095391
3758,29/06/2021,4043,74,3690,68,353,13/04/2021,"Chateau Margaux Premier Cru Classe, Margaux",Bordeaux,2011,30/06/2021,10127812011,1012781
3851,24/05/2021,4837,63,3854,-3,983,11/05/2021,"Chateau Angelus Premier Grand Cru Classe A, Saint-Emilion Grand Cru",Bordeaux,2012,25/05/2021,10060452012,1006045
1022,28/06/2021,1051,8,880,142,171,22/06/2021,"Tignanello, Toscana",Tuscany,2011,30/06/2021,10953912011,1095391
6099,08/06/2021,9792,1,6500,-401,3292,26/05/2021,"Domaine Leflaive, Chevalier-Montrachet Grand Cru",Burgundy,2011,30/06/2021,10734012011,1073401
3851,20/05/2021,4774,75,3854,-3,920,11/05/2021,"Chateau Angelus Premier Grand Cru Classe A, Saint-Emilion Grand Cru",Bordeaux,2012,21/05/2021,10060452012,1006045
530,09/07/2021,622,49,520,10,102,17/06/2021,"Chateau Batailley 5eme Cru Classe, Pauillac",Bordeaux,2005,10/07/2021,10063222005,1006322
820,29/06/2021,939,6,735,85,204,09/09/2020,"Chateau Calon Segur 3eme Cru Classe, Saint-Estephe",Bordeaux,2012,30/06/2021,10074752012,1007475
3750,24/06/2021,4160,41,3560,190,600,20/11/2020,"Chateau Margaux Premier Cru Classe, Margaux",Bordeaux,2012,30/06/2021,10127812012,1012781
13200,29/06/2021,12867,1,12850,350,17,30/11/2020,"Jacques-Frederic Mugnier, Chambolle-Musigny Premier Cru, Les Amoureuses",Burgundy,2011,30/06/2021,10496422011,1049642
6400,27/05/2021,28000,0,4500,1900,23500,08/04/2015,"Domaine Leflaive, Chevalier-Montrachet Grand Cru",Burgundy,2012,30/06/2021,10734012012,1073401
3740,29/06/2021,4016,53,3520,220,496,07/04/2021,"Chateau Margaux Premier Cru Classe, Margaux",Bordeaux,2013,30/06/2021,10127812013,1012781
3851,20/05/2021,4774,75,3854,-3,920,11/05/2021,"Chateau Angelus Premier Grand Cru Classe A, Saint-Emilion Grand Cru",Bordeaux,2012,21/05/2021,10060452012,1006045
420,09/07/2021,445,3,400,20,45,11/05/2021,"Chateau Batailley 5eme Cru Classe, Pauillac",Bordeaux,2006,10/07/2021,10063222006,1006322
686,29/06/2021,826,7,682,4,144,15/09/2020,"Chateau Calon Segur 3eme Cru Classe, Saint-Estephe",Bordeaux,2013,30/06/2021,10074752013,1007475
3720,29/06/2021,4320,146,3480,240,840,17/06/2021,"Chateau Margaux Premier Cru Classe, Margaux",Bordeaux,2014,30/06/2021,10127812014,1012781
790,25/06/2021,903,23,801,-11,102,31/05/2021,"Chateau Calon Segur 3eme Cru Classe, Saint-Estephe",Bordeaux,2014,30/06/2021,10074752014,1007475
420,09/07/2021,445,3,400,20,45,11/05/2021,"Chateau Batailley 5eme Cru Classe, Pauillac",Bordeaux,2006,10/07/2021,10063222006,1006322
1550,29/06/2021,1557,1,1300,250,257,27/04/2021,"Gaja, Barbaresco",Piedmont,2012,30/06/2021,10996052012,1099605
1080,28/06/2021,1164,6,860,220,304,08/03/2021,"Tignanello, Toscana",Tuscany,2013,30/06/2021,10953912013,1095391
970,28/06/2021,1106,42,830,140,276,22/06/2021,"Tignanello, Toscana",Tuscany,2014,30/06/2021,10953912014,1095391
1400,29/06/2021,1531,15,1276,124,255,05/03/2021,"Gaja, Barbaresco",Piedmont,2013,30/06/2021,10996052013,1099605
1592,29/06/2021,1566,15,1300,292,266,28/09/2020,"Gaja, Barbaresco",Piedmont,2014,30/06/2021,10996052014,1099605
990,04/08/2021,1119,10,880,110,239,22/06/2021,"Tignanello, Toscana",Tuscany,2011,05/08/2021,10953912011,1095391
1090,30/06/2021,1165,6,860,230,305,08/03/2021,"Tignanello, Toscana",Tuscany,2013,01/07/2021,10953912013,1095391
984,30/06/2021,1106,42,830,154,276,22/06/2021,"Tignanello, Toscana",Tuscany,2014,01/07/2021,10953912014,1095391
9600,30/06/2021,9690,1,8000,1600,1690,30/01/2020,"Domaine Leflaive, Chevalier-Montrachet Grand Cru",Burgundy,2014,01/07/2021,10734012014,1073401
3851,18/05/2021,4774,75,3854,-3,920,11/05/2021,"Chateau Angelus Premier Grand Cru Classe A, Saint-Emilion Grand Cru",Bordeaux,2012,19/05/2021,10060452012,1006045
3900,06/08/2021,4442,22,3684,216,758,10/06/2020,"Chateau Margaux Premier Cru Classe, Margaux",Bordeaux,2002,07/08/2021,10127812002,1012781
4450,05/08/2021,4739,16,4400,50,339,29/09/2020,"Chateau Margaux Premier Cru Classe, Margaux",Bordeaux,2001,06/08/2021,10127812001,1012781
3851,18/05/2021,4774,75,3854,-3,920,11/05/2021,"Chateau Angelus Premier Grand Cru Classe A, Saint-Emilion Grand Cru",Bordeaux,2012,19/05/2021,10060452012,1006045
800,04/08/2021,792,19,682,118,110,15/09/2020,"Chateau Calon Segur 3eme Cru Classe, Saint-Estephe",Bordeaux,2013,05/08/2021,10074752013,1007475
3851,14/05/2021,4772,75,3854,-3,918,11/05/2021,"Chateau Angelus Premier Grand Cru Classe A, Saint-Emilion Grand Cru",Bordeaux,2012,15/05/2021,10060452012,1006045
3851,14/05/2021,4772,75,3854,-3,918,11/05/2021,"Chateau Angelus Premier Grand Cru Classe A, Saint-Emilion Grand Cru",Bordeaux,2012,15/05/2021,10060452012,1006045
3826,05/08/2021,4631,44,4116,-290,515,25/02/2021,"Chateau Margaux Premier Cru Classe, Margaux",Bordeaux,2004,06/08/2021,10127812004,1012781
6400,06/08/2021,7592,63,6188,212,1404,16/07/2021,"Chateau Margaux Premier Cru Classe, Margaux",Bordeaux,2010,07/08/2021,10127812010,1012781
895,04/08/2021,950,9,781,114,169,16/11/2020,"Chateau Calon Segur 3eme Cru Classe, Saint-Estephe",Bordeaux,2008,05/08/2021,10074752008,1007475
850,30/06/2021,1078,85,822,28,256,28/06/2021,"Chateau Calon Segur 3eme Cru Classe, Saint-Estephe",Bordeaux,2015,01/07/2021,10074752015,1007475
10400,30/06/2021,11947,51,9800,600,2147,11/06/2021,"Chateau Margaux Premier Cru Classe, Margaux",Bordeaux,2015,01/07/2021,10127812015,1012781
3851,12/05/2021,4757,76,3854,-3,903,11/05/2021,"Chateau Angelus Premier Grand Cru Classe A, Saint-Emilion Grand Cru",Bordeaux,2012,13/05/2021,10060452012,1006045
450,09/07/2021,445,4,332,118,113,06/10/2020,"Chateau Batailley 5eme Cru Classe, Pauillac",Bordeaux,2008,10/07/2021,10063222008,1006322
800,03/08/2021,792,19,682,118,110,15/09/2020,"Chateau Calon Segur 3eme Cru Classe, Saint-Estephe",Bordeaux,2013,04/08/2021,10074752013,1007475
3851,12/05/2021,4772,75,3854,-3,918,11/05/2021,"Chateau Angelus Premier Grand Cru Classe A, Saint-Emilion Grand Cru",Bordeaux,2012,14/05/2021,10060452012,1006045
1900,06/08/2021,2336,4,2190,-290,146,01/05/2021,"Gaja, Barbaresco",Piedmont,2004,07/08/2021,10996052004,1099605
686,05/08/2021,773,23,682,4,91,15/09/2020,"Chateau Calon Segur 3eme Cru Classe, Saint-Estephe",Bordeaux,2013,06/08/2021,10074752013,1007475
510,09/07/2021,596,396,494,16,102,20/04/2021,"Chateau Batailley 5eme Cru Classe, Pauillac",Bordeaux,2010,10/07/2021,10063222010,1006322
940,04/08/2021,1072,77,866,74,206,20/07/2021,"Chateau Calon Segur 3eme Cru Classe, Saint-Estephe",Bordeaux,2015,05/08/2021,10074752015,1007475
3851,12/05/2021,4757,76,3854,-3,903,11/05/2021,"Chateau Angelus Premier Grand Cru Classe A, Saint-Emilion Grand Cru",Bordeaux,2012,13/05/2021,10060452012,1006045
8200,20/07/2021,9082,15,8100,100,982,21/06/2021,"Chateau Margaux Premier Cru Classe, Margaux",Bordeaux,2000,21/07/2021,10127812000,1012781
3851,12/05/2021,4772,75,3854,-3,918,11/05/2021,"Chateau Angelus Premier Grand Cru Classe A, Saint-Emilion Grand Cru",Bordeaux,2012,14/05/2021,10060452012,1006045
4450,20/07/2021,4750,24,4400,50,350,29/09/2020,"Chateau Margaux Premier Cru Classe, Margaux",Bordeaux,2001,21/07/2021,10127812001,1012781
3939,20/07/2021,4417,22,3684,255,733,10/06/2020,"Chateau Margaux Premier Cru Classe, Margaux",Bordeaux,2002,21/07/2021,10127812002,1012781
3826,20/07/2021,4585,47,4116,-290,469,25/02/2021,"Chateau Margaux Premier Cru Classe, Margaux",Bordeaux,2004,21/07/2021,10127812004,1012781
4850,16/07/2021,6002,22,4650,200,1352,21/06/2021,"Chateau Margaux Premier Cru Classe, Margaux",Bordeaux,2003,21/07/2021,10127812003,1012781
3851,10/05/2021,4769,75,3854,-3,915,11/05/2021,"Chateau Angelus Premier Grand Cru Classe A, Saint-Emilion Grand Cru",Bordeaux,2012,12/05/2021,10060452012,1006045
907,19/07/2021,952,22,805,102,147,20/11/2019,"Chateau Calon Segur 3eme Cru Classe, Saint-Estephe",Bordeaux,2001,21/07/2021,10074752001,1007475
510,09/07/2021,596,396,494,16,102,20/04/2021,"Chateau Batailley 5eme Cru Classe, Pauillac",Bordeaux,2010,10/07/2021,10063222010,1006322
3851,10/05/2021,4813,63,3541,310,1272,19/04/2021,"Chateau Angelus Premier Grand Cru Classe A, Saint-Emilion Grand Cru",Bordeaux,2012,11/05/2021,10060452012,1006045
6500,20/07/2021,7503,24,6776,-276,727,10/06/2021,"Chateau Margaux Premier Cru Classe, Margaux",Bordeaux,2005,21/07/2021,10127812005,1012781
895,20/07/2021,928,41,863,32,65,10/05/2021,"Chateau Calon Segur 3eme Cru Classe, Saint-Estephe",Bordeaux,2006,21/07/2021,10074752006,1007475
3900,20/07/2021,4683,79,3822,78,861,20/06/2021,"Chateau Margaux Premier Cru Classe, Margaux",Bordeaux,2006,21/07/2021,10127812006,1012781
3750,20/07/2021,4258,81,3525,225,733,18/06/2021,"Chateau Margaux Premier Cru Classe, Margaux",Bordeaux,2007,21/07/2021,10127812007,1012781
880,20/07/2021,980,7,725,155,255,13/04/2021,"Chateau Calon Segur 3eme Cru Classe, Saint-Estephe",Bordeaux,2007,21/07/2021,10074752007,1007475
3851,10/05/2021,4769,75,3854,-3,915,11/05/2021,"Chateau Angelus Premier Grand Cru Classe A, Saint-Emilion Grand Cru",Bordeaux,2012,12/05/2021,10060452012,1006045
3900,20/07/2021,4355,72,3870,30,485,10/07/2021,"Chateau Margaux Premier Cru Classe, Margaux",Bordeaux,2008,21/07/2021,10127812008,1012781
895,20/07/2021,981,10,781,114,200,16/11/2020,"Chateau Calon Segur 3eme Cru Classe, Saint-Estephe",Bordeaux,2008,21/07/2021,10074752008,1007475
3851,10/05/2021,4813,63,3541,310,1272,19/04/2021,"Chateau Angelus Premier Grand Cru Classe A, Saint-Emilion Grand Cru",Bordeaux,2012,11/05/2021,10060452012,1006045
2500,19/07/2021,2640,3,2400,100,240,18/07/2021,"Gaja, Barbaresco",Piedmont,2001,21/07/2021,10996052001,1099605
2386,20/07/2021,2397,3,2190,196,207,01/05/2021,"Gaja, Barbaresco",Piedmont,2004,21/07/2021,10996052004,1099605
1408,20/07/2021,1754,2,882,526,872,26/04/2019,"Tignanello, Toscana",Tuscany,2003,21/07/2021,10953912003,1095391
1733,20/07/2021,1713,3,1420,313,293,29/06/2021,"Tignanello, Toscana",Tuscany,2004,21/07/2021,10953912004,1095391
6400,20/07/2021,7568,55,6188,212,1380,16/07/2021,"Chateau Margaux Premier Cru Classe, Margaux",Bordeaux,2010,21/07/2021,10127812010,1012781
320,09/07/2021,321,110,304,16,17,10/01/2021,"Chateau Batailley 5eme Cru Classe, Pauillac",Bordeaux,2013,10/07/2021,10063222013,1006322
990,20/07/2021,1124,16,990,0,134,16/06/2021,"Chateau Calon Segur 3eme Cru Classe, Saint-Estephe",Bordeaux,2010,21/07/2021,10074752010,1007475
3851,07/05/2021,4808,64,3541,310,1267,19/04/2021,"Chateau Angelus Premier Grand Cru Classe A, Saint-Emilion Grand Cru",Bordeaux,2012,10/05/2021,10060452012,1006045
750,20/07/2021,893,29,790,-40,103,01/06/2020,"Chateau Calon Segur 3eme Cru Classe, Saint-Estephe",Bordeaux,2011,21/07/2021,10074752011,1007475
1260,20/07/2021,1628,3,1170,90,458,24/06/2021,"Tignanello, Toscana",Tuscany,2010,21/07/2021,10953912010,1095391
3758,20/07/2021,4355,71,3690,68,665,13/04/2021,"Chateau Margaux Premier Cru Classe, Margaux",Bordeaux,2011,21/07/2021,10127812011,1012781
3851,07/05/2021,4801,64,3541,310,1260,19/04/2021,"Chateau Angelus Premier Grand Cru Classe A, Saint-Emilion Grand Cru",Bordeaux,2012,08/05/2021,10060452012,1006045
3851,07/05/2021,4808,64,3541,310,1267,19/04/2021,"Chateau Angelus Premier Grand Cru Classe A, Saint-Emilion Grand Cru",Bordeaux,2012,10/05/2021,10060452012,1006045
359,09/07/2021,368,89,324,35,44,09/06/2021,"Chateau Batailley 5eme Cru Classe, Pauillac",Bordeaux,2014,10/07/2021,10063222014,1006322
820,20/07/2021,924,5,735,85,189,09/09/2020,"Chateau Calon Segur 3eme Cru Classe, Saint-Estephe",Bordeaux,2012,21/07/2021,10074752012,1007475
3740,20/07/2021,4095,25,3520,220,575,07/04/2021,"Chateau Margaux Premier Cru Classe, Margaux",Bordeaux,2013,21/07/2021,10127812013,1012781
3851,07/05/2021,4801,64,3541,310,1260,19/04/2021,"Chateau Angelus Premier Grand Cru Classe A, Saint-Emilion Grand Cru",Bordeaux,2012,08/05/2021,10060452012,1006045
3800,20/07/2021,4351,120,3480,320,871,17/06/2021,"Chateau Margaux Premier Cru Classe, Margaux",Bordeaux,2014,21/07/2021,10127812014,1012781
1040,14/07/2021,1383,66,940,100,443,18/03/2021,"Chateau Calon Segur 3eme Cru Classe, Saint-Estephe",Bordeaux,2000,20/07/2021,10074752000,1007475
8200,19/07/2021,9082,15,8100,100,982,21/06/2021,"Chateau Margaux Premier Cru Classe, Margaux",Bordeaux,2000,20/07/2021,10127812000,1012781
3851,05/05/2021,4801,64,3541,310,1260,19/04/2021,"Chateau Angelus Premier Grand Cru Classe A, Saint-Emilion Grand Cru",Bordeaux,2012,07/05/2021,10060452012,1006045
950,19/07/2021,1118,23,800,150,318,21/11/2019,"Chateau Calon Segur 3eme Cru Classe, Saint-Estephe",Bordeaux,2003,20/07/2021,10074752003,1007475
4450,19/07/2021,4754,23,4400,50,354,29/09/2020,"Chateau Margaux Premier Cru Classe, Margaux",Bordeaux,2001,20/07/2021,10127812001,1012781
3939,19/07/2021,4416,21,3684,255,732,10/06/2020,"Chateau Margaux Premier Cru Classe, Margaux",Bordeaux,2002,20/07/2021,10127812002,1012781
3826,19/07/2021,4585,47,4116,-290,469,25/02/2021,"Chateau Margaux Premier Cru Classe, Margaux",Bordeaux,2004,20/07/2021,10127812004,1012781
4850,16/07/2021,6003,22,4650,200,1353,21/06/2021,"Chateau Margaux Premier Cru Classe, Margaux",Bordeaux,2003,20/07/2021,10127812003,1012781
3851,05/05/2021,4752,74,3541,310,1211,19/04/2021,"Chateau Angelus Premier Grand Cru Classe A, Saint-Emilion Grand Cru",Bordeaux,2012,06/05/2021,10060452012,1006045
3851,05/05/2021,4752,74,3541,310,1211,19/04/2021,"Chateau Angelus Premier Grand Cru Classe A, Saint-Emilion Grand Cru",Bordeaux,2012,06/05/2021,10060452012,1006045
840,16/07/2021,1052,20,745,95,307,16/11/2020,"Chateau Calon Segur 3eme Cru Classe, Saint-Estephe",Bordeaux,2004,20/07/2021,10074752004,1007475
3851,05/05/2021,4801,64,3541,310,1260,19/04/2021,"Chateau Angelus Premier Grand Cru Classe A, Saint-Emilion Grand Cru",Bordeaux,2012,07/05/2021,10060452012,1006045
907,19/07/2021,926,18,805,102,121,20/11/2019,"Chateau Calon Segur 3eme Cru Classe, Saint-Estephe",Bordeaux,2001,20/07/2021,10074752001,1007475
476,09/07/2021,520,39,364,112,156,12/05/2021,"Chateau Batailley 5eme Cru Classe, Pauillac",Bordeaux,2016,10/07/2021,10063222016,1006322
3851,03/05/2021,4788,79,3541,310,1247,19/04/2021,"Chateau Angelus Premier Grand Cru Classe A, Saint-Emilion Grand Cru",Bordeaux,2012,04/05/2021,10060452012,1006045
476,09/07/2021,526,37,364,112,162,12/05/2021,"Chateau Batailley 5eme Cru Classe, Pauillac",Bordeaux,2016,12/07/2021,10063222016,1006322
6500,19/07/2021,7502,24,6776,-276,726,10/06/2021,"Chateau Margaux Premier Cru Classe, Margaux",Bordeaux,2005,20/07/2021,10127812005,1012781
3851,03/05/2021,4752,74,3541,310,1211,19/04/2021,"Chateau Angelus Premier Grand Cru Classe A, Saint-Emilion Grand Cru",Bordeaux,2012,05/05/2021,10060452012,1006045
990,19/07/2021,1165,84,988,2,177,28/05/2021,"Chateau Calon Segur 3eme Cru Classe, Saint-Estephe",Bordeaux,2005,20/07/2021,10074752005,1007475
3851,03/05/2021,4788,79,3541,310,1247,19/04/2021,"Chateau Angelus Premier Grand Cru Classe A, Saint-Emilion Grand Cru",Bordeaux,2012,04/05/2021,10060452012,1006045
895,19/07/2021,916,51,863,32,53,10/05/2021,"Chateau Calon Segur 3eme Cru Classe, Saint-Estephe",Bordeaux,2006,20/07/2021,10074752006,1007475
3900,19/07/2021,4683,79,3822,78,861,20/06/2021,"Chateau Margaux Premier Cru Classe, Margaux",Bordeaux,2006,20/07/2021,10127812006,1012781
3750,19/07/2021,4192,93,3525,225,667,18/06/2021,"Chateau Margaux Premier Cru Classe, Margaux",Bordeaux,2007,20/07/2021,10127812007,1012781
880,19/07/2021,980,7,725,155,255,13/04/2021,"Chateau Calon Segur 3eme Cru Classe, Saint-Estephe",Bordeaux,2007,20/07/2021,10074752007,1007475
3851,03/05/2021,4752,74,3541,310,1211,19/04/2021,"Chateau Angelus Premier Grand Cru Classe A, Saint-Emilion Grand Cru",Bordeaux,2012,05/05/2021,10060452012,1006045
2300,10/08/2021,2650,34,2000,300,650,17/02/2021,"Chateau Angelus Premier Grand Cru Classe A, Saint-Emilion Grand Cru",Bordeaux,2013,11/08/2021,10060452013,1006045
3900,19/07/2021,4355,72,3870,30,485,10/07/2021,"Chateau Margaux Premier Cru Classe, Margaux",Bordeaux,2008,20/07/2021,10127812008,1012781
895,19/07/2021,935,22,781,114,154,16/11/2020,"Chateau Calon Segur 3eme Cru Classe, Saint-Estephe",Bordeaux,2008,20/07/2021,10074752008,1007475
6930,19/07/2021,7697,52,7086,-156,611,11/06/2021,"Chateau Margaux Premier Cru Classe, Margaux",Bordeaux,2009,20/07/2021,10127812009,1012781
1000,19/07/2021,1231,51,1026,-26,205,24/06/2021,"Chateau Calon Segur 3eme Cru Classe, Saint-Estephe",Bordeaux,2009,20/07/2021,10074752009,1007475
397,09/07/2021,413,27,357,40,56,06/05/2021,"Chateau Batailley 5eme Cru Classe, Pauillac",Bordeaux,2018,10/07/2021,10063222018,1006322
2300,10/08/2021,2650,34,2000,300,650,17/02/2021,"Chateau Angelus Premier Grand Cru Classe A, Saint-Emilion Grand Cru",Bordeaux,2013,11/08/2021,10060452013,1006045
2500,19/07/2021,2643,3,2400,100,243,18/07/2021,"Gaja, Barbaresco",Piedmont,2001,20/07/2021,10996052001,1099605
2386,19/07/2021,2397,3,2190,196,207,01/05/2021,"Gaja, Barbaresco",Piedmont,2004,20/07/2021,10996052004,1099605
1592,08/07/2021,1657,4,1378,214,279,29/07/2020,"Tignanello, Toscana",Tuscany,2001,20/07/2021,10953912001,1095391
1299,06/07/2021,1516,5,1010,289,506,18/12/2020,"Tignanello, Toscana",Tuscany,2008,20/07/2021,10953912008,1095391
1248,08/07/2021,1310,4,1238,10,72,02/11/2020,"Tignanello, Toscana",Tuscany,2006,20/07/2021,10953912006,1095391
1733,13/07/2021,1713,3,1420,313,293,29/06/2021,"Tignanello, Toscana",Tuscany,2004,20/07/2021,10953912004,1095391
6400,19/07/2021,7569,55,6188,212,1381,16/07/2021,"Chateau Margaux Premier Cru Classe, Margaux",Bordeaux,2010,20/07/2021,10127812010,1012781
990,19/07/2021,1124,16,990,0,134,16/06/2021,"Chateau Calon Segur 3eme Cru Classe, Saint-Estephe",Bordeaux,2010,20/07/2021,10074752010,1007475
2300,09/08/2021,2650,34,2000,300,650,17/02/2021,"Chateau Angelus Premier Grand Cru Classe A, Saint-Emilion Grand Cru",Bordeaux,2013,10/08/2021,10060452013,1006045
750,19/07/2021,893,29,790,-40,103,01/06/2020,"Chateau Calon Segur 3eme Cru Classe, Saint-Estephe",Bordeaux,2011,20/07/2021,10074752011,1007475
1180,19/07/2021,1378,3,1072,108,306,20/01/2021,"Tignanello, Toscana",Tuscany,2009,20/07/2021,10953912009,1095391
1260,19/07/2021,1628,3,1170,90,458,24/06/2021,"Tignanello, Toscana",Tuscany,2010,20/07/2021,10953912010,1095391
3758,19/07/2021,4355,71,3690,68,665,13/04/2021,"Chateau Margaux Premier Cru Classe, Margaux",Bordeaux,2011,20/07/2021,10127812011,1012781
2300,09/08/2021,2650,34,2000,300,650,17/02/2021,"Chateau Angelus Premier Grand Cru Classe A, Saint-Emilion Grand Cru",Bordeaux,2013,10/08/2021,10060452013,1006045
1050,19/07/2021,1133,7,880,170,253,22/06/2021,"Tignanello, Toscana",Tuscany,2011,20/07/2021,10953912011,1095391
820,19/07/2021,924,5,735,85,189,09/09/2020,"Chateau Calon Segur 3eme Cru Classe, Saint-Estephe",Bordeaux,2012,20/07/2021,10074752012,1007475
2300,06/08/2021,2649,34,2000,300,649,17/02/2021,"Chateau Angelus Premier Grand Cru Classe A, Saint-Emilion Grand Cru",Bordeaux,2013,07/08/2021,10060452013,1006045
3750,15/07/2021,4275,41,3560,190,715,20/11/2020,"Chateau Margaux Premier Cru Classe, Margaux",Bordeaux,2012,20/07/2021,10127812012,1012781
3740,19/07/2021,4095,25,3520,220,575,07/04/2021,"Chateau Margaux Premier Cru Classe, Margaux",Bordeaux,2013,20/07/2021,10127812013,1012781
2300,06/08/2021,2650,34,2000,300,650,17/02/2021,"Chateau Angelus Premier Grand Cru Classe A, Saint-Emilion Grand Cru",Bordeaux,2013,09/08/2021,10060452013,1006045
686,16/07/2021,792,19,682,4,110,15/09/2020,"Chateau Calon Segur 3eme Cru Classe, Saint-Estephe",Bordeaux,2013,20/07/2021,10074752013,1007475
1060,20/07/2021,1140,9,860,200,280,08/03/2021,"Tignanello, Toscana",Tuscany,2013,21/07/2021,10953912013,1095391
984,20/07/2021,1048,7,854,130,194,15/07/2021,"Tignanello, Toscana",Tuscany,2014,21/07/2021,10953912014,1095391
10800,20/07/2021,10550,1,8000,2800,2550,30/01/2020,"Domaine Leflaive, Chevalier-Montrachet Grand Cru",Burgundy,2014,21/07/2021,10734012014,1073401
940,20/07/2021,1078,79,866,74,212,20/07/2021,"Chateau Calon Segur 3eme Cru Classe, Saint-Estephe",Bordeaux,2015,21/07/2021,10074752015,1007475
10614,07/07/2021,11687,43,9800,814,1887,11/06/2021,"Chateau Margaux Premier Cru Classe, Margaux",Bordeaux,2015,21/07/2021,10127812015,1012781
4450,30/06/2021,4688,22,4400,50,288,29/09/2020,"Chateau Margaux Premier Cru Classe, Margaux",Bordeaux,2001,01/07/2021,10127812001,1012781
3900,30/06/2021,4495,25,3684,216,811,10/06/2020,"Chateau Margaux Premier Cru Classe, Margaux",Bordeaux,2002,01/07/2021,10127812002,1012781
3826,30/06/2021,4482,60,4116,-290,366,25/02/2021,"Chateau Margaux Premier Cru Classe, Margaux",Bordeaux,2004,01/07/2021,10127812004,1012781
4850,25/06/2021,5859,21,4650,200,1209,21/06/2021,"Chateau Margaux Premier Cru Classe, Margaux",Bordeaux,2003,01/07/2021,10127812003,1012781
2300,06/08/2021,2649,34,2000,300,649,17/02/2021,"Chateau Angelus Premier Grand Cru Classe A, Saint-Emilion Grand Cru",Bordeaux,2013,07/08/2021,10060452013,1006045
2300,06/08/2021,2650,34,2000,300,650,17/02/2021,"Chateau Angelus Premier Grand Cru Classe A, Saint-Emilion Grand Cru",Bordeaux,2013,09/08/2021,10060452013,1006045
800,30/06/2021,921,19,745,55,176,16/11/2020,"Chateau Calon Segur 3eme Cru Classe, Saint-Estephe",Bordeaux,2004,01/07/2021,10074752004,1007475
685,12/07/2021,1033,3,470,215,563,29/03/2018,"Chateau Batailley 5eme Cru Classe, Pauillac",Bordeaux,2000,13/07/2021,10063222000,1006322
907,30/06/2021,953,23,805,102,148,20/11/2019,"Chateau Calon Segur 3eme Cru Classe, Saint-Estephe",Bordeaux,2001,01/07/2021,10074752001,1007475
685,12/07/2021,1033,3,470,215,563,29/03/2018,"Chateau Batailley 5eme Cru Classe, Pauillac",Bordeaux,2000,13/07/2021,10063222000,1006322
2300,05/08/2021,2649,34,2000,300,649,17/02/2021,"Chateau Angelus Premier Grand Cru Classe A, Saint-Emilion Grand Cru",Bordeaux,2013,06/08/2021,10060452013,1006045
480,12/07/2021,592,2,465,15,127,04/05/2020,"Chateau Batailley 5eme Cru Classe, Pauillac",Bordeaux,2001,13/07/2021,10063222001,1006322
6400,30/06/2021,7230,26,6776,-376,454,10/06/2021,"Chateau Margaux Premier Cru Classe, Margaux",Bordeaux,2005,01/07/2021,10127812005,1012781
2300,05/08/2021,2649,34,2000,300,649,17/02/2021,"Chateau Angelus Premier Grand Cru Classe A, Saint-Emilion Grand Cru",Bordeaux,2013,06/08/2021,10060452013,1006045
1000,30/06/2021,1157,92,988,12,169,28/05/2021,"Chateau Calon Segur 3eme Cru Classe, Saint-Estephe",Bordeaux,2005,01/07/2021,10074752005,1007475
2300,04/08/2021,2655,32,2000,300,655,17/02/2021,"Chateau Angelus Premier Grand Cru Classe A, Saint-Emilion Grand Cru",Bordeaux,2013,05/08/2021,10060452013,1006045
900,30/06/2021,1017,53,863,37,154,10/05/2021,"Chateau Calon Segur 3eme Cru Classe, Saint-Estephe",Bordeaux,2006,01/07/2021,10074752006,1007475
3900,30/06/2021,4638,94,3822,78,816,20/06/2021,"Chateau Margaux Premier Cru Classe, Margaux",Bordeaux,2006,01/07/2021,10127812006,1012781
450,12/07/2021,521,3,300,150,221,15/12/2019,"Chateau Batailley 5eme Cru Classe, Pauillac",Bordeaux,2004,13/07/2021,10063222004,1006322
6557,30/06/2021,6557,0,3920,2637,2637,26/04/2017,"Domaine Leflaive, Chevalier-Montrachet Grand Cru",Burgundy,2006,01/07/2021,10734012006,1073401
3560,30/06/2021,4189,40,3525,35,664,18/06/2021,"Chateau Margaux Premier Cru Classe, Margaux",Bordeaux,2007,01/07/2021,10127812007,1012781
880,30/06/2021,967,9,725,155,242,13/04/2021,"Chateau Calon Segur 3eme Cru Classe, Saint-Estephe",Bordeaux,2007,01/07/2021,10074752007,1007475
2300,04/08/2021,2655,32,2000,300,655,17/02/2021,"Chateau Angelus Premier Grand Cru Classe A, Saint-Emilion Grand Cru",Bordeaux,2013,05/08/2021,10060452013,1006045
2300,03/08/2021,2655,32,2000,300,655,17/02/2021,"Chateau Angelus Premier Grand Cru Classe A, Saint-Emilion Grand Cru",Bordeaux,2013,03/08/2021,10060452013,1006045
3900,30/06/2021,4256,79,3750,150,506,28/06/2021,"Chateau Margaux Premier Cru Classe, Margaux",Bordeaux,2008,01/07/2021,10127812008,1012781
895,30/06/2021,980,10,781,114,199,16/11/2020,"Chateau Calon Segur 3eme Cru Classe, Saint-Estephe",Bordeaux,2008,01/07/2021,10074752008,1007475
530,12/07/2021,622,49,520,10,102,17/06/2021,"Chateau Batailley 5eme Cru Classe, Pauillac",Bordeaux,2005,13/07/2021,10063222005,1006322
6830,30/06/2021,7732,48,7086,-256,646,11/06/2021,"Chateau Margaux Premier Cru Classe, Margaux",Bordeaux,2009,01/07/2021,10127812009,1012781
2300,03/08/2021,2655,32,2000,300,655,17/02/2021,"Chateau Angelus Premier Grand Cru Classe A, Saint-Emilion Grand Cru",Bordeaux,2013,04/08/2021,10060452013,1006045
1850,30/06/2021,1831,1,1180,670,651,10/03/2017,"Gaja, Barbaresco",Piedmont,2005,01/07/2021,10996052005,1099605
1800,30/06/2021,1814,1,1300,500,514,30/05/2019,"Gaja, Barbaresco",Piedmont,2007,01/07/2021,10996052007,1099605
2500,30/06/2021,2636,2,2220,280,416,14/06/2021,"Gaja, Barbaresco",Piedmont,2001,01/07/2021,10996052001,1099605
2098,30/06/2021,2300,4,2190,-92,110,01/05/2021,"Gaja, Barbaresco",Piedmont,2004,01/07/2021,10996052004,1099605
520,30/06/2021,563,3,460,60,103,05/05/2020,"Tua Rita, Giusto di Notri, Toscana",Tuscany,2008,01/07/2021,11058072008,1105807
660,30/06/2021,727,5,390,270,337,18/08/2017,"Tua Rita, Giusto di Notri, Toscana",Tuscany,2006,01/07/2021,11058072006,1105807
540,30/06/2021,527,2,300,240,227,03/11/2011,"Tua Rita, Giusto di Notri, Toscana",Tuscany,2007,01/07/2021,11058072007,1105807
1300,30/06/2021,1365,2,1200,100,165,06/03/2021,"Tignanello, Toscana",Tuscany,2007,01/07/2021,10953912007,1095391
1700,30/06/2021,1847,4,1378,322,469,29/07/2020,"Tignanello, Toscana",Tuscany,2001,01/07/2021,10953912001,1095391
1408,30/06/2021,1389,4,1238,170,151,02/11/2020,"Tignanello, Toscana",Tuscany,2006,01/07/2021,10953912006,1095391
6400,30/06/2021,7572,51,5950,450,1622,23/06/2021,"Chateau Margaux Premier Cru Classe, Margaux",Bordeaux,2010,01/07/2021,10127812010,1012781
990,30/06/2021,1116,15,990,0,126,16/06/2021,"Chateau Calon Segur 3eme Cru Classe, Saint-Estephe",Bordeaux,2010,01/07/2021,10074752010,1007475
530,12/07/2021,622,49,520,10,102,17/06/2021,"Chateau Batailley 5eme Cru Classe, Pauillac",Bordeaux,2005,13/07/2021,10063222005,1006322
750,30/06/2021,995,35,790,-40,205,01/06/2020,"Chateau Calon Segur 3eme Cru Classe, Saint-Estephe",Bordeaux,2011,01/07/2021,10074752011,1007475
8400,30/06/2021,8400,1,5960,2440,2440,01/08/2017,"Domaine Leflaive, Chevalier-Montrachet Grand Cru",Burgundy,2010,01/07/2021,10734012010,1073401
1024,30/06/2021,1255,4,1072,-48,183,20/01/2021,"Tignanello, Toscana",Tuscany,2009,01/07/2021,10953912009,1095391
1326,30/06/2021,1473,3,1170,156,303,24/06/2021,"Tignanello, Toscana",Tuscany,2010,01/07/2021,10953912010,1095391
3758,30/06/2021,4043,74,3690,68,353,13/04/2021,"Chateau Margaux Premier Cru Classe, Margaux",Bordeaux,2011,01/07/2021,10127812011,1012781
2300,02/08/2021,2655,32,2000,300,655,17/02/2021,"Chateau Angelus Premier Grand Cru Classe A, Saint-Emilion Grand Cru",Bordeaux,2013,03/08/2021,10060452013,1006045
2199,30/06/2021,2225,2,1340,859,885,13/03/2020,"Gaja, Barbaresco",Piedmont,2009,01/07/2021,10996052009,1099605
960,30/06/2021,1043,9,880,80,163,22/06/2021,"Tignanello, Toscana",Tuscany,2011,01/07/2021,10953912011,1095391
2300,02/08/2021,2655,32,2000,300,655,17/02/2021,"Chateau Angelus Premier Grand Cru Classe A, Saint-Emilion Grand Cru",Bordeaux,2013,03/08/2021,10060452013,1006045
420,12/07/2021,445,3,400,20,45,11/05/2021,"Chateau Batailley 5eme Cru Classe, Pauillac",Bordeaux,2006,13/07/2021,10063222006,1006322
820,30/06/2021,939,6,735,85,204,09/09/2020,"Chateau Calon Segur 3eme Cru Classe, Saint-Estephe",Bordeaux,2012,01/07/2021,10074752012,1007475
3750,24/06/2021,4160,42,3560,190,600,20/11/2020,"Chateau Margaux Premier Cru Classe, Margaux",Bordeaux,2012,01/07/2021,10127812012,1012781
13200,30/06/2021,12867,1,12850,350,17,30/11/2020,"Jacques-Frederic Mugnier, Chambolle-Musigny Premier Cru, Les Amoureuses",Burgundy,2011,01/07/2021,10496422011,1049642
6400,30/06/2021,17200,1,4500,1900,12700,08/04/2015,"Domaine Leflaive, Chevalier-Montrachet Grand Cru",Burgundy,2012,01/07/2021,10734012012,1073401
3740,30/06/2021,4016,53,3520,220,496,07/04/2021,"Chateau Margaux Premier Cru Classe, Margaux",Bordeaux,2013,01/07/2021,10127812013,1012781
2300,30/07/2021,2655,32,2000,300,655,17/02/2021,"Chateau Angelus Premier Grand Cru Classe A, Saint-Emilion Grand Cru",Bordeaux,2013,31/07/2021,10060452013,1006045
420,12/07/2021,445,3,400,20,45,11/05/2021,"Chateau Batailley 5eme Cru Classe, Pauillac",Bordeaux,2006,13/07/2021,10063222006,1006322
686,30/06/2021,826,7,682,4,144,15/09/2020,"Chateau Calon Segur 3eme Cru Classe, Saint-Estephe",Bordeaux,2013,01/07/2021,10074752013,1007475
1380,30/06/2021,1443,7,1352,28,91,23/09/2020,"Gaja, Barbaresco",Piedmont,2011,01/07/2021,10996052011,1099605
6282,18/06/2021,10048,1,4000,2282,6048,25/04/2016,"Domaine Denis Mortet, Chambertin Grand Cru",Burgundy,2013,01/07/2021,10490202013,1049020
960,30/06/2021,1272,13,850,110,422,28/01/2021,"Tignanello, Toscana",Tuscany,2012,01/07/2021,10953912012,1095391
2300,30/07/2021,2655,32,2000,300,655,17/02/2021,"Chateau Angelus Premier Grand Cru Classe A, Saint-Emilion Grand Cru",Bordeaux,2013,31/07/2021,10060452013,1006045
3720,30/06/2021,4320,146,3480,240,840,17/06/2021,"Chateau Margaux Premier Cru Classe, Margaux",Bordeaux,2014,01/07/2021,10127812014,1012781
450,12/07/2021,417,3,332,118,85,06/10/2020,"Chateau Batailley 5eme Cru Classe, Pauillac",Bordeaux,2008,13/07/2021,10063222008,1006322
1550,30/06/2021,1557,1,1300,250,257,27/04/2021,"Gaja, Barbaresco",Piedmont,2012,01/07/2021,10996052012,1099605
1090,30/06/2021,1165,6,860,230,305,08/03/2021,"Tignanello, Toscana",Tuscany,2013,01/07/2021,10953912013,1095391
984,30/06/2021,1106,42,830,154,276,22/06/2021,"Tignanello, Toscana",Tuscany,2014,01/07/2021,10953912014,1095391
1400,30/06/2021,1536,14,1300,100,236,30/06/2021,"Gaja, Barbaresco",Piedmont,2013,01/07/2021,10996052013,1099605
9600,30/06/2021,9690,1,8000,1600,1690,30/01/2020,"Domaine Leflaive, Chevalier-Montrachet Grand Cru",Burgundy,2014,01/07/2021,10734012014,1073401
1300,30/06/2021,1566,15,1300,0,266,28/09/2020,"Gaja, Barbaresco",Piedmont,2014,01/07/2021,10996052014,1099605
850,30/06/2021,1078,85,822,28,256,28/06/2021,"Chateau Calon Segur 3eme Cru Classe, Saint-Estephe",Bordeaux,2015,01/07/2021,10074752015,1007475
10400,30/06/2021,11947,51,9800,600,2147,11/06/2021,"Chateau Margaux Premier Cru Classe, Margaux",Bordeaux,2015,01/07/2021,10127812015,1012781
14520,30/06/2021,14520,1,12000,2520,2520,28/05/2020,"Jacques-Frederic Mugnier, Chambolle-Musigny Premier Cru, Les Amoureuses",Burgundy,2014,01/07/2021,10496422014,1049642
1130,30/06/2021,1228,9,1202,-72,26,10/05/2021,"Tignanello, Toscana",Tuscany,2015,01/07/2021,10953912015,1095391
16200,30/06/2021,16040,0,18750,-2550,-2710,29/08/2018,"Jacques-Frederic Mugnier, Chambolle-Musigny Premier Cru, Les Amoureuses",Burgundy,2015,01/07/2021,10496422015,1049642
5307,28/06/2021,5793,119,5238,69,555,17/05/2021,"Chateau Margaux Premier Cru Classe, Margaux",Bordeaux,2016,01/07/2021,10127812016,1012781
2300,29/07/2021,2655,32,2000,300,655,17/02/2021,"Chateau Angelus Premier Grand Cru Classe A, Saint-Emilion Grand Cru",Bordeaux,2013,30/07/2021,10060452013,1006045
1100,30/06/2021,1220,68,1036,64,184,27/05/2021,"Chateau Calon Segur 3eme Cru Classe, Saint-Estephe",Bordeaux,2016,01/07/2021,10074752016,1007475
510,12/07/2021,596,398,494,16,102,20/04/2021,"Chateau Batailley 5eme Cru Classe, Pauillac",Bordeaux,2010,13/07/2021,10063222010,1006322
1244,30/06/2021,1270,44,1100,144,170,28/06/2021,"Tignanello, Toscana",Tuscany,2016,01/07/2021,10953912016,1095391
2300,29/07/2021,2655,32,2000,300,655,17/02/2021,"Chateau Angelus Premier Grand Cru Classe A, Saint-Emilion Grand Cru",Bordeaux,2013,30/07/2021,10060452013,1006045
780,30/06/2021,929,102,740,40,189,21/05/2021,"Chateau Calon Segur 3eme Cru Classe, Saint-Estephe",Bordeaux,2017,01/07/2021,10074752017,1007475
3790,30/06/2021,4221,105,3950,-160,271,30/06/2021,"Chateau Margaux Premier Cru Classe, Margaux",Bordeaux,2017,01/07/2021,10127812017,1012781
1350,30/06/2021,1475,60,1260,90,215,18/02/2021,"Gaja, Barbaresco",Piedmont,2015,01/07/2021,10996052015,1099605
460,30/06/2021,489,188,420,40,69,28/05/2021,"Tua Rita, Giusto di Notri, Toscana",Tuscany,2016,01/07/2021,11058072016,1105807
8000,30/06/2021,8692,5,6974,1026,1718,14/03/2021,"Domaine Leflaive, Chevalier-Montrachet Grand Cru",Burgundy,2017,01/07/2021,10734012017,1073401
15600,30/06/2021,15231,5,13000,2600,2231,29/04/2021,"Jacques-Frederic Mugnier, Chambolle-Musigny Premier Cru, Les Amoureuses",Burgundy,2017,01/07/2021,10496422017,1049642
2300,28/07/2021,2655,32,2000,300,655,17/02/2021,"Chateau Angelus Premier Grand Cru Classe A, Saint-Emilion Grand Cru",Bordeaux,2013,29/07/2021,10060452013,1006045
5600,30/06/2021,5852,100,5254,346,598,26/05/2021,"Chateau Margaux Premier Cru Classe, Margaux",Bordeaux,2018,01/07/2021,10127812018,1012781
1080,30/06/2021,1216,48,950,130,266,03/05/2021,"Chateau Calon Segur 3eme Cru Classe, Saint-Estephe",Bordeaux,2018,01/07/2021,10074752018,1007475
857,30/06/2021,949,144,844,13,105,25/06/2021,"Tignanello, Toscana",Tuscany,2017,01/07/2021,10953912017,1095391
7800,30/06/2021,8255,5,7330,470,925,02/06/2021,"Domaine Leflaive, Chevalier-Montrachet Grand Cru",Burgundy,2018,01/07/2021,10734012018,1073401
860,30/06/2021,1031,71,910,-50,121,23/06/2021,"Tignanello, Toscana",Tuscany,2018,01/07/2021,10953912018,1095391
510,12/07/2021,596,398,494,16,102,20/04/2021,"Chateau Batailley 5eme Cru Classe, Pauillac",Bordeaux,2010,13/07/2021,10063222010,1006322
5260,30/06/2021,5088,7,4160,1100,928,19/03/2021,"Chateau Margaux Premier Cru Classe, Margaux",Bordeaux,2019,01/07/2021,10127812019,1012781
430,30/06/2021,461,121,380,50,81,25/03/2021,"Tua Rita, Giusto di Notri, Toscana",Tuscany,2018,01/07/2021,11058072018,1105807
1040,30/06/2021,1205,23,940,100,265,18/03/2021,"Chateau Calon Segur 3eme Cru Classe, Saint-Estephe",Bordeaux,2000,02/07/2021,10074752000,1007475
3935,06/08/2021,4648,43,4116,-181,532,25/02/2021,"Chateau Margaux Premier Cru Classe, Margaux",Bordeaux,2004,07/08/2021,10127812004,1012781
1090,06/08/2021,1136,8,952,138,184,04/08/2021,"Tignanello, Toscana",Tuscany,2013,07/08/2021,10953912013,1095391
2300,28/07/2021,2655,32,2000,300,655,17/02/2021,"Chateau Angelus Premier Grand Cru Classe A, Saint-Emilion Grand Cru",Bordeaux,2013,29/07/2021,10060452013,1006045
3800,03/08/2021,4349,127,3600,200,749,02/08/2021,"Chateau Margaux Premier Cru Classe, Margaux",Bordeaux,2014,04/08/2021,10127812014,1012781
3800,02/08/2021,4531,57,3525,275,1006,18/06/2021,"Chateau Margaux Premier Cru Classe, Margaux",Bordeaux,2007,04/08/2021,10127812007,1012781
870,21/07/2021,966,5,705,165,261,01/02/2021,"Chateau Calon Segur 3eme Cru Classe, Saint-Estephe",Bordeaux,2002,22/07/2021,10074752002,1007475
2300,27/07/2021,2658,31,2000,300,658,17/02/2021,"Chateau Angelus Premier Grand Cru Classe A, Saint-Emilion Grand Cru",Bordeaux,2013,28/07/2021,10060452013,1006045
950,21/07/2021,1118,23,800,150,318,21/11/2019,"Chateau Calon Segur 3eme Cru Classe, Saint-Estephe",Bordeaux,2003,22/07/2021,10074752003,1007475
4450,21/07/2021,4750,24,4400,50,350,29/09/2020,"Chateau Margaux Premier Cru Classe, Margaux",Bordeaux,2001,22/07/2021,10127812001,1012781
4050,21/07/2021,4417,22,3684,366,733,10/06/2020,"Chateau Margaux Premier Cru Classe, Margaux",Bordeaux,2002,22/07/2021,10127812002,1012781
3826,21/07/2021,4585,47,4116,-290,469,25/02/2021,"Chateau Margaux Premier Cru Classe, Margaux",Bordeaux,2004,22/07/2021,10127812004,1012781
2300,27/07/2021,2658,31,2000,300,658,17/02/2021,"Chateau Angelus Premier Grand Cru Classe A, Saint-Emilion Grand Cru",Bordeaux,2013,28/07/2021,10060452013,1006045
840,21/07/2021,1052,20,745,95,307,16/11/2020,"Chateau Calon Segur 3eme Cru Classe, Saint-Estephe",Bordeaux,2004,22/07/2021,10074752004,1007475
2300,26/07/2021,2650,31,2000,300,650,17/02/2021,"Chateau Angelus Premier Grand Cru Classe A, Saint-Emilion Grand Cru",Bordeaux,2013,27/07/2021,10060452013,1006045
5100,05/08/2021,5703,19,4650,450,1053,21/06/2021,"Chateau Margaux Premier Cru Classe, Margaux",Bordeaux,2003,06/08/2021,10127812003,1012781
1584,04/08/2021,1670,4,1378,206,292,29/07/2020,"Tignanello, Toscana",Tuscany,2001,05/08/2021,10953912001,1095391
1584,06/08/2021,1670,4,1378,206,292,29/07/2020,"Tignanello, Toscana",Tuscany,2001,07/08/2021,10953912001,1095391
3900,06/08/2021,4228,49,3690,210,538,13/04/2021,"Chateau Margaux Premier Cru Classe, Margaux",Bordeaux,2011,07/08/2021,10127812011,1012781
2300,26/07/2021,2650,31,2000,300,650,17/02/2021,"Chateau Angelus Premier Grand Cru Classe A, Saint-Emilion Grand Cru",Bordeaux,2013,27/07/2021,10060452013,1006045
1680,06/08/2021,1693,2,1420,260,273,29/06/2021,"Tignanello, Toscana",Tuscany,2004,07/08/2021,10953912004,1095391
3900,04/08/2021,4228,49,3690,210,538,13/04/2021,"Chateau Margaux Premier Cru Classe, Margaux",Bordeaux,2011,05/08/2021,10127812011,1012781
10620,03/08/2021,11831,47,9800,820,2031,11/06/2021,"Chateau Margaux Premier Cru Classe, Margaux",Bordeaux,2015,04/08/2021,10127812015,1012781
3700,06/08/2021,4167,47,3520,180,647,07/04/2021,"Chateau Margaux Premier Cru Classe, Margaux",Bordeaux,2013,07/08/2021,10127812013,1012781
907,21/07/2021,952,22,805,102,147,20/11/2019,"Chateau Calon Segur 3eme Cru Classe, Saint-Estephe",Bordeaux,2001,22/07/2021,10074752001,1007475
320,12/07/2021,321,110,304,16,17,10/01/2021,"Chateau Batailley 5eme Cru Classe, Pauillac",Bordeaux,2013,13/07/2021,10063222013,1006322
2300,23/07/2021,2726,21,2000,300,726,17/02/2021,"Chateau Angelus Premier Grand Cru Classe A, Saint-Emilion Grand Cru",Bordeaux,2013,24/07/2021,10060452013,1006045
359,12/07/2021,368,89,324,35,44,09/06/2021,"Chateau Batailley 5eme Cru Classe, Pauillac",Bordeaux,2014,13/07/2021,10063222014,1006322
6500,21/07/2021,7503,24,6776,-276,727,10/06/2021,"Chateau Margaux Premier Cru Classe, Margaux",Bordeaux,2005,22/07/2021,10127812005,1012781
2300,23/07/2021,2726,21,2000,300,726,17/02/2021,"Chateau Angelus Premier Grand Cru Classe A, Saint-Emilion Grand Cru",Bordeaux,2013,24/07/2021,10060452013,1006045
990,19/07/2021,1165,84,1029,-39,136,21/07/2021,"Chateau Calon Segur 3eme Cru Classe, Saint-Estephe",Bordeaux,2005,22/07/2021,10074752005,1007475
476,12/07/2021,526,37,364,112,162,12/05/2021,"Chateau Batailley 5eme Cru Classe, Pauillac",Bordeaux,2016,13/07/2021,10063222016,1006322
2300,22/07/2021,2681,26,2000,300,681,17/02/2021,"Chateau Angelus Premier Grand Cru Classe A, Saint-Emilion Grand Cru",Bordeaux,2013,23/07/2021,10060452013,1006045
895,21/07/2021,928,41,863,32,65,10/05/2021,"Chateau Calon Segur 3eme Cru Classe, Saint-Estephe",Bordeaux,2006,22/07/2021,10074752006,1007475
3900,21/07/2021,4683,79,3822,78,861,20/06/2021,"Chateau Margaux Premier Cru Classe, Margaux",Bordeaux,2006,22/07/2021,10127812006,1012781
3750,21/07/2021,4258,81,3525,225,733,18/06/2021,"Chateau Margaux Premier Cru Classe, Margaux",Bordeaux,2007,22/07/2021,10127812007,1012781
880,21/07/2021,980,7,725,155,255,13/04/2021,"Chateau Calon Segur 3eme Cru Classe, Saint-Estephe",Bordeaux,2007,22/07/2021,10074752007,1007475
2300,22/07/2021,2681,26,2000,300,681,17/02/2021,"Chateau Angelus Premier Grand Cru Classe A, Saint-Emilion Grand Cru",Bordeaux,2013,23/07/2021,10060452013,1006045
8400,21/07/2021,8400,1,5700,2700,2700,10/09/2020,"Domaine Leflaive, Chevalier-Montrachet Grand Cru",Burgundy,2007,22/07/2021,10734012007,1073401
2300,21/07/2021,2681,26,2000,300,681,17/02/2021,"Chateau Angelus Premier Grand Cru Classe A, Saint-Emilion Grand Cru",Bordeaux,2013,22/07/2021,10060452013,1006045
3900,21/07/2021,4355,72,3870,30,485,10/07/2021,"Chateau Margaux Premier Cru Classe, Margaux",Bordeaux,2008,22/07/2021,10127812008,1012781
895,21/07/2021,981,10,781,114,200,16/11/2020,"Chateau Calon Segur 3eme Cru Classe, Saint-Estephe",Bordeaux,2008,22/07/2021,10074752008,1007475
6930,21/07/2021,7721,53,7086,-156,635,11/06/2021,"Chateau Margaux Premier Cru Classe, Margaux",Bordeaux,2009,22/07/2021,10127812009,1012781
9000,21/07/2021,8799,1,5400,3600,3399,13/08/2020,"Domaine Leflaive, Chevalier-Montrachet Grand Cru",Burgundy,2008,22/07/2021,10734012008,1073401
1000,21/07/2021,1231,51,1026,-26,205,24/06/2021,"Chateau Calon Segur 3eme Cru Classe, Saint-Estephe",Bordeaux,2009,22/07/2021,10074752009,1007475
870,21/07/2021,966,5,705,165,261,01/02/2021,"Chateau Calon Segur 3eme Cru Classe, Saint-Estephe",Bordeaux,2002,22/07/2021,10074752002,1007475
2300,21/07/2021,2681,26,2000,300,681,17/02/2021,"Chateau Angelus Premier Grand Cru Classe A, Saint-Emilion Grand Cru",Bordeaux,2013,22/07/2021,10060452013,1006045
950,21/07/2021,1118,23,800,150,318,21/11/2019,"Chateau Calon Segur 3eme Cru Classe, Saint-Estephe",Bordeaux,2003,22/07/2021,10074752003,1007475
4450,21/07/2021,4750,24,4400,50,350,29/09/2020,"Chateau Margaux Premier Cru Classe, Margaux",Bordeaux,2001,22/07/2021,10127812001,1012781
4050,21/07/2021,4417,22,3684,366,733,10/06/2020,"Chateau Margaux Premier Cru Classe, Margaux",Bordeaux,2002,22/07/2021,10127812002,1012781
3826,21/07/2021,4585,47,4116,-290,469,25/02/2021,"Chateau Margaux Premier Cru Classe, Margaux",Bordeaux,2004,22/07/2021,10127812004,1012781
2300,20/07/2021,2681,26,2000,300,681,17/02/2021,"Chateau Angelus Premier Grand Cru Classe A, Saint-Emilion Grand Cru",Bordeaux,2013,21/07/2021,10060452013,1006045
840,21/07/2021,1052,20,745,95,307,16/11/2020,"Chateau Calon Segur 3eme Cru Classe, Saint-Estephe",Bordeaux,2004,22/07/2021,10074752004,1007475
907,21/07/2021,952,22,805,102,147,20/11/2019,"Chateau Calon Segur 3eme Cru Classe, Saint-Estephe",Bordeaux,2001,22/07/2021,10074752001,1007475
480,13/07/2021,592,2,465,15,127,04/05/2020,"Chateau Batailley 5eme Cru Classe, Pauillac",Bordeaux,2001,14/07/2021,10063222001,1006322
2300,20/07/2021,2681,26,2000,300,681,17/02/2021,"Chateau Angelus Premier Grand Cru Classe A, Saint-Emilion Grand Cru",Bordeaux,2013,21/07/2021,10060452013,1006045
450,13/07/2021,521,3,300,150,221,15/12/2019,"Chateau Batailley 5eme Cru Classe, Pauillac",Bordeaux,2004,14/07/2021,10063222004,1006322
6500,21/07/2021,7503,24,6776,-276,727,10/06/2021,"Chateau Margaux Premier Cru Classe, Margaux",Bordeaux,2005,22/07/2021,10127812005,1012781
1879,15/07/2021,2681,26,2000,-121,681,17/02/2021,"Chateau Angelus Premier Grand Cru Classe A, Saint-Emilion Grand Cru",Bordeaux,2013,20/07/2021,10060452013,1006045
990,19/07/2021,1165,84,1029,-39,136,21/07/2021,"Chateau Calon Segur 3eme Cru Classe, Saint-Estephe",Bordeaux,2005,22/07/2021,10074752005,1007475
1879,15/07/2021,2676,28,2000,-121,676,17/02/2021,"Chateau Angelus Premier Grand Cru Classe A, Saint-Emilion Grand Cru",Bordeaux,2013,16/07/2021,10060452013,1006045
1850,21/07/2021,1812,1,1180,670,632,10/03/2017,"Gaja, Barbaresco",Piedmont,2005,22/07/2021,10996052005,1099605
1879,15/07/2021,2676,28,2000,-121,676,17/02/2021,"Chateau Angelus Premier Grand Cru Classe A, Saint-Emilion Grand Cru",Bordeaux,2013,16/07/2021,10060452013,1006045
895,21/07/2021,928,41,863,32,65,10/05/2021,"Chateau Calon Segur 3eme Cru Classe, Saint-Estephe",Bordeaux,2006,22/07/2021,10074752006,1007475
3900,21/07/2021,4683,79,3822,78,861,20/06/2021,"Chateau Margaux Premier Cru Classe, Margaux",Bordeaux,2006,22/07/2021,10127812006,1012781
1800,21/07/2021,1700,1,1300,500,400,30/05/2019,"Gaja, Barbaresco",Piedmont,2007,22/07/2021,10996052007,1099605
2386,21/07/2021,2397,3,2190,196,207,01/05/2021,"Gaja, Barbaresco",Piedmont,2004,22/07/2021,10996052004,1099605
660,21/07/2021,727,5,390,270,337,18/08/2017,"Tua Rita, Giusto di Notri, Toscana",Tuscany,2006,22/07/2021,11058072006,1105807
520,21/07/2021,563,3,460,60,103,05/05/2020,"Tua Rita, Giusto di Notri, Toscana",Tuscany,2008,22/07/2021,11058072008,1105807
6400,21/07/2021,7568,55,6188,212,1380,16/07/2021,"Chateau Margaux Premier Cru Classe, Margaux",Bordeaux,2010,22/07/2021,10127812010,1012781
990,21/07/2021,1124,16,990,0,134,16/06/2021,"Chateau Calon Segur 3eme Cru Classe, Saint-Estephe",Bordeaux,2010,22/07/2021,10074752010,1007475
589,13/07/2021,622,49,520,69,102,17/06/2021,"Chateau Batailley 5eme Cru Classe, Pauillac",Bordeaux,2005,14/07/2021,10063222005,1006322
1879,15/07/2021,2681,26,2000,-121,681,17/02/2021,"Chateau Angelus Premier Grand Cru Classe A, Saint-Emilion Grand Cru",Bordeaux,2013,20/07/2021,10060452013,1006045
3750,21/07/2021,4258,81,3525,225,733,18/06/2021,"Chateau Margaux Premier Cru Classe, Margaux",Bordeaux,2007,22/07/2021,10127812007,1012781
880,21/07/2021,980,7,725,155,255,13/04/2021,"Chateau Calon Segur 3eme Cru Classe, Saint-Estephe",Bordeaux,2007,22/07/2021,10074752007,1007475
2300,14/07/2021,2684,29,2000,300,684,17/02/2021,"Chateau Angelus Premier Grand Cru Classe A, Saint-Emilion Grand Cru",Bordeaux,2013,15/07/2021,10060452013,1006045
2300,14/07/2021,2684,29,2000,300,684,17/02/2021,"Chateau Angelus Premier Grand Cru Classe A, Saint-Emilion Grand Cru",Bordeaux,2013,15/07/2021,10060452013,1006045
3900,21/07/2021,4355,72,3870,30,485,10/07/2021,"Chateau Margaux Premier Cru Classe, Margaux",Bordeaux,2008,22/07/2021,10127812008,1012781
895,21/07/2021,981,10,781,114,200,16/11/2020,"Chateau Calon Segur 3eme Cru Classe, Saint-Estephe",Bordeaux,2008,22/07/2021,10074752008,1007475
6930,21/07/2021,7721,53,7086,-156,635,11/06/2021,"Chateau Margaux Premier Cru Classe, Margaux",Bordeaux,2009,22/07/2021,10127812009,1012781
1000,21/07/2021,1231,51,1026,-26,205,24/06/2021,"Chateau Calon Segur 3eme Cru Classe, Saint-Estephe",Bordeaux,2009,22/07/2021,10074752009,1007475
589,13/07/2021,622,49,520,69,102,17/06/2021,"Chateau Batailley 5eme Cru Classe, Pauillac",Bordeaux,2005,14/07/2021,10063222005,1006322
2300,13/07/2021,2684,29,2000,300,684,17/02/2021,"Chateau Angelus Premier Grand Cru Classe A, Saint-Emilion Grand Cru",Bordeaux,2013,14/07/2021,10060452013,1006045
2386,21/07/2021,2397,3,2190,196,207,01/05/2021,"Gaja, Barbaresco",Piedmont,2004,22/07/2021,10996052004,1099605
6400,21/07/2021,7568,55,6188,212,1380,16/07/2021,"Chateau Margaux Premier Cru Classe, Margaux",Bordeaux,2010,22/07/2021,10127812010,1012781
510,13/07/2021,596,398,494,16,102,20/04/2021,"Chateau Batailley 5eme Cru Classe, Pauillac",Bordeaux,2010,14/07/2021,10063222010,1006322
990,21/07/2021,1124,16,990,0,134,16/06/2021,"Chateau Calon Segur 3eme Cru Classe, Saint-Estephe",Bordeaux,2010,22/07/2021,10074752010,1007475
2300,13/07/2021,2684,29,2000,300,684,17/02/2021,"Chateau Angelus Premier Grand Cru Classe A, Saint-Emilion Grand Cru",Bordeaux,2013,14/07/2021,10060452013,1006045
750,21/07/2021,892,29,790,-40,102,01/06/2020,"Chateau Calon Segur 3eme Cru Classe, Saint-Estephe",Bordeaux,2011,22/07/2021,10074752011,1007475
1180,21/07/2021,1378,3,1140,40,238,21/07/2021,"Tignanello, Toscana",Tuscany,2009,22/07/2021,10953912009,1095391
1260,21/07/2021,1628,3,1170,90,458,24/06/2021,"Tignanello, Toscana",Tuscany,2010,22/07/2021,10953912010,1095391
3758,21/07/2021,4355,71,3690,68,665,13/04/2021,"Chateau Margaux Premier Cru Classe, Margaux",Bordeaux,2011,22/07/2021,10127812011,1012781
2300,12/07/2021,2684,29,2000,300,684,17/02/2021,"Chateau Angelus Premier Grand Cru Classe A, Saint-Emilion Grand Cru",Bordeaux,2013,13/07/2021,10060452013,1006045
510,13/07/2021,596,398,494,16,102,20/04/2021,"Chateau Batailley 5eme Cru Classe, Pauillac",Bordeaux,2010,14/07/2021,10063222010,1006322
1050,21/07/2021,1133,7,880,170,253,22/06/2021,"Tignanello, Toscana",Tuscany,2011,22/07/2021,10953912011,1095391
2300,12/07/2021,2684,29,2000,300,684,17/02/2021,"Chateau Angelus Premier Grand Cru Classe A, Saint-Emilion Grand Cru",Bordeaux,2013,13/07/2021,10060452013,1006045
320,13/07/2021,321,110,304,16,17,10/01/2021,"Chateau Batailley 5eme Cru Classe, Pauillac",Bordeaux,2013,14/07/2021,10063222013,1006322
820,21/07/2021,924,5,735,85,189,09/09/2020,"Chateau Calon Segur 3eme Cru Classe, Saint-Estephe",Bordeaux,2012,22/07/2021,10074752012,1007475
3740,21/07/2021,4120,25,3520,220,600,07/04/2021,"Chateau Margaux Premier Cru Classe, Margaux",Bordeaux,2013,22/07/2021,10127812013,1012781
2300,09/07/2021,2684,29,2000,300,684,17/02/2021,"Chateau Angelus Premier Grand Cru Classe A, Saint-Emilion Grand Cru",Bordeaux,2013,10/07/2021,10060452013,1006045
800,21/07/2021,792,19,682,118,110,15/09/2020,"Chateau Calon Segur 3eme Cru Classe, Saint-Estephe",Bordeaux,2013,22/07/2021,10074752013,1007475
960,21/07/2021,1346,11,850,110,496,28/01/2021,"Tignanello, Toscana",Tuscany,2012,22/07/2021,10953912012,1095391
2300,09/07/2021,2684,29,2000,300,684,17/02/2021,"Chateau Angelus Premier Grand Cru Classe A, Saint-Emilion Grand Cru",Bordeaux,2013,10/07/2021,10060452013,1006045
3800,21/07/2021,4351,120,3480,320,871,17/06/2021,"Chateau Margaux Premier Cru Classe, Margaux",Bordeaux,2014,22/07/2021,10127812014,1012781
1060,21/07/2021,1140,9,860,200,280,08/03/2021,"Tignanello, Toscana",Tuscany,2013,22/07/2021,10953912013,1095391
984,21/07/2021,1048,7,854,130,194,15/07/2021,"Tignanello, Toscana",Tuscany,2014,22/07/2021,10953912014,1095391
940,21/07/2021,1078,79,866,74,212,20/07/2021,"Chateau Calon Segur 3eme Cru Classe, Saint-Estephe",Bordeaux,2015,22/07/2021,10074752015,1007475
10620,21/07/2021,11692,42,9800,820,1892,11/06/2021,"Chateau Margaux Premier Cru Classe, Margaux",Bordeaux,2015,22/07/2021,10127812015,1012781
870,22/07/2021,966,5,705,165,261,01/02/2021,"Chateau Calon Segur 3eme Cru Classe, Saint-Estephe",Bordeaux,2002,23/07/2021,10074752002,1007475
2300,08/07/2021,2684,29,2000,300,684,17/02/2021,"Chateau Angelus Premier Grand Cru Classe A, Saint-Emilion Grand Cru",Bordeaux,2013,09/07/2021,10060452013,1006045
4050,22/07/2021,4417,22,3684,366,733,10/06/2020,"Chateau Margaux Premier Cru Classe, Margaux",Bordeaux,2002,23/07/2021,10127812002,1012781
3840,22/07/2021,4601,46,4116,-276,485,25/02/2021,"Chateau Margaux Premier Cru Classe, Margaux",Bordeaux,2004,23/07/2021,10127812004,1012781
4450,22/07/2021,4750,24,4400,50,350,29/09/2020,"Chateau Margaux Premier Cru Classe, Margaux",Bordeaux,2001,23/07/2021,10127812001,1012781
2300,08/07/2021,2684,29,2000,300,684,17/02/2021,"Chateau Angelus Premier Grand Cru Classe A, Saint-Emilion Grand Cru",Bordeaux,2013,09/07/2021,10060452013,1006045
2300,07/07/2021,2677,30,2000,300,677,17/02/2021,"Chateau Angelus Premier Grand Cru Classe A, Saint-Emilion Grand Cru",Bordeaux,2013,08/07/2021,10060452013,1006045
840,22/07/2021,1059,19,745,95,314,16/11/2020,"Chateau Calon Segur 3eme Cru Classe, Saint-Estephe",Bordeaux,2004,23/07/2021,10074752004,1007475
870,22/07/2021,966,5,705,165,261,01/02/2021,"Chateau Calon Segur 3eme Cru Classe, Saint-Estephe",Bordeaux,2002,23/07/2021,10074752002,1007475
2300,07/07/2021,2677,30,2000,300,677,17/02/2021,"Chateau Angelus Premier Grand Cru Classe A, Saint-Emilion Grand Cru",Bordeaux,2013,08/07/2021,10060452013,1006045
4450,22/07/2021,4750,24,4400,50,350,29/09/2020,"Chateau Margaux Premier Cru Classe, Margaux",Bordeaux,2001,23/07/2021,10127812001,1012781
4050,22/07/2021,4417,22,3684,366,733,10/06/2020,"Chateau Margaux Premier Cru Classe, Margaux",Bordeaux,2002,23/07/2021,10127812002,1012781
3840,22/07/2021,4601,46,4116,-276,485,25/02/2021,"Chateau Margaux Premier Cru Classe, Margaux",Bordeaux,2004,23/07/2021,10127812004,1012781
2300,06/07/2021,2674,30,2000,300,674,17/02/2021,"Chateau Angelus Premier Grand Cru Classe A, Saint-Emilion Grand Cru",Bordeaux,2013,07/07/2021,10060452013,1006045
2300,06/07/2021,2674,30,2000,300,674,17/02/2021,"Chateau Angelus Premier Grand Cru Classe A, Saint-Emilion Grand Cru",Bordeaux,2013,07/07/2021,10060452013,1006045
840,22/07/2021,1059,19,745,95,314,16/11/2020,"Chateau Calon Segur 3eme Cru Classe, Saint-Estephe",Bordeaux,2004,23/07/2021,10074752004,1007475
359,13/07/2021,368,89,324,35,44,09/06/2021,"Chateau Batailley 5eme Cru Classe, Pauillac",Bordeaux,2014,14/07/2021,10063222014,1006322
2300,05/07/2021,2674,30,2000,300,674,17/02/2021,"Chateau Angelus Premier Grand Cru Classe A, Saint-Emilion Grand Cru",Bordeaux,2013,06/07/2021,10060452013,1006045
6500,22/07/2021,7503,24,6400,100,1103,22/07/2021,"Chateau Margaux Premier Cru Classe, Margaux",Bordeaux,2005,23/07/2021,10127812005,1012781
990,22/07/2021,1165,84,1029,-39,136,21/07/2021,"Chateau Calon Segur 3eme Cru Classe, Saint-Estephe",Bordeaux,2005,23/07/2021,10074752005,1007475
2300,05/07/2021,2674,30,2000,300,674,17/02/2021,"Chateau Angelus Premier Grand Cru Classe A, Saint-Emilion Grand Cru",Bordeaux,2013,06/07/2021,10060452013,1006045
875,22/07/2021,927,42,863,12,64,10/05/2021,"Chateau Calon Segur 3eme Cru Classe, Saint-Estephe",Bordeaux,2006,23/07/2021,10074752006,1007475
3900,22/07/2021,4683,79,3822,78,861,20/06/2021,"Chateau Margaux Premier Cru Classe, Margaux",Bordeaux,2006,23/07/2021,10127812006,1012781
3750,22/07/2021,4258,81,3525,225,733,18/06/2021,"Chateau Margaux Premier Cru Classe, Margaux",Bordeaux,2007,23/07/2021,10127812007,1012781
880,22/07/2021,980,7,725,155,255,13/04/2021,"Chateau Calon Segur 3eme Cru Classe, Saint-Estephe",Bordeaux,2007,23/07/2021,10074752007,1007475
2300,02/07/2021,2674,30,2000,300,674,17/02/2021,"Chateau Angelus Premier Grand Cru Classe A, Saint-Emilion Grand Cru",Bordeaux,2013,03/07/2021,10060452013,1006045
3900,22/07/2021,4355,72,3870,30,485,10/07/2021,"Chateau Margaux Premier Cru Classe, Margaux",Bordeaux,2008,23/07/2021,10127812008,1012781
895,22/07/2021,981,10,781,114,200,16/11/2020,"Chateau Calon Segur 3eme Cru Classe, Saint-Estephe",Bordeaux,2008,23/07/2021,10074752008,1007475
6930,22/07/2021,7706,54,7086,-156,620,11/06/2021,"Chateau Margaux Premier Cru Classe, Margaux",Bordeaux,2009,23/07/2021,10127812009,1012781
1000,22/07/2021,1222,53,1026,-26,196,24/06/2021,"Chateau Calon Segur 3eme Cru Classe, Saint-Estephe",Bordeaux,2009,23/07/2021,10074752009,1007475
476,13/07/2021,526,37,364,112,162,12/05/2021,"Chateau Batailley 5eme Cru Classe, Pauillac",Bordeaux,2016,14/07/2021,10063222016,1006322
2300,02/07/2021,2674,30,2000,300,674,17/02/2021,"Chateau Angelus Premier Grand Cru Classe A, Saint-Emilion Grand Cru",Bordeaux,2013,03/07/2021,10060452013,1006045
2300,01/07/2021,2690,30,2000,300,690,17/02/2021,"Chateau Angelus Premier Grand Cru Classe A, Saint-Emilion Grand Cru",Bordeaux,2013,02/07/2021,10060452013,1006045
6500,22/07/2021,7503,24,6400,100,1103,22/07/2021,"Chateau Margaux Premier Cru Classe, Margaux",Bordeaux,2005,23/07/2021,10127812005,1012781
990,22/07/2021,1165,84,1029,-39,136,21/07/2021,"Chateau Calon Segur 3eme Cru Classe, Saint-Estephe",Bordeaux,2005,23/07/2021,10074752005,1007475
685,14/07/2021,1033,3,470,215,563,29/03/2018,"Chateau Batailley 5eme Cru Classe, Pauillac",Bordeaux,2000,15/07/2021,10063222000,1006322
2300,01/07/2021,2690,30,2000,300,690,17/02/2021,"Chateau Angelus Premier Grand Cru Classe A, Saint-Emilion Grand Cru",Bordeaux,2013,02/07/2021,10060452013,1006045
875,22/07/2021,927,42,863,12,64,10/05/2021,"Chateau Calon Segur 3eme Cru Classe, Saint-Estephe",Bordeaux,2006,23/07/2021,10074752006,1007475
3900,22/07/2021,4683,79,3822,78,861,20/06/2021,"Chateau Margaux Premier Cru Classe, Margaux",Bordeaux,2006,23/07/2021,10127812006,1012781
3750,22/07/2021,4258,81,3525,225,733,18/06/2021,"Chateau Margaux Premier Cru Classe, Margaux",Bordeaux,2007,23/07/2021,10127812007,1012781
880,22/07/2021,980,7,725,155,255,13/04/2021,"Chateau Calon Segur 3eme Cru Classe, Saint-Estephe",Bordeaux,2007,23/07/2021,10074752007,1007475
2300,30/06/2021,2690,30,2000,300,690,17/02/2021,"Chateau Angelus Premier Grand Cru Classe A, Saint-Emilion Grand Cru",Bordeaux,2013,01/07/2021,10060452013,1006045
685,14/07/2021,1033,3,470,215,563,29/03/2018,"Chateau Batailley 5eme Cru Classe, Pauillac",Bordeaux,2000,15/07/2021,10063222000,1006322
8400,22/07/2021,8400,1,5700,2700,2700,10/09/2020,"Domaine Leflaive, Chevalier-Montrachet Grand Cru",Burgundy,2007,23/07/2021,10734012007,1073401
3900,22/07/2021,4355,72,3870,30,485,10/07/2021,"Chateau Margaux Premier Cru Classe, Margaux",Bordeaux,2008,23/07/2021,10127812008,1012781
895,22/07/2021,981,10,781,114,200,16/11/2020,"Chateau Calon Segur 3eme Cru Classe, Saint-Estephe",Bordeaux,2008,23/07/2021,10074752008,1007475
6930,22/07/2021,7706,54,7086,-156,620,11/06/2021,"Chateau Margaux Premier Cru Classe, Margaux",Bordeaux,2009,23/07/2021,10127812009,1012781
9000,22/07/2021,8799,1,5400,3600,3399,13/08/2020,"Domaine Leflaive, Chevalier-Montrachet Grand Cru",Burgundy,2008,23/07/2021,10734012008,1073401
1000,22/07/2021,1222,53,1026,-26,196,24/06/2021,"Chateau Calon Segur 3eme Cru Classe, Saint-Estephe",Bordeaux,2009,23/07/2021,10074752009,1007475
480,14/07/2021,592,2,465,15,127,04/05/2020,"Chateau Batailley 5eme Cru Classe, Pauillac",Bordeaux,2001,15/07/2021,10063222001,1006322
2300,30/06/2021,2690,30,2000,300,690,17/02/2021,"Chateau Angelus Premier Grand Cru Classe A, Saint-Emilion Grand Cru",Bordeaux,2013,01/07/2021,10060452013,1006045
2386,22/07/2021,2397,3,2190,196,207,01/05/2021,"Gaja, Barbaresco",Piedmont,2004,23/07/2021,10996052004,1099605
520,22/07/2021,563,3,460,60,103,05/05/2020,"Tua Rita, Giusto di Notri, Toscana",Tuscany,2008,23/07/2021,11058072008,1105807
660,22/07/2021,727,5,390,270,337,18/08/2017,"Tua Rita, Giusto di Notri, Toscana",Tuscany,2006,23/07/2021,11058072006,1105807
1700,21/07/2021,1657,4,1378,322,279,29/07/2020,"Tignanello, Toscana",Tuscany,2001,23/07/2021,10953912001,1095391
1408,20/07/2021,1310,4,1238,170,72,02/11/2020,"Tignanello, Toscana",Tuscany,2006,23/07/2021,10953912006,1095391
6400,22/07/2021,7568,55,6188,212,1380,16/07/2021,"Chateau Margaux Premier Cru Classe, Margaux",Bordeaux,2010,23/07/2021,10127812010,1012781
450,14/07/2021,521,3,300,150,221,15/12/2019,"Chateau Batailley 5eme Cru Classe, Pauillac",Bordeaux,2004,15/07/2021,10063222004,1006322
990,22/07/2021,1124,16,990,0,134,16/06/2021,"Chateau Calon Segur 3eme Cru Classe, Saint-Estephe",Bordeaux,2010,23/07/2021,10074752010,1007475
750,20/07/2021,892,29,790,-40,102,01/06/2020,"Chateau Calon Segur 3eme Cru Classe, Saint-Estephe",Bordeaux,2011,23/07/2021,10074752011,1007475
1260,22/07/2021,1591,3,1170,90,421,24/06/2021,"Tignanello, Toscana",Tuscany,2010,23/07/2021,10953912010,1095391
3800,22/07/2021,4355,71,3690,110,665,13/04/2021,"Chateau Margaux Premier Cru Classe, Margaux",Bordeaux,2011,23/07/2021,10127812011,1012781
2300,29/06/2021,2690,30,2000,300,690,17/02/2021,"Chateau Angelus Premier Grand Cru Classe A, Saint-Emilion Grand Cru",Bordeaux,2013,30/06/2021,10060452013,1006045
2300,29/06/2021,2690,30,2000,300,690,17/02/2021,"Chateau Angelus Premier Grand Cru Classe A, Saint-Emilion Grand Cru",Bordeaux,2013,30/06/2021,10060452013,1006045
820,22/07/2021,924,5,735,85,189,09/09/2020,"Chateau Calon Segur 3eme Cru Classe, Saint-Estephe",Bordeaux,2012,23/07/2021,10074752012,1007475
13200,22/07/2021,12867,1,12850,350,17,30/11/2020,"Jacques-Frederic Mugnier, Chambolle-Musigny Premier Cru, Les Amoureuses",Burgundy,2011,23/07/2021,10496422011,1049642
3700,22/07/2021,4104,26,3520,180,584,07/04/2021,"Chateau Margaux Premier Cru Classe, Margaux",Bordeaux,2013,23/07/2021,10127812013,1012781
2300,28/06/2021,2690,30,2000,300,690,17/02/2021,"Chateau Angelus Premier Grand Cru Classe A, Saint-Emilion Grand Cru",Bordeaux,2013,29/06/2021,10060452013,1006045
589,14/07/2021,622,49,520,69,102,17/06/2021,"Chateau Batailley 5eme Cru Classe, Pauillac",Bordeaux,2005,15/07/2021,10063222005,1006322
800,22/07/2021,792,19,682,118,110,15/09/2020,"Chateau Calon Segur 3eme Cru Classe, Saint-Estephe",Bordeaux,2013,23/07/2021,10074752013,1007475
3800,22/07/2021,4351,120,3480,320,871,17/06/2021,"Chateau Margaux Premier Cru Classe, Margaux",Bordeaux,2014,23/07/2021,10127812014,1012781
790,22/07/2021,877,18,801,-11,76,31/05/2021,"Chateau Calon Segur 3eme Cru Classe, Saint-Estephe",Bordeaux,2014,23/07/2021,10074752014,1007475
589,14/07/2021,622,49,520,69,102,17/06/2021,"Chateau Batailley 5eme Cru Classe, Pauillac",Bordeaux,2005,15/07/2021,10063222005,1006322
1550,22/07/2021,1550,1,1300,250,250,27/04/2021,"Gaja, Barbaresco",Piedmont,2012,23/07/2021,10996052012,1099605
1060,22/07/2021,1139,9,860,200,279,08/03/2021,"Tignanello, Toscana",Tuscany,2013,23/07/2021,10953912013,1095391
984,22/07/2021,1048,7,854,130,194,15/07/2021,"Tignanello, Toscana",Tuscany,2014,23/07/2021,10953912014,1095391
10800,20/07/2021,10405,1,8000,2800,2405,30/01/2020,"Domaine Leflaive, Chevalier-Montrachet Grand Cru",Burgundy,2014,23/07/2021,10734012014,1073401
1573,21/07/2021,1543,12,1300,273,243,10/07/2021,"Gaja, Barbaresco",Piedmont,2014,23/07/2021,10996052014,1099605
940,22/07/2021,1078,79,866,74,212,20/07/2021,"Chateau Calon Segur 3eme Cru Classe, Saint-Estephe",Bordeaux,2015,23/07/2021,10074752015,1007475
10620,22/07/2021,11692,42,9800,820,1892,11/06/2021,"Chateau Margaux Premier Cru Classe, Margaux",Bordeaux,2015,23/07/2021,10127812015,1012781
14520,22/07/2021,14520,1,12000,2520,2520,28/05/2020,"Jacques-Frederic Mugnier, Chambolle-Musigny Premier Cru, Les Amoureuses",Burgundy,2014,23/07/2021,10496422014,1049642
480,16/07/2021,536,15,388,92,148,29/09/2020,"Tua Rita, Giusto di Notri, Toscana",Tuscany,2015,23/07/2021,11058072015,1105807
16200,22/07/2021,16327,0,18750,-2550,-2423,29/08/2018,"Jacques-Frederic Mugnier, Chambolle-Musigny Premier Cru, Les Amoureuses",Burgundy,2015,23/07/2021,10496422015,1049642
2300,28/06/2021,2690,30,2000,300,690,17/02/2021,"Chateau Angelus Premier Grand Cru Classe A, Saint-Emilion Grand Cru",Bordeaux,2013,29/06/2021,10060452013,1006045
1100,22/07/2021,1219,77,1036,64,183,27/05/2021,"Chateau Calon Segur 3eme Cru Classe, Saint-Estephe",Bordeaux,2016,23/07/2021,10074752016,1007475
5500,22/07/2021,5882,130,5500,0,382,06/07/2021,"Chateau Margaux Premier Cru Classe, Margaux",Bordeaux,2016,23/07/2021,10127812016,1012781
510,14/07/2021,596,397,494,16,102,20/04/2021,"Chateau Batailley 5eme Cru Classe, Pauillac",Bordeaux,2010,15/07/2021,10063222010,1006322
1240,22/07/2021,1355,57,1220,20,135,14/07/2021,"Tignanello, Toscana",Tuscany,2016,23/07/2021,10953912016,1095391
1500,16/07/2021,1681,31,1510,-10,171,18/07/2021,"Gaja, Barbaresco",Piedmont,2016,23/07/2021,10996052016,1099605
2300,25/06/2021,2690,30,2000,300,690,17/02/2021,"Chateau Angelus Premier Grand Cru Classe A, Saint-Emilion Grand Cru",Bordeaux,2013,26/06/2021,10060452013,1006045
780,22/07/2021,938,73,740,40,198,21/05/2021,"Chateau Calon Segur 3eme Cru Classe, Saint-Estephe",Bordeaux,2017,23/07/2021,10074752017,1007475
510,14/07/2021,596,397,494,16,102,20/04/2021,"Chateau Batailley 5eme Cru Classe, Pauillac",Bordeaux,2010,15/07/2021,10063222010,1006322
3800,22/07/2021,4614,195,3950,-150,664,30/06/2021,"Chateau Margaux Premier Cru Classe, Margaux",Bordeaux,2017,23/07/2021,10127812017,1012781
460,22/07/2021,498,179,420,40,78,28/05/2021,"Tua Rita, Giusto di Notri, Toscana",Tuscany,2016,23/07/2021,11058072016,1105807
7527,12/07/2021,9748,3,7290,237,2458,21/08/2020,"Domaine Denis Mortet, Chambertin Grand Cru",Burgundy,2017,23/07/2021,10490202017,1049020
2300,25/06/2021,2690,30,2000,300,690,17/02/2021,"Chateau Angelus Premier Grand Cru Classe A, Saint-Emilion Grand Cru",Bordeaux,2013,26/06/2021,10060452013,1006045
5523,12/07/2021,5827,104,5254,269,573,26/05/2021,"Chateau Margaux Premier Cru Classe, Margaux",Bordeaux,2018,23/07/2021,10127812018,1012781
1080,22/07/2021,1242,41,1058,22,184,14/07/2021,"Chateau Calon Segur 3eme Cru Classe, Saint-Estephe",Bordeaux,2018,23/07/2021,10074752018,1007475
380,14/07/2021,422,5,320,60,102,09/07/2021,"Chateau Batailley 5eme Cru Classe, Pauillac",Bordeaux,2011,15/07/2021,10063222011,1006322
866,21/07/2021,1010,117,886,-20,124,21/07/2021,"Tignanello, Toscana",Tuscany,2017,23/07/2021,10953912017,1095391
8000,22/07/2021,8594,4,7330,670,1264,02/06/2021,"Domaine Leflaive, Chevalier-Montrachet Grand Cru",Burgundy,2018,23/07/2021,10734012018,1073401
990,21/07/2021,1157,94,910,80,247,14/07/2021,"Tignanello, Toscana",Tuscany,2018,23/07/2021,10953912018,1095391
1040,30/06/2021,1205,23,940,100,265,18/03/2021,"Chateau Calon Segur 3eme Cru Classe, Saint-Estephe",Bordeaux,2000,02/07/2021,10074752000,1007475
870,01/07/2021,955,4,705,165,250,01/02/2021,"Chateau Calon Segur 3eme Cru Classe, Saint-Estephe",Bordeaux,2002,02/07/2021,10074752002,1007475
900,30/06/2021,1053,23,800,100,253,21/11/2019,"Chateau Calon Segur 3eme Cru Classe, Saint-Estephe",Bordeaux,2003,02/07/2021,10074752003,1007475
870,01/07/2021,955,4,705,165,250,01/02/2021,"Chateau Calon Segur 3eme Cru Classe, Saint-Estephe",Bordeaux,2002,02/07/2021,10074752002,1007475
900,30/06/2021,1053,23,800,100,253,21/11/2019,"Chateau Calon Segur 3eme Cru Classe, Saint-Estephe",Bordeaux,2003,02/07/2021,10074752003,1007475
4450,01/07/2021,4706,22,4400,50,306,29/09/2020,"Chateau Margaux Premier Cru Classe, Margaux",Bordeaux,2001,02/07/2021,10127812001,1012781
3826,01/07/2021,4481,60,4116,-290,365,25/02/2021,"Chateau Margaux Premier Cru Classe, Margaux",Bordeaux,2004,02/07/2021,10127812004,1012781
2300,24/06/2021,2690,30,2000,300,690,17/02/2021,"Chateau Angelus Premier Grand Cru Classe A, Saint-Emilion Grand Cru",Bordeaux,2013,25/06/2021,10060452013,1006045
800,01/07/2021,921,19,745,55,176,16/11/2020,"Chateau Calon Segur 3eme Cru Classe, Saint-Estephe",Bordeaux,2004,02/07/2021,10074752004,1007475
4450,01/07/2021,4706,22,4400,50,306,29/09/2020,"Chateau Margaux Premier Cru Classe, Margaux",Bordeaux,2001,02/07/2021,10127812001,1012781
3826,01/07/2021,4481,60,4116,-290,365,25/02/2021,"Chateau Margaux Premier Cru Classe, Margaux",Bordeaux,2004,02/07/2021,10127812004,1012781
2300,24/06/2021,2690,30,2000,300,690,17/02/2021,"Chateau Angelus Premier Grand Cru Classe A, Saint-Emilion Grand Cru",Bordeaux,2013,25/06/2021,10060452013,1006045
800,01/07/2021,921,19,745,55,176,16/11/2020,"Chateau Calon Segur 3eme Cru Classe, Saint-Estephe",Bordeaux,2004,02/07/2021,10074752004,1007475
2300,23/06/2021,2690,30,2000,300,690,17/02/2021,"Chateau Angelus Premier Grand Cru Classe A, Saint-Emilion Grand Cru",Bordeaux,2013,24/06/2021,10060452013,1006045
2300,23/06/2021,2690,30,2000,300,690,17/02/2021,"Chateau Angelus Premier Grand Cru Classe A, Saint-Emilion Grand Cru",Bordeaux,2013,24/06/2021,10060452013,1006045
1000,30/06/2021,1161,90,988,12,173,28/05/2021,"Chateau Calon Segur 3eme Cru Classe, Saint-Estephe",Bordeaux,2005,02/07/2021,10074752005,1007475
900,01/07/2021,1017,53,863,37,154,10/05/2021,"Chateau Calon Segur 3eme Cru Classe, Saint-Estephe",Bordeaux,2006,02/07/2021,10074752006,1007475
3900,01/07/2021,4636,95,3822,78,814,20/06/2021,"Chateau Margaux Premier Cru Classe, Margaux",Bordeaux,2006,02/07/2021,10127812006,1012781
380,14/07/2021,422,5,320,60,102,09/07/2021,"Chateau Batailley 5eme Cru Classe, Pauillac",Bordeaux,2011,15/07/2021,10063222011,1006322
880,01/07/2021,967,9,725,155,242,13/04/2021,"Chateau Calon Segur 3eme Cru Classe, Saint-Estephe",Bordeaux,2007,02/07/2021,10074752007,1007475
2300,22/06/2021,2695,29,2000,300,695,17/02/2021,"Chateau Angelus Premier Grand Cru Classe A, Saint-Emilion Grand Cru",Bordeaux,2013,23/06/2021,10060452013,1006045
2300,22/06/2021,2695,29,2000,300,695,17/02/2021,"Chateau Angelus Premier Grand Cru Classe A, Saint-Emilion Grand Cru",Bordeaux,2013,23/06/2021,10060452013,1006045
3900,01/07/2021,4256,79,3750,150,506,28/06/2021,"Chateau Margaux Premier Cru Classe, Margaux",Bordeaux,2008,02/07/2021,10127812008,1012781
895,01/07/2021,980,10,781,114,199,16/11/2020,"Chateau Calon Segur 3eme Cru Classe, Saint-Estephe",Bordeaux,2008,02/07/2021,10074752008,1007475
6830,30/06/2021,7785,48,7086,-256,699,11/06/2021,"Chateau Margaux Premier Cru Classe, Margaux",Bordeaux,2009,02/07/2021,10127812009,1012781
2300,21/06/2021,2683,17,2000,300,683,17/02/2021,"Chateau Angelus Premier Grand Cru Classe A, Saint-Emilion Grand Cru",Bordeaux,2013,22/06/2021,10060452013,1006045
2300,21/06/2021,2683,17,2000,300,683,17/02/2021,"Chateau Angelus Premier Grand Cru Classe A, Saint-Emilion Grand Cru",Bordeaux,2013,22/06/2021,10060452013,1006045
1000,30/06/2021,1161,90,988,12,173,28/05/2021,"Chateau Calon Segur 3eme Cru Classe, Saint-Estephe",Bordeaux,2005,02/07/2021,10074752005,1007475
900,01/07/2021,1017,53,863,37,154,10/05/2021,"Chateau Calon Segur 3eme Cru Classe, Saint-Estephe",Bordeaux,2006,02/07/2021,10074752006,1007475
3900,01/07/2021,4636,95,3822,78,814,20/06/2021,"Chateau Margaux Premier Cru Classe, Margaux",Bordeaux,2006,02/07/2021,10127812006,1012781
400,14/07/2021,426,6,408,-8,18,14/07/2021,"Chateau Batailley 5eme Cru Classe, Pauillac",Bordeaux,2012,15/07/2021,10063222012,1006322
880,01/07/2021,967,9,725,155,242,13/04/2021,"Chateau Calon Segur 3eme Cru Classe, Saint-Estephe",Bordeaux,2007,02/07/2021,10074752007,1007475
2300,18/06/2021,2683,17,2000,300,683,17/02/2021,"Chateau Angelus Premier Grand Cru Classe A, Saint-Emilion Grand Cru",Bordeaux,2013,21/06/2021,10060452013,1006045
2300,18/06/2021,2673,18,2000,300,673,17/02/2021,"Chateau Angelus Premier Grand Cru Classe A, Saint-Emilion Grand Cru",Bordeaux,2013,19/06/2021,10060452013,1006045
3900,01/07/2021,4256,79,3750,150,506,28/06/2021,"Chateau Margaux Premier Cru Classe, Margaux",Bordeaux,2008,02/07/2021,10127812008,1012781
895,01/07/2021,980,10,781,114,199,16/11/2020,"Chateau Calon Segur 3eme Cru Classe, Saint-Estephe",Bordeaux,2008,02/07/2021,10074752008,1007475
6830,30/06/2021,7785,48,7086,-256,699,11/06/2021,"Chateau Margaux Premier Cru Classe, Margaux",Bordeaux,2009,02/07/2021,10127812009,1012781
1299,01/07/2021,1260,45,1026,273,234,24/06/2021,"Chateau Calon Segur 3eme Cru Classe, Saint-Estephe",Bordeaux,2009,02/07/2021,10074752009,1007475
400,14/07/2021,426,6,408,-8,18,14/07/2021,"Chateau Batailley 5eme Cru Classe, Pauillac",Bordeaux,2012,15/07/2021,10063222012,1006322
2300,18/06/2021,2683,17,2000,300,683,17/02/2021,"Chateau Angelus Premier Grand Cru Classe A, Saint-Emilion Grand Cru",Bordeaux,2013,21/06/2021,10060452013,1006045
3740,01/07/2021,4016,53,3520,220,496,07/04/2021,"Chateau Margaux Premier Cru Classe, Margaux",Bordeaux,2013,02/07/2021,10127812013,1012781
320,14/07/2021,321,110,304,16,17,10/01/2021,"Chateau Batailley 5eme Cru Classe, Pauillac",Bordeaux,2013,15/07/2021,10063222013,1006322
2300,18/06/2021,2673,18,2000,300,673,17/02/2021,"Chateau Angelus Premier Grand Cru Classe A, Saint-Emilion Grand Cru",Bordeaux,2013,19/06/2021,10060452013,1006045
686,01/07/2021,816,8,682,4,134,15/09/2020,"Chateau Calon Segur 3eme Cru Classe, Saint-Estephe",Bordeaux,2013,02/07/2021,10074752013,1007475
6282,18/06/2021,10168,1,4000,2282,6168,25/04/2016,"Domaine Denis Mortet, Chambertin Grand Cru",Burgundy,2013,02/07/2021,10490202013,1049020
960,30/06/2021,1274,13,850,110,424,28/01/2021,"Tignanello, Toscana",Tuscany,2012,02/07/2021,10953912012,1095391
3720,01/07/2021,4320,146,3480,240,840,17/06/2021,"Chateau Margaux Premier Cru Classe, Margaux",Bordeaux,2014,02/07/2021,10127812014,1012781
790,25/06/2021,902,23,801,-11,101,31/05/2021,"Chateau Calon Segur 3eme Cru Classe, Saint-Estephe",Bordeaux,2014,02/07/2021,10074752014,1007475
359,14/07/2021,368,89,360,-1,8,14/07/2021,"Chateau Batailley 5eme Cru Classe, Pauillac",Bordeaux,2014,15/07/2021,10063222014,1006322
1550,01/07/2021,1557,1,1300,250,257,27/04/2021,"Gaja, Barbaresco",Piedmont,2012,02/07/2021,10996052012,1099605
1090,30/06/2021,1163,6,860,230,303,08/03/2021,"Tignanello, Toscana",Tuscany,2013,02/07/2021,10953912013,1095391
984,01/07/2021,1104,42,830,154,274,22/06/2021,"Tignanello, Toscana",Tuscany,2014,02/07/2021,10953912014,1095391
1400,01/07/2021,1536,14,1300,100,236,30/06/2021,"Gaja, Barbaresco",Piedmont,2013,02/07/2021,10996052013,1099605
850,01/07/2021,1075,87,822,28,253,28/06/2021,"Chateau Calon Segur 3eme Cru Classe, Saint-Estephe",Bordeaux,2015,02/07/2021,10074752015,1007475
10400,01/07/2021,11895,52,9800,600,2095,11/06/2021,"Chateau Margaux Premier Cru Classe, Margaux",Bordeaux,2015,02/07/2021,10127812015,1012781
1130,30/06/2021,1240,10,1202,-72,38,10/05/2021,"Tignanello, Toscana",Tuscany,2015,02/07/2021,10953912015,1095391
16200,01/07/2021,16040,0,18750,-2550,-2710,29/08/2018,"Jacques-Frederic Mugnier, Chambolle-Musigny Premier Cru, Les Amoureuses",Burgundy,2015,02/07/2021,10496422015,1049642
5578,01/07/2021,5794,119,5238,340,556,17/05/2021,"Chateau Margaux Premier Cru Classe, Margaux",Bordeaux,2016,02/07/2021,10127812016,1012781
2300,17/06/2021,2684,18,2000,300,684,17/02/2021,"Chateau Angelus Premier Grand Cru Classe A, Saint-Emilion Grand Cru",Bordeaux,2013,18/06/2021,10060452013,1006045
1100,01/07/2021,1219,70,1036,64,183,27/05/2021,"Chateau Calon Segur 3eme Cru Classe, Saint-Estephe",Bordeaux,2016,02/07/2021,10074752016,1007475
476,14/07/2021,526,37,364,112,162,12/05/2021,"Chateau Batailley 5eme Cru Classe, Pauillac",Bordeaux,2016,15/07/2021,10063222016,1006322
2300,17/06/2021,2684,18,2000,300,684,17/02/2021,"Chateau Angelus Premier Grand Cru Classe A, Saint-Emilion Grand Cru",Bordeaux,2013,18/06/2021,10060452013,1006045
780,01/07/2021,928,102,740,40,188,21/05/2021,"Chateau Calon Segur 3eme Cru Classe, Saint-Estephe",Bordeaux,2017,02/07/2021,10074752017,1007475
3790,30/06/2021,4253,104,3950,-160,303,30/06/2021,"Chateau Margaux Premier Cru Classe, Margaux",Bordeaux,2017,02/07/2021,10127812017,1012781
460,01/07/2021,487,158,420,40,67,28/05/2021,"Tua Rita, Giusto di Notri, Toscana",Tuscany,2016,02/07/2021,11058072016,1105807
8000,01/07/2021,8692,5,6974,1026,1718,14/03/2021,"Domaine Leflaive, Chevalier-Montrachet Grand Cru",Burgundy,2017,02/07/2021,10734012017,1073401
2300,16/06/2021,2684,18,2000,300,684,17/02/2021,"Chateau Angelus Premier Grand Cru Classe A, Saint-Emilion Grand Cru",Bordeaux,2013,17/06/2021,10060452013,1006045
5600,30/06/2021,5854,100,5254,346,600,26/05/2021,"Chateau Margaux Premier Cru Classe, Margaux",Bordeaux,2018,02/07/2021,10127812018,1012781
1080,01/07/2021,1214,49,950,130,264,03/05/2021,"Chateau Calon Segur 3eme Cru Classe, Saint-Estephe",Bordeaux,2018,02/07/2021,10074752018,1007475
857,30/06/2021,953,133,844,13,109,25/06/2021,"Tignanello, Toscana",Tuscany,2017,02/07/2021,10953912017,1095391
8000,01/07/2021,8255,5,7330,670,925,02/06/2021,"Domaine Leflaive, Chevalier-Montrachet Grand Cru",Burgundy,2018,02/07/2021,10734012018,1073401
480,15/07/2021,592,2,465,15,127,04/05/2020,"Chateau Batailley 5eme Cru Classe, Pauillac",Bordeaux,2001,16/07/2021,10063222001,1006322
5260,01/07/2021,5088,7,4160,1100,928,19/03/2021,"Chateau Margaux Premier Cru Classe, Margaux",Bordeaux,2019,02/07/2021,10127812019,1012781
1516,29/06/2021,1585,124,1398,118,187,01/07/2021,"Gaja, Barbaresco",Piedmont,2017,02/07/2021,10996052017,1099605
2300,16/06/2021,2684,18,2000,300,684,17/02/2021,"Chateau Angelus Premier Grand Cru Classe A, Saint-Emilion Grand Cru",Bordeaux,2013,17/06/2021,10060452013,1006045
550,15/07/2021,570,4,420,130,150,09/07/2019,"Chateau Batailley 5eme Cru Classe, Pauillac",Bordeaux,2003,24/07/2021,10063222003,1006322
5290,22/07/2021,4957,10,4160,1130,797,19/03/2021,"Chateau Margaux Premier Cru Classe, Margaux",Bordeaux,2019,23/07/2021,10127812019,1012781
1480,15/07/2021,1604,72,1398,82,206,01/07/2021,"Gaja, Barbaresco",Piedmont,2017,23/07/2021,10996052017,1099605
1624,22/07/2021,1713,22,1580,44,133,21/07/2021,"Gaja, Barbaresco",Piedmont,2018,23/07/2021,10996052018,1099605
2082,02/06/2021,2684,18,2000,82,684,17/02/2021,"Chateau Angelus Premier Grand Cru Classe A, Saint-Emilion Grand Cru",Bordeaux,2013,15/06/2021,10060452013,1006045
870,23/07/2021,966,5,705,165,261,01/02/2021,"Chateau Calon Segur 3eme Cru Classe, Saint-Estephe",Bordeaux,2002,24/07/2021,10074752002,1007475
8200,23/07/2021,9028,16,8100,100,928,21/06/2021,"Chateau Margaux Premier Cru Classe, Margaux",Bordeaux,2000,24/07/2021,10127812000,1012781
2082,02/06/2021,2671,18,2000,82,671,17/02/2021,"Chateau Angelus Premier Grand Cru Classe A, Saint-Emilion Grand Cru",Bordeaux,2013,11/06/2021,10060452013,1006045
900,23/07/2021,1118,23,800,100,318,21/11/2019,"Chateau Calon Segur 3eme Cru Classe, Saint-Estephe",Bordeaux,2003,24/07/2021,10074752003,1007475
4450,23/07/2021,4750,24,4400,50,350,29/09/2020,"Chateau Margaux Premier Cru Classe, Margaux",Bordeaux,2001,24/07/2021,10127812001,1012781
3900,23/07/2021,4417,22,3684,216,733,10/06/2020,"Chateau Margaux Premier Cru Classe, Margaux",Bordeaux,2002,24/07/2021,10127812002,1012781
3840,23/07/2021,4601,46,4116,-276,485,25/02/2021,"Chateau Margaux Premier Cru Classe, Margaux",Bordeaux,2004,24/07/2021,10127812004,1012781
5040,23/07/2021,6002,22,4650,390,1352,21/06/2021,"Chateau Margaux Premier Cru Classe, Margaux",Bordeaux,2003,24/07/2021,10127812003,1012781
2082,02/06/2021,2723,25,2000,82,723,17/02/2021,"Chateau Angelus Premier Grand Cru Classe A, Saint-Emilion Grand Cru",Bordeaux,2013,05/06/2021,10060452013,1006045
840,23/07/2021,1059,19,745,95,314,16/11/2020,"Chateau Calon Segur 3eme Cru Classe, Saint-Estephe",Bordeaux,2004,24/07/2021,10074752004,1007475
907,23/07/2021,952,22,805,102,147,20/11/2019,"Chateau Calon Segur 3eme Cru Classe, Saint-Estephe",Bordeaux,2001,24/07/2021,10074752001,1007475
550,15/07/2021,552,5,420,130,132,09/07/2019,"Chateau Batailley 5eme Cru Classe, Pauillac",Bordeaux,2003,19/07/2021,10063222003,1006322
2082,02/06/2021,2684,18,2000,82,684,17/02/2021,"Chateau Angelus Premier Grand Cru Classe A, Saint-Emilion Grand Cru",Bordeaux,2013,15/06/2021,10060452013,1006045
550,15/07/2021,547,6,420,130,127,09/07/2019,"Chateau Batailley 5eme Cru Classe, Pauillac",Bordeaux,2003,16/07/2021,10063222003,1006322
6500,23/07/2021,7503,24,6400,100,1103,22/07/2021,"Chateau Margaux Premier Cru Classe, Margaux",Bordeaux,2005,24/07/2021,10127812005,1012781
2082,02/06/2021,2714,26,2000,82,714,17/02/2021,"Chateau Angelus Premier Grand Cru Classe A, Saint-Emilion Grand Cru",Bordeaux,2013,03/06/2021,10060452013,1006045
990,22/07/2021,1157,66,1029,-39,128,21/07/2021,"Chateau Calon Segur 3eme Cru Classe, Saint-Estephe",Bordeaux,2005,24/07/2021,10074752005,1007475
1299,01/07/2021,1260,45,1026,273,234,24/06/2021,"Chateau Calon Segur 3eme Cru Classe, Saint-Estephe",Bordeaux,2009,02/07/2021,10074752009,1007475
450,15/07/2021,521,3,300,150,221,15/12/2019,"Chateau Batailley 5eme Cru Classe, Pauillac",Bordeaux,2004,16/07/2021,10063222004,1006322
2082,02/06/2021,2714,26,2000,82,714,17/02/2021,"Chateau Angelus Premier Grand Cru Classe A, Saint-Emilion Grand Cru",Bordeaux,2013,03/06/2021,10060452013,1006045
2500,01/07/2021,2636,2,2220,280,416,14/06/2021,"Gaja, Barbaresco",Piedmont,2001,02/07/2021,10996052001,1099605
2098,30/06/2021,2366,3,2190,-92,176,01/05/2021,"Gaja, Barbaresco",Piedmont,2004,02/07/2021,10996052004,1099605
1299,29/06/2021,1626,6,1010,289,616,18/12/2020,"Tignanello, Toscana",Tuscany,2008,02/07/2021,10953912008,1095391
6400,01/07/2021,7576,51,5950,450,1626,23/06/2021,"Chateau Margaux Premier Cru Classe, Margaux",Bordeaux,2010,02/07/2021,10127812010,1012781
990,01/07/2021,1134,16,990,0,144,16/06/2021,"Chateau Calon Segur 3eme Cru Classe, Saint-Estephe",Bordeaux,2010,02/07/2021,10074752010,1007475
589,15/07/2021,622,49,520,69,102,17/06/2021,"Chateau Batailley 5eme Cru Classe, Pauillac",Bordeaux,2005,16/07/2021,10063222005,1006322
2082,02/06/2021,2723,25,2000,82,723,17/02/2021,"Chateau Angelus Premier Grand Cru Classe A, Saint-Emilion Grand Cru",Bordeaux,2013,05/06/2021,10060452013,1006045
750,30/06/2021,988,36,790,-40,198,01/06/2020,"Chateau Calon Segur 3eme Cru Classe, Saint-Estephe",Bordeaux,2011,02/07/2021,10074752011,1007475
1326,30/06/2021,1560,4,1170,156,390,24/06/2021,"Tignanello, Toscana",Tuscany,2010,02/07/2021,10953912010,1095391
3758,01/07/2021,4002,59,3690,68,312,13/04/2021,"Chateau Margaux Premier Cru Classe, Margaux",Bordeaux,2011,02/07/2021,10127812011,1012781
2082,02/06/2021,2671,18,2000,82,671,17/02/2021,"Chateau Angelus Premier Grand Cru Classe A, Saint-Emilion Grand Cru",Bordeaux,2013,11/06/2021,10060452013,1006045
589,15/07/2021,622,49,520,69,102,17/06/2021,"Chateau Batailley 5eme Cru Classe, Pauillac",Bordeaux,2005,16/07/2021,10063222005,1006322
960,30/06/2021,1037,10,880,80,157,22/06/2021,"Tignanello, Toscana",Tuscany,2011,02/07/2021,10953912011,1095391
2300,01/06/2021,2714,26,2000,300,714,17/02/2021,"Chateau Angelus Premier Grand Cru Classe A, Saint-Emilion Grand Cru",Bordeaux,2013,02/06/2021,10060452013,1006045
510,15/07/2021,596,397,494,16,102,20/04/2021,"Chateau Batailley 5eme Cru Classe, Pauillac",Bordeaux,2010,16/07/2021,10063222010,1006322
820,01/07/2021,937,6,735,85,202,09/09/2020,"Chateau Calon Segur 3eme Cru Classe, Saint-Estephe",Bordeaux,2012,02/07/2021,10074752012,1007475
3750,24/06/2021,4175,42,3560,190,615,20/11/2020,"Chateau Margaux Premier Cru Classe, Margaux",Bordeaux,2012,02/07/2021,10127812012,1012781
3740,01/07/2021,4016,53,3520,220,496,07/04/2021,"Chateau Margaux Premier Cru Classe, Margaux",Bordeaux,2013,02/07/2021,10127812013,1012781
2300,01/06/2021,2714,26,2000,300,714,17/02/2021,"Chateau Angelus Premier Grand Cru Classe A, Saint-Emilion Grand Cru",Bordeaux,2013,02/06/2021,10060452013,1006045
686,01/07/2021,816,8,682,4,134,15/09/2020,"Chateau Calon Segur 3eme Cru Classe, Saint-Estephe",Bordeaux,2013,02/07/2021,10074752013,1007475
960,30/06/2021,1274,13,850,110,424,28/01/2021,"Tignanello, Toscana",Tuscany,2012,02/07/2021,10953912012,1095391
3720,01/07/2021,4320,146,3480,240,840,17/06/2021,"Chateau Margaux Premier Cru Classe, Margaux",Bordeaux,2014,02/07/2021,10127812014,1012781
790,25/06/2021,902,23,801,-11,101,31/05/2021,"Chateau Calon Segur 3eme Cru Classe, Saint-Estephe",Bordeaux,2014,02/07/2021,10074752014,1007475
1090,30/06/2021,1163,6,860,230,303,08/03/2021,"Tignanello, Toscana",Tuscany,2013,02/07/2021,10953912013,1095391
984,01/07/2021,1104,42,830,154,274,22/06/2021,"Tignanello, Toscana",Tuscany,2014,02/07/2021,10953912014,1095391
850,01/07/2021,1075,87,822,28,253,28/06/2021,"Chateau Calon Segur 3eme Cru Classe, Saint-Estephe",Bordeaux,2015,02/07/2021,10074752015,1007475
10400,01/07/2021,11895,52,9800,600,2095,11/06/2021,"Chateau Margaux Premier Cru Classe, Margaux",Bordeaux,2015,02/07/2021,10127812015,1012781
1040,30/06/2021,1204,24,940,100,264,18/03/2021,"Chateau Calon Segur 3eme Cru Classe, Saint-Estephe",Bordeaux,2000,03/07/2021,10074752000,1007475
870,02/07/2021,966,5,705,165,261,01/02/2021,"Chateau Calon Segur 3eme Cru Classe, Saint-Estephe",Bordeaux,2002,03/07/2021,10074752002,1007475
8100,02/07/2021,9023,15,8100,0,923,21/06/2021,"Chateau Margaux Premier Cru Classe, Margaux",Bordeaux,2000,03/07/2021,10127812000,1012781
3900,23/07/2021,4693,76,3822,78,871,20/06/2021,"Chateau Margaux Premier Cru Classe, Margaux",Bordeaux,2006,24/07/2021,10127812006,1012781
510,15/07/2021,596,397,494,16,102,20/04/2021,"Chateau Batailley 5eme Cru Classe, Pauillac",Bordeaux,2010,16/07/2021,10063222010,1006322
3750,23/07/2021,4240,77,3525,225,715,18/06/2021,"Chateau Margaux Premier Cru Classe, Margaux",Bordeaux,2007,24/07/2021,10127812007,1012781
880,23/07/2021,980,7,725,155,255,13/04/2021,"Chateau Calon Segur 3eme Cru Classe, Saint-Estephe",Bordeaux,2007,24/07/2021,10074752007,1007475
2300,31/05/2021,2696,25,2000,300,696,17/02/2021,"Chateau Angelus Premier Grand Cru Classe A, Saint-Emilion Grand Cru",Bordeaux,2013,01/06/2021,10060452013,1006045
2386,22/07/2021,2397,3,2190,196,207,01/05/2021,"Gaja, Barbaresco",Piedmont,2004,23/07/2021,10996052004,1099605
1700,21/07/2021,1657,4,1378,322,279,29/07/2020,"Tignanello, Toscana",Tuscany,2001,23/07/2021,10953912001,1095391
1408,20/07/2021,1310,4,1238,170,72,02/11/2020,"Tignanello, Toscana",Tuscany,2006,23/07/2021,10953912006,1095391
6400,22/07/2021,7568,55,6188,212,1380,16/07/2021,"Chateau Margaux Premier Cru Classe, Margaux",Bordeaux,2010,23/07/2021,10127812010,1012781
320,15/07/2021,321,110,304,16,17,10/01/2021,"Chateau Batailley 5eme Cru Classe, Pauillac",Bordeaux,2013,16/07/2021,10063222013,1006322
990,22/07/2021,1124,16,990,0,134,16/06/2021,"Chateau Calon Segur 3eme Cru Classe, Saint-Estephe",Bordeaux,2010,23/07/2021,10074752010,1007475
2300,31/05/2021,2696,25,2000,300,696,17/02/2021,"Chateau Angelus Premier Grand Cru Classe A, Saint-Emilion Grand Cru",Bordeaux,2013,01/06/2021,10060452013,1006045
3900,23/07/2021,4348,71,3780,120,568,23/07/2021,"Chateau Margaux Premier Cru Classe, Margaux",Bordeaux,2008,24/07/2021,10127812008,1012781
895,23/07/2021,981,10,781,114,200,16/11/2020,"Chateau Calon Segur 3eme Cru Classe, Saint-Estephe",Bordeaux,2008,24/07/2021,10074752008,1007475
6930,23/07/2021,7671,50,7086,-156,585,11/06/2021,"Chateau Margaux Premier Cru Classe, Margaux",Bordeaux,2009,24/07/2021,10127812009,1012781
996,23/07/2021,1218,54,1026,-30,192,24/06/2021,"Chateau Calon Segur 3eme Cru Classe, Saint-Estephe",Bordeaux,2009,24/07/2021,10074752009,1007475
359,15/07/2021,369,85,360,-1,9,14/07/2021,"Chateau Batailley 5eme Cru Classe, Pauillac",Bordeaux,2014,16/07/2021,10063222014,1006322
2386,23/07/2021,2397,3,2190,196,207,01/05/2021,"Gaja, Barbaresco",Piedmont,2004,24/07/2021,10996052004,1099605
1700,23/07/2021,1657,4,1378,322,279,29/07/2020,"Tignanello, Toscana",Tuscany,2001,24/07/2021,10953912001,1095391
1680,23/07/2021,1705,4,1420,260,285,29/06/2021,"Tignanello, Toscana",Tuscany,2004,24/07/2021,10953912004,1095391
6300,23/07/2021,7547,55,6188,112,1359,16/07/2021,"Chateau Margaux Premier Cru Classe, Margaux",Bordeaux,2010,24/07/2021,10127812010,1012781
476,15/07/2021,526,37,364,112,162,12/05/2021,"Chateau Batailley 5eme Cru Classe, Pauillac",Bordeaux,2016,16/07/2021,10063222016,1006322
750,20/07/2021,892,29,790,-40,102,01/06/2020,"Chateau Calon Segur 3eme Cru Classe, Saint-Estephe",Bordeaux,2011,23/07/2021,10074752011,1007475
1260,22/07/2021,1591,3,1170,90,421,24/06/2021,"Tignanello, Toscana",Tuscany,2010,23/07/2021,10953912010,1095391
3800,22/07/2021,4355,71,3690,110,665,13/04/2021,"Chateau Margaux Premier Cru Classe, Margaux",Bordeaux,2011,23/07/2021,10127812011,1012781
2300,28/05/2021,2693,26,2000,300,693,17/02/2021,"Chateau Angelus Premier Grand Cru Classe A, Saint-Emilion Grand Cru",Bordeaux,2013,29/05/2021,10060452013,1006045
990,23/07/2021,1117,17,990,0,127,16/06/2021,"Chateau Calon Segur 3eme Cru Classe, Saint-Estephe",Bordeaux,2010,24/07/2021,10074752010,1007475
2300,28/05/2021,2693,26,2000,300,693,17/02/2021,"Chateau Angelus Premier Grand Cru Classe A, Saint-Emilion Grand Cru",Bordeaux,2013,29/05/2021,10060452013,1006045
750,23/07/2021,892,29,790,-40,102,01/06/2020,"Chateau Calon Segur 3eme Cru Classe, Saint-Estephe",Bordeaux,2011,24/07/2021,10074752011,1007475
1180,23/07/2021,1378,3,1140,40,238,21/07/2021,"Tignanello, Toscana",Tuscany,2009,24/07/2021,10953912009,1095391
1260,23/07/2021,1591,3,1170,90,421,24/06/2021,"Tignanello, Toscana",Tuscany,2010,24/07/2021,10953912010,1095391
3758,23/07/2021,4359,70,3690,68,669,13/04/2021,"Chateau Margaux Premier Cru Classe, Margaux",Bordeaux,2011,24/07/2021,10127812011,1012781
2300,27/05/2021,2686,26,2000,300,686,17/02/2021,"Chateau Angelus Premier Grand Cru Classe A, Saint-Emilion Grand Cru",Bordeaux,2013,28/05/2021,10060452013,1006045
2300,27/05/2021,2686,26,2000,300,686,17/02/2021,"Chateau Angelus Premier Grand Cru Classe A, Saint-Emilion Grand Cru",Bordeaux,2013,28/05/2021,10060452013,1006045
820,22/07/2021,924,5,735,85,189,09/09/2020,"Chateau Calon Segur 3eme Cru Classe, Saint-Estephe",Bordeaux,2012,23/07/2021,10074752012,1007475
1040,30/06/2021,1204,24,940,100,264,18/03/2021,"Chateau Calon Segur 3eme Cru Classe, Saint-Estephe",Bordeaux,2000,03/07/2021,10074752000,1007475
870,02/07/2021,966,5,705,165,261,01/02/2021,"Chateau Calon Segur 3eme Cru Classe, Saint-Estephe",Bordeaux,2002,03/07/2021,10074752002,1007475
8100,02/07/2021,9023,15,8100,0,923,21/06/2021,"Chateau Margaux Premier Cru Classe, Margaux",Bordeaux,2000,03/07/2021,10127812000,1012781
900,02/07/2021,1138,24,800,100,338,21/11/2019,"Chateau Calon Segur 3eme Cru Classe, Saint-Estephe",Bordeaux,2003,03/07/2021,10074752003,1007475
4438,02/07/2021,4709,22,4400,38,309,29/09/2020,"Chateau Margaux Premier Cru Classe, Margaux",Bordeaux,2001,03/07/2021,10127812001,1012781
3900,02/07/2021,4469,26,3684,216,785,10/06/2020,"Chateau Margaux Premier Cru Classe, Margaux",Bordeaux,2002,03/07/2021,10127812002,1012781
3826,02/07/2021,4500,55,4116,-290,384,25/02/2021,"Chateau Margaux Premier Cru Classe, Margaux",Bordeaux,2004,03/07/2021,10127812004,1012781
4850,02/07/2021,6060,25,4650,200,1410,21/06/2021,"Chateau Margaux Premier Cru Classe, Margaux",Bordeaux,2003,03/07/2021,10127812003,1012781
2300,26/05/2021,2693,26,2000,300,693,17/02/2021,"Chateau Angelus Premier Grand Cru Classe A, Saint-Emilion Grand Cru",Bordeaux,2013,27/05/2021,10060452013,1006045
2300,26/05/2021,2693,26,2000,300,693,17/02/2021,"Chateau Angelus Premier Grand Cru Classe A, Saint-Emilion Grand Cru",Bordeaux,2013,27/05/2021,10060452013,1006045
800,02/07/2021,921,19,745,55,176,16/11/2020,"Chateau Calon Segur 3eme Cru Classe, Saint-Estephe",Bordeaux,2004,03/07/2021,10074752004,1007475
907,02/07/2021,953,23,805,102,148,20/11/2019,"Chateau Calon Segur 3eme Cru Classe, Saint-Estephe",Bordeaux,2001,03/07/2021,10074752001,1007475
6400,02/07/2021,7186,28,6776,-376,410,10/06/2021,"Chateau Margaux Premier Cru Classe, Margaux",Bordeaux,2005,03/07/2021,10127812005,1012781
2300,25/05/2021,2693,26,2000,300,693,17/02/2021,"Chateau Angelus Premier Grand Cru Classe A, Saint-Emilion Grand Cru",Bordeaux,2013,26/05/2021,10060452013,1006045
1000,02/07/2021,1160,89,988,12,172,28/05/2021,"Chateau Calon Segur 3eme Cru Classe, Saint-Estephe",Bordeaux,2005,03/07/2021,10074752005,1007475
900,02/07/2021,1138,24,800,100,338,21/11/2019,"Chateau Calon Segur 3eme Cru Classe, Saint-Estephe",Bordeaux,2003,03/07/2021,10074752003,1007475
3900,02/07/2021,4469,26,3684,216,785,10/06/2020,"Chateau Margaux Premier Cru Classe, Margaux",Bordeaux,2002,03/07/2021,10127812002,1012781
3826,02/07/2021,4500,55,4116,-290,384,25/02/2021,"Chateau Margaux Premier Cru Classe, Margaux",Bordeaux,2004,03/07/2021,10127812004,1012781
4438,02/07/2021,4709,22,4400,38,309,29/09/2020,"Chateau Margaux Premier Cru Classe, Margaux",Bordeaux,2001,03/07/2021,10127812001,1012781
4850,02/07/2021,6060,25,4650,200,1410,21/06/2021,"Chateau Margaux Premier Cru Classe, Margaux",Bordeaux,2003,03/07/2021,10127812003,1012781
2300,25/05/2021,2693,26,2000,300,693,17/02/2021,"Chateau Angelus Premier Grand Cru Classe A, Saint-Emilion Grand Cru",Bordeaux,2013,26/05/2021,10060452013,1006045
2300,24/05/2021,2576,61,2000,300,576,17/02/2021,"Chateau Angelus Premier Grand Cru Classe A, Saint-Emilion Grand Cru",Bordeaux,2013,25/05/2021,10060452013,1006045
800,02/07/2021,921,19,745,55,176,16/11/2020,"Chateau Calon Segur 3eme Cru Classe, Saint-Estephe",Bordeaux,2004,03/07/2021,10074752004,1007475
907,02/07/2021,953,23,805,102,148,20/11/2019,"Chateau Calon Segur 3eme Cru Classe, Saint-Estephe",Bordeaux,2001,03/07/2021,10074752001,1007475
685,16/07/2021,1033,3,470,215,563,29/03/2018,"Chateau Batailley 5eme Cru Classe, Pauillac",Bordeaux,2000,17/07/2021,10063222000,1006322
685,16/07/2021,1033,3,470,215,563,29/03/2018,"Chateau Batailley 5eme Cru Classe, Pauillac",Bordeaux,2000,17/07/2021,10063222000,1006322
6400,02/07/2021,7186,28,6776,-376,410,10/06/2021,"Chateau Margaux Premier Cru Classe, Margaux",Bordeaux,2005,03/07/2021,10127812005,1012781
2300,24/05/2021,2576,61,2000,300,576,17/02/2021,"Chateau Angelus Premier Grand Cru Classe A, Saint-Emilion Grand Cru",Bordeaux,2013,25/05/2021,10060452013,1006045
1000,02/07/2021,1160,89,988,12,172,28/05/2021,"Chateau Calon Segur 3eme Cru Classe, Saint-Estephe",Bordeaux,2005,03/07/2021,10074752005,1007475
480,16/07/2021,592,2,465,15,127,04/05/2020,"Chateau Batailley 5eme Cru Classe, Pauillac",Bordeaux,2001,17/07/2021,10063222001,1006322
2300,21/05/2021,2576,61,2000,300,576,17/02/2021,"Chateau Angelus Premier Grand Cru Classe A, Saint-Emilion Grand Cru",Bordeaux,2013,22/05/2021,10060452013,1006045
900,02/07/2021,936,44,863,37,73,10/05/2021,"Chateau Calon Segur 3eme Cru Classe, Saint-Estephe",Bordeaux,2006,03/07/2021,10074752006,1007475
3900,02/07/2021,4634,94,3822,78,812,20/06/2021,"Chateau Margaux Premier Cru Classe, Margaux",Bordeaux,2006,03/07/2021,10127812006,1012781
480,16/07/2021,480,1,465,15,15,04/05/2020,"Chateau Batailley 5eme Cru Classe, Pauillac",Bordeaux,2001,01/08/2021,10063222001,1006322
6557,02/07/2021,6557,0,3920,2637,2637,26/04/2017,"Domaine Leflaive, Chevalier-Montrachet Grand Cru",Burgundy,2006,03/07/2021,10734012006,1073401
3560,02/07/2021,4183,39,3525,35,658,18/06/2021,"Chateau Margaux Premier Cru Classe, Margaux",Bordeaux,2007,03/07/2021,10127812007,1012781
880,02/07/2021,967,9,725,155,242,13/04/2021,"Chateau Calon Segur 3eme Cru Classe, Saint-Estephe",Bordeaux,2007,03/07/2021,10074752007,1007475
2300,21/05/2021,2576,61,2000,300,576,17/02/2021,"Chateau Angelus Premier Grand Cru Classe A, Saint-Emilion Grand Cru",Bordeaux,2013,22/05/2021,10060452013,1006045
2300,20/05/2021,2576,61,2000,300,576,17/02/2021,"Chateau Angelus Premier Grand Cru Classe A, Saint-Emilion Grand Cru",Bordeaux,2013,21/05/2021,10060452013,1006045
3900,02/07/2021,4295,86,3750,150,545,28/06/2021,"Chateau Margaux Premier Cru Classe, Margaux",Bordeaux,2008,03/07/2021,10127812008,1012781
895,02/07/2021,980,10,781,114,199,16/11/2020,"Chateau Calon Segur 3eme Cru Classe, Saint-Estephe",Bordeaux,2008,03/07/2021,10074752008,1007475
6830,02/07/2021,7777,48,7086,-256,691,11/06/2021,"Chateau Margaux Premier Cru Classe, Margaux",Bordeaux,2009,03/07/2021,10127812009,1012781
420,16/07/2021,470,4,220,200,250,17/06/2015,"Chateau Batailley 5eme Cru Classe, Pauillac",Bordeaux,2002,17/07/2021,10063222002,1006322
1000,02/07/2021,1259,45,1026,-26,233,24/06/2021,"Chateau Calon Segur 3eme Cru Classe, Saint-Estephe",Bordeaux,2009,03/07/2021,10074752009,1007475
2300,20/05/2021,2576,61,2000,300,576,17/02/2021,"Chateau Angelus Premier Grand Cru Classe A, Saint-Emilion Grand Cru",Bordeaux,2013,21/05/2021,10060452013,1006045
13200,02/07/2021,12867,1,12850,350,17,30/11/2020,"Jacques-Frederic Mugnier, Chambolle-Musigny Premier Cru, Les Amoureuses",Burgundy,2011,03/07/2021,10496422011,1049642
3740,02/07/2021,3999,50,3520,220,479,07/04/2021,"Chateau Margaux Premier Cru Classe, Margaux",Bordeaux,2013,03/07/2021,10127812013,1012781
2300,19/05/2021,2578,60,2000,300,578,17/02/2021,"Chateau Angelus Premier Grand Cru Classe A, Saint-Emilion Grand Cru",Bordeaux,2013,20/05/2021,10060452013,1006045
450,16/07/2021,532,2,300,150,232,15/12/2019,"Chateau Batailley 5eme Cru Classe, Pauillac",Bordeaux,2004,19/07/2021,10063222004,1006322
686,02/07/2021,809,7,682,4,127,15/09/2020,"Chateau Calon Segur 3eme Cru Classe, Saint-Estephe",Bordeaux,2013,03/07/2021,10074752013,1007475
1380,02/07/2021,1442,7,1352,28,90,23/09/2020,"Gaja, Barbaresco",Piedmont,2011,03/07/2021,10996052011,1099605
600,02/07/2021,600,14,408,192,192,09/04/2019,"Tua Rita, Giusto di Notri, Toscana",Tuscany,2012,03/07/2021,11058072012,1105807
960,02/07/2021,1256,12,850,110,406,28/01/2021,"Tignanello, Toscana",Tuscany,2012,03/07/2021,10953912012,1095391
2300,19/05/2021,2578,60,2000,300,578,17/02/2021,"Chateau Angelus Premier Grand Cru Classe A, Saint-Emilion Grand Cru",Bordeaux,2013,20/05/2021,10060452013,1006045
3720,02/07/2021,4319,131,3480,240,839,17/06/2021,"Chateau Margaux Premier Cru Classe, Margaux",Bordeaux,2014,03/07/2021,10127812014,1012781
790,02/07/2021,905,21,801,-11,104,31/05/2021,"Chateau Calon Segur 3eme Cru Classe, Saint-Estephe",Bordeaux,2014,03/07/2021,10074752014,1007475
450,16/07/2021,521,3,300,150,221,15/12/2019,"Chateau Batailley 5eme Cru Classe, Pauillac",Bordeaux,2004,17/07/2021,10063222004,1006322
1550,02/07/2021,1557,1,1300,250,257,27/04/2021,"Gaja, Barbaresco",Piedmont,2012,03/07/2021,10996052012,1099605
1090,02/07/2021,1163,6,860,230,303,08/03/2021,"Tignanello, Toscana",Tuscany,2013,03/07/2021,10953912013,1095391
984,02/07/2021,1104,42,830,154,274,22/06/2021,"Tignanello, Toscana",Tuscany,2014,03/07/2021,10953912014,1095391
540,11/06/2021,540,1,544,-4,-4,18/09/2020,"Tua Rita, Giusto di Notri, Toscana",Tuscany,2013,03/07/2021,11058072013,1105807
1400,02/07/2021,1527,14,1300,100,227,30/06/2021,"Gaja, Barbaresco",Piedmont,2013,03/07/2021,10996052013,1099605
2300,18/05/2021,2578,60,2000,300,578,17/02/2021,"Chateau Angelus Premier Grand Cru Classe A, Saint-Emilion Grand Cru",Bordeaux,2013,19/05/2021,10060452013,1006045
850,02/07/2021,1075,87,822,28,253,28/06/2021,"Chateau Calon Segur 3eme Cru Classe, Saint-Estephe",Bordeaux,2015,03/07/2021,10074752015,1007475
10400,02/07/2021,11879,51,9800,600,2079,11/06/2021,"Chateau Margaux Premier Cru Classe, Margaux",Bordeaux,2015,03/07/2021,10127812015,1012781
1130,30/06/2021,1170,15,1012,118,158,02/07/2021,"Tignanello, Toscana",Tuscany,2015,03/07/2021,10953912015,1095391
487,29/06/2021,534,23,388,99,146,29/09/2020,"Tua Rita, Giusto di Notri, Toscana",Tuscany,2015,03/07/2021,11058072015,1105807
15705,02/07/2021,16040,0,18750,-3045,-2710,29/08/2018,"Jacques-Frederic Mugnier, Chambolle-Musigny Premier Cru, Les Amoureuses",Burgundy,2015,03/07/2021,10496422015,1049642
5415,02/07/2021,5829,131,5238,177,591,17/05/2021,"Chateau Margaux Premier Cru Classe, Margaux",Bordeaux,2016,03/07/2021,10127812016,1012781
2300,18/05/2021,2578,60,2000,300,578,17/02/2021,"Chateau Angelus Premier Grand Cru Classe A, Saint-Emilion Grand Cru",Bordeaux,2013,19/05/2021,10060452013,1006045
1100,02/07/2021,1220,70,1036,64,184,27/05/2021,"Chateau Calon Segur 3eme Cru Classe, Saint-Estephe",Bordeaux,2016,03/07/2021,10074752016,1007475
589,16/07/2021,622,49,520,69,102,17/06/2021,"Chateau Batailley 5eme Cru Classe, Pauillac",Bordeaux,2005,17/07/2021,10063222005,1006322
1238,02/07/2021,1290,64,1100,138,190,28/06/2021,"Tignanello, Toscana",Tuscany,2016,03/07/2021,10953912016,1095391
1500,02/07/2021,1673,43,1408,92,265,09/04/2021,"Gaja, Barbaresco",Piedmont,2016,03/07/2021,10996052016,1099605
780,02/07/2021,929,102,740,40,189,21/05/2021,"Chateau Calon Segur 3eme Cru Classe, Saint-Estephe",Bordeaux,2017,03/07/2021,10074752017,1007475
3790,02/07/2021,4274,99,3950,-160,324,30/06/2021,"Chateau Margaux Premier Cru Classe, Margaux",Bordeaux,2017,03/07/2021,10127812017,1012781
1350,02/07/2021,1475,61,1260,90,215,18/02/2021,"Gaja, Barbaresco",Piedmont,2015,03/07/2021,10996052015,1099605
460,02/07/2021,488,157,420,40,68,28/05/2021,"Tua Rita, Giusto di Notri, Toscana",Tuscany,2016,03/07/2021,11058072016,1105807
8000,02/07/2021,8692,5,6974,1026,1718,14/03/2021,"Domaine Leflaive, Chevalier-Montrachet Grand Cru",Burgundy,2017,03/07/2021,10734012017,1073401
2300,17/05/2021,2578,60,2000,300,578,17/02/2021,"Chateau Angelus Premier Grand Cru Classe A, Saint-Emilion Grand Cru",Bordeaux,2013,18/05/2021,10060452013,1006045
5600,02/07/2021,5857,101,5254,346,603,26/05/2021,"Chateau Margaux Premier Cru Classe, Margaux",Bordeaux,2018,03/07/2021,10127812018,1012781
1080,02/07/2021,1214,51,950,130,264,03/05/2021,"Chateau Calon Segur 3eme Cru Classe, Saint-Estephe",Bordeaux,2018,03/07/2021,10074752018,1007475
589,16/07/2021,622,49,520,69,102,17/06/2021,"Chateau Batailley 5eme Cru Classe, Pauillac",Bordeaux,2005,17/07/2021,10063222005,1006322
857,30/06/2021,984,133,848,9,136,02/07/2021,"Tignanello, Toscana",Tuscany,2017,03/07/2021,10953912017,1095391
8000,02/07/2021,8305,5,7330,670,975,02/06/2021,"Domaine Leflaive, Chevalier-Montrachet Grand Cru",Burgundy,2018,03/07/2021,10734012018,1073401
860,02/07/2021,1003,71,910,-50,93,23/06/2021,"Tignanello, Toscana",Tuscany,2018,03/07/2021,10953912018,1095391
510,16/07/2021,596,397,494,16,102,20/04/2021,"Chateau Batailley 5eme Cru Classe, Pauillac",Bordeaux,2010,17/07/2021,10063222010,1006322
920,02/07/2021,1104,25,842,78,262,22/08/2020,"Chateau Calon Segur 3eme Cru Classe, Saint-Estephe",Bordeaux,2019,03/07/2021,10074752019,1007475
5290,02/07/2021,5211,7,4160,1130,1051,19/03/2021,"Chateau Margaux Premier Cru Classe, Margaux",Bordeaux,2019,03/07/2021,10127812019,1012781
1516,29/06/2021,1585,123,1398,118,187,01/07/2021,"Gaja, Barbaresco",Piedmont,2017,03/07/2021,10996052017,1099605
8100,02/07/2021,9025,14,8100,0,925,21/06/2021,"Chateau Margaux Premier Cru Classe, Margaux",Bordeaux,2000,04/07/2021,10127812000,1012781
3700,22/07/2021,4104,26,3520,180,584,07/04/2021,"Chateau Margaux Premier Cru Classe, Margaux",Bordeaux,2013,23/07/2021,10127812013,1012781
2300,17/05/2021,2578,60,2000,300,578,17/02/2021,"Chateau Angelus Premier Grand Cru Classe A, Saint-Emilion Grand Cru",Bordeaux,2013,18/05/2021,10060452013,1006045
800,22/07/2021,792,19,682,118,110,15/09/2020,"Chateau Calon Segur 3eme Cru Classe, Saint-Estephe",Bordeaux,2013,23/07/2021,10074752013,1007475
3800,22/07/2021,4351,120,3480,320,871,17/06/2021,"Chateau Margaux Premier Cru Classe, Margaux",Bordeaux,2014,23/07/2021,10127812014,1012781
790,22/07/2021,877,18,801,-11,76,31/05/2021,"Chateau Calon Segur 3eme Cru Classe, Saint-Estephe",Bordeaux,2014,23/07/2021,10074752014,1007475
1060,22/07/2021,1139,9,860,200,279,08/03/2021,"Tignanello, Toscana",Tuscany,2013,23/07/2021,10953912013,1095391
984,22/07/2021,1048,7,854,130,194,15/07/2021,"Tignanello, Toscana",Tuscany,2014,23/07/2021,10953912014,1095391
10800,20/07/2021,10405,1,8000,2800,2405,30/01/2020,"Domaine Leflaive, Chevalier-Montrachet Grand Cru",Burgundy,2014,23/07/2021,10734012014,1073401
940,22/07/2021,1078,79,866,74,212,20/07/2021,"Chateau Calon Segur 3eme Cru Classe, Saint-Estephe",Bordeaux,2015,23/07/2021,10074752015,1007475
10620,22/07/2021,11692,42,9800,820,1892,11/06/2021,"Chateau Margaux Premier Cru Classe, Margaux",Bordeaux,2015,23/07/2021,10127812015,1012781
870,23/07/2021,966,5,705,165,261,01/02/2021,"Chateau Calon Segur 3eme Cru Classe, Saint-Estephe",Bordeaux,2002,24/07/2021,10074752002,1007475
8200,23/07/2021,9028,16,8100,100,928,21/06/2021,"Chateau Margaux Premier Cru Classe, Margaux",Bordeaux,2000,24/07/2021,10127812000,1012781
2300,14/05/2021,2578,60,2000,300,578,17/02/2021,"Chateau Angelus Premier Grand Cru Classe A, Saint-Emilion Grand Cru",Bordeaux,2013,15/05/2021,10060452013,1006045
900,23/07/2021,1118,23,800,100,318,21/11/2019,"Chateau Calon Segur 3eme Cru Classe, Saint-Estephe",Bordeaux,2003,24/07/2021,10074752003,1007475
4450,23/07/2021,4750,24,4400,50,350,29/09/2020,"Chateau Margaux Premier Cru Classe, Margaux",Bordeaux,2001,24/07/2021,10127812001,1012781
3900,23/07/2021,4417,22,3684,216,733,10/06/2020,"Chateau Margaux Premier Cru Classe, Margaux",Bordeaux,2002,24/07/2021,10127812002,1012781
3950,04/08/2021,4469,108,3780,170,689,23/07/2021,"Chateau Margaux Premier Cru Classe, Margaux",Bordeaux,2008,05/08/2021,10127812008,1012781
790,04/08/2021,868,17,801,-11,67,31/05/2021,"Chateau Calon Segur 3eme Cru Classe, Saint-Estephe",Bordeaux,2014,05/08/2021,10074752014,1007475
510,16/07/2021,596,397,494,16,102,20/04/2021,"Chateau Batailley 5eme Cru Classe, Pauillac",Bordeaux,2010,17/07/2021,10063222010,1006322
2300,14/05/2021,2578,60,2000,300,578,17/02/2021,"Chateau Angelus Premier Grand Cru Classe A, Saint-Emilion Grand Cru",Bordeaux,2013,15/05/2021,10060452013,1006045
900,02/07/2021,936,44,863,37,73,10/05/2021,"Chateau Calon Segur 3eme Cru Classe, Saint-Estephe",Bordeaux,2006,03/07/2021,10074752006,1007475
3900,02/07/2021,4634,94,3822,78,812,20/06/2021,"Chateau Margaux Premier Cru Classe, Margaux",Bordeaux,2006,03/07/2021,10127812006,1012781
320,16/07/2021,320,109,304,16,16,10/01/2021,"Chateau Batailley 5eme Cru Classe, Pauillac",Bordeaux,2013,17/07/2021,10063222013,1006322
3560,02/07/2021,4183,39,3525,35,658,18/06/2021,"Chateau Margaux Premier Cru Classe, Margaux",Bordeaux,2007,03/07/2021,10127812007,1012781
880,02/07/2021,967,9,725,155,242,13/04/2021,"Chateau Calon Segur 3eme Cru Classe, Saint-Estephe",Bordeaux,2007,03/07/2021,10074752007,1007475
2350,12/05/2021,2581,61,2000,350,581,17/02/2021,"Chateau Angelus Premier Grand Cru Classe A, Saint-Emilion Grand Cru",Bordeaux,2013,13/05/2021,10060452013,1006045
2350,12/05/2021,2578,60,2000,350,578,17/02/2021,"Chateau Angelus Premier Grand Cru Classe A, Saint-Emilion Grand Cru",Bordeaux,2013,14/05/2021,10060452013,1006045
3900,02/07/2021,4295,86,3750,150,545,28/06/2021,"Chateau Margaux Premier Cru Classe, Margaux",Bordeaux,2008,03/07/2021,10127812008,1012781
895,02/07/2021,980,10,781,114,199,16/11/2020,"Chateau Calon Segur 3eme Cru Classe, Saint-Estephe",Bordeaux,2008,03/07/2021,10074752008,1007475
6830,02/07/2021,7777,48,7086,-256,691,11/06/2021,"Chateau Margaux Premier Cru Classe, Margaux",Bordeaux,2009,03/07/2021,10127812009,1012781
1000,02/07/2021,1259,45,1026,-26,233,24/06/2021,"Chateau Calon Segur 3eme Cru Classe, Saint-Estephe",Bordeaux,2009,03/07/2021,10074752009,1007475
359,16/07/2021,369,85,360,-1,9,14/07/2021,"Chateau Batailley 5eme Cru Classe, Pauillac",Bordeaux,2014,17/07/2021,10063222014,1006322
2350,12/05/2021,2581,61,2000,350,581,17/02/2021,"Chateau Angelus Premier Grand Cru Classe A, Saint-Emilion Grand Cru",Bordeaux,2013,13/05/2021,10060452013,1006045
1408,29/06/2021,1605,2,1150,258,455,21/04/2019,"Tignanello, Toscana",Tuscany,2005,03/07/2021,10953912005,1095391
2500,02/07/2021,2632,3,2220,280,412,14/06/2021,"Gaja, Barbaresco",Piedmont,2001,03/07/2021,10996052001,1099605
1700,02/07/2021,1847,4,1378,322,469,29/07/2020,"Tignanello, Toscana",Tuscany,2001,03/07/2021,10953912001,1095391
1408,02/07/2021,1389,4,1238,170,151,02/11/2020,"Tignanello, Toscana",Tuscany,2006,03/07/2021,10953912006,1095391
6400,02/07/2021,7556,51,5950,450,1606,23/06/2021,"Chateau Margaux Premier Cru Classe, Margaux",Bordeaux,2010,03/07/2021,10127812010,1012781
359,16/07/2021,368,97,360,-1,8,14/07/2021,"Chateau Batailley 5eme Cru Classe, Pauillac",Bordeaux,2014,20/07/2021,10063222014,1006322
990,02/07/2021,1134,16,990,0,144,16/06/2021,"Chateau Calon Segur 3eme Cru Classe, Saint-Estephe",Bordeaux,2010,03/07/2021,10074752010,1007475
2350,12/05/2021,2578,60,2000,350,578,17/02/2021,"Chateau Angelus Premier Grand Cru Classe A, Saint-Emilion Grand Cru",Bordeaux,2013,14/05/2021,10060452013,1006045
750,02/07/2021,988,36,790,-40,198,01/06/2020,"Chateau Calon Segur 3eme Cru Classe, Saint-Estephe",Bordeaux,2011,03/07/2021,10074752011,1007475
1024,02/07/2021,1255,4,1072,-48,183,20/01/2021,"Tignanello, Toscana",Tuscany,2009,03/07/2021,10953912009,1095391
1326,02/07/2021,1560,4,1170,156,390,24/06/2021,"Tignanello, Toscana",Tuscany,2010,03/07/2021,10953912010,1095391
3758,02/07/2021,4298,75,3690,68,608,13/04/2021,"Chateau Margaux Premier Cru Classe, Margaux",Bordeaux,2011,03/07/2021,10127812011,1012781
2350,10/05/2021,2581,61,2000,350,581,17/02/2021,"Chateau Angelus Premier Grand Cru Classe A, Saint-Emilion Grand Cru",Bordeaux,2013,12/05/2021,10060452013,1006045
960,30/06/2021,1038,10,880,80,158,22/06/2021,"Tignanello, Toscana",Tuscany,2011,03/07/2021,10953912011,1095391
2350,10/05/2021,2712,25,2000,350,712,17/02/2021,"Chateau Angelus Premier Grand Cru Classe A, Saint-Emilion Grand Cru",Bordeaux,2013,11/05/2021,10060452013,1006045
476,16/07/2021,526,37,364,112,162,12/05/2021,"Chateau Batailley 5eme Cru Classe, Pauillac",Bordeaux,2016,17/07/2021,10063222016,1006322
820,02/07/2021,937,6,735,85,202,09/09/2020,"Chateau Calon Segur 3eme Cru Classe, Saint-Estephe",Bordeaux,2012,03/07/2021,10074752012,1007475
3750,24/06/2021,4181,41,3560,190,621,20/11/2020,"Chateau Margaux Premier Cru Classe, Margaux",Bordeaux,2012,03/07/2021,10127812012,1012781
3740,02/07/2021,3999,50,3520,220,479,07/04/2021,"Chateau Margaux Premier Cru Classe, Margaux",Bordeaux,2013,03/07/2021,10127812013,1012781
2350,10/05/2021,2581,61,2000,350,581,17/02/2021,"Chateau Angelus Premier Grand Cru Classe A, Saint-Emilion Grand Cru",Bordeaux,2013,12/05/2021,10060452013,1006045
686,02/07/2021,809,7,682,4,127,15/09/2020,"Chateau Calon Segur 3eme Cru Classe, Saint-Estephe",Bordeaux,2013,03/07/2021,10074752013,1007475
960,02/07/2021,1256,12,850,110,406,28/01/2021,"Tignanello, Toscana",Tuscany,2012,03/07/2021,10953912012,1095391
2350,10/05/2021,2712,25,2000,350,712,17/02/2021,"Chateau Angelus Premier Grand Cru Classe A, Saint-Emilion Grand Cru",Bordeaux,2013,11/05/2021,10060452013,1006045
3720,02/07/2021,4319,131,3480,240,839,17/06/2021,"Chateau Margaux Premier Cru Classe, Margaux",Bordeaux,2014,03/07/2021,10127812014,1012781
790,02/07/2021,905,21,801,-11,104,31/05/2021,"Chateau Calon Segur 3eme Cru Classe, Saint-Estephe",Bordeaux,2014,03/07/2021,10074752014,1007475
1090,02/07/2021,1163,6,860,230,303,08/03/2021,"Tignanello, Toscana",Tuscany,2013,03/07/2021,10953912013,1095391
984,02/07/2021,1104,42,830,154,274,22/06/2021,"Tignanello, Toscana",Tuscany,2014,03/07/2021,10953912014,1095391
850,02/07/2021,1075,87,822,28,253,28/06/2021,"Chateau Calon Segur 3eme Cru Classe, Saint-Estephe",Bordeaux,2015,03/07/2021,10074752015,1007475
10400,02/07/2021,11879,51,9800,600,2079,11/06/2021,"Chateau Margaux Premier Cru Classe, Margaux",Bordeaux,2015,03/07/2021,10127812015,1012781
4438,02/07/2021,4717,21,4400,38,317,29/09/2020,"Chateau Margaux Premier Cru Classe, Margaux",Bordeaux,2001,04/07/2021,10127812001,1012781
2300,07/05/2021,2721,23,2000,300,721,17/02/2021,"Chateau Angelus Premier Grand Cru Classe A, Saint-Emilion Grand Cru",Bordeaux,2013,08/05/2021,10060452013,1006045
2300,07/05/2021,2721,23,2000,300,721,17/02/2021,"Chateau Angelus Premier Grand Cru Classe A, Saint-Emilion Grand Cru",Bordeaux,2013,08/05/2021,10060452013,1006045
907,02/07/2021,924,18,805,102,119,20/11/2019,"Chateau Calon Segur 3eme Cru Classe, Saint-Estephe",Bordeaux,2001,04/07/2021,10074752001,1007475
6400,02/07/2021,7179,27,6776,-376,403,10/06/2021,"Chateau Margaux Premier Cru Classe, Margaux",Bordeaux,2005,04/07/2021,10127812005,1012781
1000,23/07/2021,1115,8,880,120,235,22/06/2021,"Tignanello, Toscana",Tuscany,2011,24/07/2021,10953912011,1095391
2300,06/05/2021,2693,27,2000,300,693,17/02/2021,"Chateau Angelus Premier Grand Cru Classe A, Saint-Emilion Grand Cru",Bordeaux,2013,07/05/2021,10060452013,1006045
395,16/07/2021,411,27,357,38,54,06/05/2021,"Chateau Batailley 5eme Cru Classe, Pauillac",Bordeaux,2018,23/07/2021,10063222018,1006322
820,23/07/2021,924,5,735,85,189,09/09/2020,"Chateau Calon Segur 3eme Cru Classe, Saint-Estephe",Bordeaux,2012,24/07/2021,10074752012,1007475
3750,15/07/2021,4269,39,3560,190,709,20/11/2020,"Chateau Margaux Premier Cru Classe, Margaux",Bordeaux,2012,24/07/2021,10127812012,1012781
3700,23/07/2021,4089,26,3520,180,569,07/04/2021,"Chateau Margaux Premier Cru Classe, Margaux",Bordeaux,2013,24/07/2021,10127812013,1012781
2300,06/05/2021,2693,27,2000,300,693,17/02/2021,"Chateau Angelus Premier Grand Cru Classe A, Saint-Emilion Grand Cru",Bordeaux,2013,07/05/2021,10060452013,1006045
800,23/07/2021,792,19,682,118,110,15/09/2020,"Chateau Calon Segur 3eme Cru Classe, Saint-Estephe",Bordeaux,2013,24/07/2021,10074752013,1007475
960,23/07/2021,1309,13,850,110,459,28/01/2021,"Tignanello, Toscana",Tuscany,2012,24/07/2021,10953912012,1095391
2300,05/05/2021,2693,27,2000,300,693,17/02/2021,"Chateau Angelus Premier Grand Cru Classe A, Saint-Emilion Grand Cru",Bordeaux,2013,06/05/2021,10060452013,1006045
3800,23/07/2021,4349,120,3480,320,869,17/06/2021,"Chateau Margaux Premier Cru Classe, Margaux",Bordeaux,2014,24/07/2021,10127812014,1012781
790,23/07/2021,877,18,801,-11,76,31/05/2021,"Chateau Calon Segur 3eme Cru Classe, Saint-Estephe",Bordeaux,2014,24/07/2021,10074752014,1007475
1060,23/07/2021,1140,9,860,200,280,08/03/2021,"Tignanello, Toscana",Tuscany,2013,24/07/2021,10953912013,1095391
984,23/07/2021,1048,7,854,130,194,15/07/2021,"Tignanello, Toscana",Tuscany,2014,24/07/2021,10953912014,1095391
940,23/07/2021,1079,77,866,74,213,20/07/2021,"Chateau Calon Segur 3eme Cru Classe, Saint-Estephe",Bordeaux,2015,24/07/2021,10074752015,1007475
10620,23/07/2021,11696,40,9800,820,1896,11/06/2021,"Chateau Margaux Premier Cru Classe, Margaux",Bordeaux,2015,24/07/2021,10127812015,1012781
820,06/08/2021,925,4,735,85,190,09/09/2020,"Chateau Calon Segur 3eme Cru Classe, Saint-Estephe",Bordeaux,2012,07/08/2021,10074752012,1007475
6930,23/07/2021,7678,50,7086,-156,592,11/06/2021,"Chateau Margaux Premier Cru Classe, Margaux",Bordeaux,2009,25/07/2021,10127812009,1012781
1680,23/07/2021,1707,3,1420,260,287,29/06/2021,"Tignanello, Toscana",Tuscany,2004,25/07/2021,10953912004,1095391
6300,23/07/2021,7557,55,6188,112,1369,16/07/2021,"Chateau Margaux Premier Cru Classe, Margaux",Bordeaux,2010,25/07/2021,10127812010,1012781
820,23/07/2021,920,4,735,85,185,09/09/2020,"Chateau Calon Segur 3eme Cru Classe, Saint-Estephe",Bordeaux,2012,25/07/2021,10074752012,1007475
7906,20/07/2021,8033,1,7124,782,909,15/02/2019,"Domaine Leflaive, Chevalier-Montrachet Grand Cru",Burgundy,2016,25/07/2021,10734012016,1073401
8556,21/07/2021,8836,2,6974,1582,1862,14/03/2021,"Domaine Leflaive, Chevalier-Montrachet Grand Cru",Burgundy,2017,25/07/2021,10734012017,1073401
1680,23/07/2021,1707,3,1420,260,287,29/06/2021,"Tignanello, Toscana",Tuscany,2004,25/07/2021,10953912004,1095391
6300,23/07/2021,7557,55,6188,112,1369,16/07/2021,"Chateau Margaux Premier Cru Classe, Margaux",Bordeaux,2010,25/07/2021,10127812010,1012781
820,23/07/2021,920,4,735,85,185,09/09/2020,"Chateau Calon Segur 3eme Cru Classe, Saint-Estephe",Bordeaux,2012,25/07/2021,10074752012,1007475
6500,23/07/2021,7509,23,6400,100,1109,22/07/2021,"Chateau Margaux Premier Cru Classe, Margaux",Bordeaux,2005,26/07/2021,10127812005,1012781
2300,05/05/2021,2693,27,2000,300,693,17/02/2021,"Chateau Angelus Premier Grand Cru Classe A, Saint-Emilion Grand Cru",Bordeaux,2013,06/05/2021,10060452013,1006045
990,22/07/2021,1162,64,1029,-39,133,21/07/2021,"Chateau Calon Segur 3eme Cru Classe, Saint-Estephe",Bordeaux,2005,26/07/2021,10074752005,1007475
895,23/07/2021,953,8,781,114,172,16/11/2020,"Chateau Calon Segur 3eme Cru Classe, Saint-Estephe",Bordeaux,2008,26/07/2021,10074752008,1007475
2300,04/05/2021,2693,27,2000,300,693,17/02/2021,"Chateau Angelus Premier Grand Cru Classe A, Saint-Emilion Grand Cru",Bordeaux,2013,05/05/2021,10060452013,1006045
2300,04/05/2021,2693,27,2000,300,693,17/02/2021,"Chateau Angelus Premier Grand Cru Classe A, Saint-Emilion Grand Cru",Bordeaux,2013,05/05/2021,10060452013,1006045
1260,23/07/2021,1602,3,1170,90,432,24/06/2021,"Tignanello, Toscana",Tuscany,2010,26/07/2021,10953912010,1095391
1000,02/07/2021,1159,88,988,12,171,28/05/2021,"Chateau Calon Segur 3eme Cru Classe, Saint-Estephe",Bordeaux,2005,04/07/2021,10074752005,1007475
900,02/07/2021,927,41,863,37,64,10/05/2021,"Chateau Calon Segur 3eme Cru Classe, Saint-Estephe",Bordeaux,2006,04/07/2021,10074752006,1007475
3900,02/07/2021,4647,89,3822,78,825,20/06/2021,"Chateau Margaux Premier Cru Classe, Margaux",Bordeaux,2006,04/07/2021,10127812006,1012781
3560,02/07/2021,4185,37,3525,35,660,18/06/2021,"Chateau Margaux Premier Cru Classe, Margaux",Bordeaux,2007,04/07/2021,10127812007,1012781
2300,03/05/2021,2693,27,2000,300,693,17/02/2021,"Chateau Angelus Premier Grand Cru Classe A, Saint-Emilion Grand Cru",Bordeaux,2013,04/05/2021,10060452013,1006045
3900,02/07/2021,4288,82,3750,150,538,28/06/2021,"Chateau Margaux Premier Cru Classe, Margaux",Bordeaux,2008,04/07/2021,10127812008,1012781
395,16/07/2021,413,28,357,38,56,06/05/2021,"Chateau Batailley 5eme Cru Classe, Pauillac",Bordeaux,2018,19/07/2021,10063222018,1006322
895,02/07/2021,978,10,781,114,197,16/11/2020,"Chateau Calon Segur 3eme Cru Classe, Saint-Estephe",Bordeaux,2008,04/07/2021,10074752008,1007475
6830,02/07/2021,7777,46,7086,-256,691,11/06/2021,"Chateau Margaux Premier Cru Classe, Margaux",Bordeaux,2009,04/07/2021,10127812009,1012781
1000,02/07/2021,1259,44,1026,-26,233,24/06/2021,"Chateau Calon Segur 3eme Cru Classe, Saint-Estephe",Bordeaux,2009,04/07/2021,10074752009,1007475
7000,10/05/2021,6391,0,5360,1640,1031,18/09/2020,"Domaine Leflaive, Chevalier-Montrachet Grand Cru",Burgundy,2009,04/07/2021,10734012009,1073401
6400,02/07/2021,7532,50,5950,450,1582,23/06/2021,"Chateau Margaux Premier Cru Classe, Margaux",Bordeaux,2010,04/07/2021,10127812010,1012781
750,02/07/2021,989,35,790,-40,199,01/06/2020,"Chateau Calon Segur 3eme Cru Classe, Saint-Estephe",Bordeaux,2011,04/07/2021,10074752011,1007475
2300,03/05/2021,2693,27,2000,300,693,17/02/2021,"Chateau Angelus Premier Grand Cru Classe A, Saint-Emilion Grand Cru",Bordeaux,2013,04/05/2021,10060452013,1006045
395,16/07/2021,412,28,357,38,55,06/05/2021,"Chateau Batailley 5eme Cru Classe, Pauillac",Bordeaux,2018,17/07/2021,10063222018,1006322
2360,09/08/2021,2634,193,2260,100,374,05/08/2021,"Chateau Angelus Premier Grand Cru Classe A, Saint-Emilion Grand Cru",Bordeaux,2014,10/08/2021,10060452014,1006045
3750,24/06/2021,4182,41,3560,190,622,20/11/2020,"Chateau Margaux Premier Cru Classe, Margaux",Bordeaux,2012,04/07/2021,10127812012,1012781
860,02/07/2021,1003,71,910,-50,93,03/07/2021,"Tignanello, Toscana",Tuscany,2018,04/07/2021,10953912018,1095391
3820,23/07/2021,4618,192,3950,-130,668,30/06/2021,"Chateau Margaux Premier Cru Classe, Margaux",Bordeaux,2017,26/07/2021,10127812017,1012781
1028,23/07/2021,1245,39,1058,-30,187,14/07/2021,"Chateau Calon Segur 3eme Cru Classe, Saint-Estephe",Bordeaux,2018,26/07/2021,10074752018,1007475
866,21/07/2021,989,101,886,-20,103,21/07/2021,"Tignanello, Toscana",Tuscany,2017,26/07/2021,10953912017,1095391
2360,09/08/2021,2634,193,2260,100,374,05/08/2021,"Chateau Angelus Premier Grand Cru Classe A, Saint-Emilion Grand Cru",Bordeaux,2014,10/08/2021,10060452014,1006045
2360,06/08/2021,2634,193,2260,100,374,05/08/2021,"Chateau Angelus Premier Grand Cru Classe A, Saint-Emilion Grand Cru",Bordeaux,2014,07/08/2021,10060452014,1006045
907,06/08/2021,953,23,805,102,148,20/11/2019,"Chateau Calon Segur 3eme Cru Classe, Saint-Estephe",Bordeaux,2001,07/08/2021,10074752001,1007475
3840,23/07/2021,4601,46,4116,-276,485,25/02/2021,"Chateau Margaux Premier Cru Classe, Margaux",Bordeaux,2004,24/07/2021,10127812004,1012781
5040,23/07/2021,6002,22,4650,390,1352,21/06/2021,"Chateau Margaux Premier Cru Classe, Margaux",Bordeaux,2003,24/07/2021,10127812003,1012781
2360,06/08/2021,2634,193,2260,100,374,05/08/2021,"Chateau Angelus Premier Grand Cru Classe A, Saint-Emilion Grand Cru",Bordeaux,2014,07/08/2021,10060452014,1006045
840,23/07/2021,1059,19,745,95,314,16/11/2020,"Chateau Calon Segur 3eme Cru Classe, Saint-Estephe",Bordeaux,2004,24/07/2021,10074752004,1007475
907,23/07/2021,952,22,805,102,147,20/11/2019,"Chateau Calon Segur 3eme Cru Classe, Saint-Estephe",Bordeaux,2001,24/07/2021,10074752001,1007475
685,19/07/2021,1033,3,470,215,563,29/03/2018,"Chateau Batailley 5eme Cru Classe, Pauillac",Bordeaux,2000,20/07/2021,10063222000,1006322
2360,04/08/2021,2634,188,2178,182,456,19/04/2021,"Chateau Angelus Premier Grand Cru Classe A, Saint-Emilion Grand Cru",Bordeaux,2014,05/08/2021,10060452014,1006045
685,19/07/2021,1033,3,470,215,563,29/03/2018,"Chateau Batailley 5eme Cru Classe, Pauillac",Bordeaux,2000,20/07/2021,10063222000,1006322
2360,04/08/2021,2634,188,2178,182,456,19/04/2021,"Chateau Angelus Premier Grand Cru Classe A, Saint-Emilion Grand Cru",Bordeaux,2014,05/08/2021,10060452014,1006045
6500,23/07/2021,7503,24,6400,100,1103,22/07/2021,"Chateau Margaux Premier Cru Classe, Margaux",Bordeaux,2005,24/07/2021,10127812005,1012781
990,22/07/2021,1157,66,1029,-39,128,21/07/2021,"Chateau Calon Segur 3eme Cru Classe, Saint-Estephe",Bordeaux,2005,24/07/2021,10074752005,1007475
450,19/07/2021,532,2,300,150,232,15/12/2019,"Chateau Batailley 5eme Cru Classe, Pauillac",Bordeaux,2004,20/07/2021,10063222004,1006322
950,03/08/2021,1140,7,960,-10,180,27/07/2021,"Tignanello, Toscana",Tuscany,2013,04/08/2021,10953912013,1095391
589,19/07/2021,623,61,520,69,103,17/06/2021,"Chateau Batailley 5eme Cru Classe, Pauillac",Bordeaux,2005,20/07/2021,10063222005,1006322
3900,23/07/2021,4693,76,3822,78,871,20/06/2021,"Chateau Margaux Premier Cru Classe, Margaux",Bordeaux,2006,24/07/2021,10127812006,1012781
589,19/07/2021,623,61,520,69,103,17/06/2021,"Chateau Batailley 5eme Cru Classe, Pauillac",Bordeaux,2005,20/07/2021,10063222005,1006322
880,23/07/2021,980,7,725,155,255,13/04/2021,"Chateau Calon Segur 3eme Cru Classe, Saint-Estephe",Bordeaux,2007,24/07/2021,10074752007,1007475
2360,04/08/2021,2635,192,2260,100,375,05/08/2021,"Chateau Angelus Premier Grand Cru Classe A, Saint-Emilion Grand Cru",Bordeaux,2014,06/08/2021,10060452014,1006045
3750,23/07/2021,4240,77,3525,225,715,18/06/2021,"Chateau Margaux Premier Cru Classe, Margaux",Bordeaux,2007,24/07/2021,10127812007,1012781
8400,23/07/2021,8400,1,5700,2700,2700,10/09/2020,"Domaine Leflaive, Chevalier-Montrachet Grand Cru",Burgundy,2007,24/07/2021,10734012007,1073401
2360,04/08/2021,2635,192,2260,100,375,05/08/2021,"Chateau Angelus Premier Grand Cru Classe A, Saint-Emilion Grand Cru",Bordeaux,2014,06/08/2021,10060452014,1006045
6500,23/07/2021,7509,23,6400,100,1109,22/07/2021,"Chateau Margaux Premier Cru Classe, Margaux",Bordeaux,2005,26/07/2021,10127812005,1012781
2380,02/08/2021,2634,188,2178,202,456,19/04/2021,"Chateau Angelus Premier Grand Cru Classe A, Saint-Emilion Grand Cru",Bordeaux,2014,03/08/2021,10060452014,1006045
990,22/07/2021,1162,64,1029,-39,133,21/07/2021,"Chateau Calon Segur 3eme Cru Classe, Saint-Estephe",Bordeaux,2005,26/07/2021,10074752005,1007475
895,23/07/2021,953,8,781,114,172,16/11/2020,"Chateau Calon Segur 3eme Cru Classe, Saint-Estephe",Bordeaux,2008,26/07/2021,10074752008,1007475
2380,02/08/2021,2634,188,2178,202,456,19/04/2021,"Chateau Angelus Premier Grand Cru Classe A, Saint-Emilion Grand Cru",Bordeaux,2014,03/08/2021,10060452014,1006045
2380,30/07/2021,2634,187,2178,202,456,19/04/2021,"Chateau Angelus Premier Grand Cru Classe A, Saint-Emilion Grand Cru",Bordeaux,2014,31/07/2021,10060452014,1006045
1260,23/07/2021,1602,3,1170,90,432,24/06/2021,"Tignanello, Toscana",Tuscany,2010,26/07/2021,10953912010,1095391
6930,23/07/2021,7678,50,7086,-156,592,11/06/2021,"Chateau Margaux Premier Cru Classe, Margaux",Bordeaux,2009,25/07/2021,10127812009,1012781
8200,26/07/2021,9028,16,8200,0,828,26/07/2021,"Chateau Margaux Premier Cru Classe, Margaux",Bordeaux,2000,27/07/2021,10127812000,1012781
870,26/07/2021,966,5,705,165,261,01/02/2021,"Chateau Calon Segur 3eme Cru Classe, Saint-Estephe",Bordeaux,2002,27/07/2021,10074752002,1007475
2380,30/07/2021,2634,187,2178,202,456,19/04/2021,"Chateau Angelus Premier Grand Cru Classe A, Saint-Emilion Grand Cru",Bordeaux,2014,31/07/2021,10060452014,1006045
900,26/07/2021,1115,23,800,100,315,21/11/2019,"Chateau Calon Segur 3eme Cru Classe, Saint-Estephe",Bordeaux,2003,27/07/2021,10074752003,1007475
3900,26/07/2021,4417,22,3684,216,733,10/06/2020,"Chateau Margaux Premier Cru Classe, Margaux",Bordeaux,2002,27/07/2021,10127812002,1012781
4450,26/07/2021,4750,24,4400,50,350,29/09/2020,"Chateau Margaux Premier Cru Classe, Margaux",Bordeaux,2001,27/07/2021,10127812001,1012781
3840,26/07/2021,4582,49,4116,-276,466,25/02/2021,"Chateau Margaux Premier Cru Classe, Margaux",Bordeaux,2004,27/07/2021,10127812004,1012781
5040,26/07/2021,6002,22,4650,390,1352,21/06/2021,"Chateau Margaux Premier Cru Classe, Margaux",Bordeaux,2003,27/07/2021,10127812003,1012781
840,26/07/2021,1059,19,745,95,314,16/11/2020,"Chateau Calon Segur 3eme Cru Classe, Saint-Estephe",Bordeaux,2004,27/07/2021,10074752004,1007475
8100,02/07/2021,8994,13,8100,0,894,21/06/2021,"Chateau Margaux Premier Cru Classe, Margaux",Bordeaux,2000,05/07/2021,10127812000,1012781
900,02/07/2021,1146,23,800,100,346,21/11/2019,"Chateau Calon Segur 3eme Cru Classe, Saint-Estephe",Bordeaux,2003,05/07/2021,10074752003,1007475
3826,02/07/2021,4507,54,4116,-290,391,25/02/2021,"Chateau Margaux Premier Cru Classe, Margaux",Bordeaux,2004,05/07/2021,10127812004,1012781
2380,28/07/2021,2626,198,2178,202,448,19/04/2021,"Chateau Angelus Premier Grand Cru Classe A, Saint-Emilion Grand Cru",Bordeaux,2014,29/07/2021,10060452014,1006045
800,02/07/2021,922,18,745,55,177,16/11/2020,"Chateau Calon Segur 3eme Cru Classe, Saint-Estephe",Bordeaux,2004,05/07/2021,10074752004,1007475
6400,02/07/2021,7276,24,6776,-376,500,10/06/2021,"Chateau Margaux Premier Cru Classe, Margaux",Bordeaux,2005,05/07/2021,10127812005,1012781
6830,02/07/2021,7788,45,7086,-256,702,11/06/2021,"Chateau Margaux Premier Cru Classe, Margaux",Bordeaux,2009,05/07/2021,10127812009,1012781
6400,02/07/2021,7550,49,5950,450,1600,23/06/2021,"Chateau Margaux Premier Cru Classe, Margaux",Bordeaux,2010,05/07/2021,10127812010,1012781
960,30/06/2021,1039,9,880,80,159,22/06/2021,"Tignanello, Toscana",Tuscany,2011,05/07/2021,10953912011,1095391
3740,02/07/2021,4000,49,3520,220,480,07/04/2021,"Chateau Margaux Premier Cru Classe, Margaux",Bordeaux,2013,05/07/2021,10127812013,1012781
2380,28/07/2021,2620,185,2178,202,442,19/04/2021,"Chateau Angelus Premier Grand Cru Classe A, Saint-Emilion Grand Cru",Bordeaux,2014,30/07/2021,10060452014,1006045
3720,02/07/2021,4324,127,3480,240,844,17/06/2021,"Chateau Margaux Premier Cru Classe, Margaux",Bordeaux,2014,05/07/2021,10127812014,1012781
850,02/07/2021,1084,81,822,28,262,28/06/2021,"Chateau Calon Segur 3eme Cru Classe, Saint-Estephe",Bordeaux,2015,05/07/2021,10074752015,1007475
10400,02/07/2021,11861,49,9800,600,2061,11/06/2021,"Chateau Margaux Premier Cru Classe, Margaux",Bordeaux,2015,05/07/2021,10127812015,1012781
870,05/07/2021,966,5,705,165,261,01/02/2021,"Chateau Calon Segur 3eme Cru Classe, Saint-Estephe",Bordeaux,2002,06/07/2021,10074752002,1007475
8100,05/07/2021,9036,12,8100,0,936,21/06/2021,"Chateau Margaux Premier Cru Classe, Margaux",Bordeaux,2000,06/07/2021,10127812000,1012781
900,05/07/2021,1156,20,800,100,356,21/11/2019,"Chateau Calon Segur 3eme Cru Classe, Saint-Estephe",Bordeaux,2003,06/07/2021,10074752003,1007475
960,05/07/2021,1256,12,850,110,406,28/01/2021,"Tignanello, Toscana",Tuscany,2012,06/07/2021,10953912012,1095391
2380,28/07/2021,2626,198,2178,202,448,19/04/2021,"Chateau Angelus Premier Grand Cru Classe A, Saint-Emilion Grand Cru",Bordeaux,2014,29/07/2021,10060452014,1006045
3720,05/07/2021,4324,123,3480,240,844,17/06/2021,"Chateau Margaux Premier Cru Classe, Margaux",Bordeaux,2014,06/07/2021,10127812014,1012781
510,19/07/2021,595,401,494,16,101,20/04/2021,"Chateau Batailley 5eme Cru Classe, Pauillac",Bordeaux,2010,20/07/2021,10063222010,1006322
1550,05/07/2021,1557,1,1300,250,257,27/04/2021,"Gaja, Barbaresco",Piedmont,2012,06/07/2021,10996052012,1099605
1090,05/07/2021,1159,7,860,230,299,08/03/2021,"Tignanello, Toscana",Tuscany,2013,06/07/2021,10953912013,1095391
984,05/07/2021,1104,42,830,154,274,22/06/2021,"Tignanello, Toscana",Tuscany,2014,06/07/2021,10953912014,1095391
1400,05/07/2021,1527,14,1300,100,227,30/06/2021,"Gaja, Barbaresco",Piedmont,2013,06/07/2021,10996052013,1099605
850,05/07/2021,1084,81,822,28,262,28/06/2021,"Chateau Calon Segur 3eme Cru Classe, Saint-Estephe",Bordeaux,2015,06/07/2021,10074752015,1007475
2380,28/07/2021,2620,185,2178,202,442,19/04/2021,"Chateau Angelus Premier Grand Cru Classe A, Saint-Emilion Grand Cru",Bordeaux,2014,30/07/2021,10060452014,1006045
10400,05/07/2021,11872,49,9800,600,2072,11/06/2021,"Chateau Margaux Premier Cru Classe, Margaux",Bordeaux,2015,06/07/2021,10127812015,1012781
14520,05/07/2021,14520,1,12000,2520,2520,28/05/2020,"Jacques-Frederic Mugnier, Chambolle-Musigny Premier Cru, Les Amoureuses",Burgundy,2014,06/07/2021,10496422014,1049642
1130,30/06/2021,1167,15,1012,118,155,02/07/2021,"Tignanello, Toscana",Tuscany,2015,06/07/2021,10953912015,1095391
487,29/06/2021,533,23,388,99,145,29/09/2020,"Tua Rita, Giusto di Notri, Toscana",Tuscany,2015,06/07/2021,11058072015,1105807
5415,05/07/2021,5825,118,5238,177,587,17/05/2021,"Chateau Margaux Premier Cru Classe, Margaux",Bordeaux,2016,06/07/2021,10127812016,1012781
1100,05/07/2021,1222,68,1036,64,186,27/05/2021,"Chateau Calon Segur 3eme Cru Classe, Saint-Estephe",Bordeaux,2016,06/07/2021,10074752016,1007475
510,19/07/2021,595,401,494,16,101,20/04/2021,"Chateau Batailley 5eme Cru Classe, Pauillac",Bordeaux,2010,20/07/2021,10063222010,1006322
1238,05/07/2021,1290,64,1100,138,190,28/06/2021,"Tignanello, Toscana",Tuscany,2016,06/07/2021,10953912016,1095391
1500,05/07/2021,1677,42,1408,92,269,09/04/2021,"Gaja, Barbaresco",Piedmont,2016,06/07/2021,10996052016,1099605
2380,26/07/2021,2626,197,2178,202,448,19/04/2021,"Chateau Angelus Premier Grand Cru Classe A, Saint-Emilion Grand Cru",Bordeaux,2014,27/07/2021,10060452014,1006045
780,05/07/2021,929,102,740,40,189,21/05/2021,"Chateau Calon Segur 3eme Cru Classe, Saint-Estephe",Bordeaux,2017,06/07/2021,10074752017,1007475
320,19/07/2021,320,121,304,16,16,10/01/2021,"Chateau Batailley 5eme Cru Classe, Pauillac",Bordeaux,2013,20/07/2021,10063222013,1006322
3790,05/07/2021,4274,98,3950,-160,324,30/06/2021,"Chateau Margaux Premier Cru Classe, Margaux",Bordeaux,2017,06/07/2021,10127812017,1012781
1350,05/07/2021,1480,56,1260,90,220,18/02/2021,"Gaja, Barbaresco",Piedmont,2015,06/07/2021,10996052015,1099605
460,05/07/2021,488,157,420,40,68,28/05/2021,"Tua Rita, Giusto di Notri, Toscana",Tuscany,2016,06/07/2021,11058072016,1105807
8000,05/07/2021,8684,5,6974,1026,1710,14/03/2021,"Domaine Leflaive, Chevalier-Montrachet Grand Cru",Burgundy,2017,06/07/2021,10734012017,1073401
7527,05/07/2021,9867,3,7290,237,2577,21/08/2020,"Domaine Denis Mortet, Chambertin Grand Cru",Burgundy,2017,06/07/2021,10490202017,1049020
2380,26/07/2021,2626,197,2178,202,448,19/04/2021,"Chateau Angelus Premier Grand Cru Classe A, Saint-Emilion Grand Cru",Bordeaux,2014,27/07/2021,10060452014,1006045
5600,05/07/2021,5855,100,5254,346,601,26/05/2021,"Chateau Margaux Premier Cru Classe, Margaux",Bordeaux,2018,06/07/2021,10127812018,1012781
1080,05/07/2021,1214,51,950,130,264,03/05/2021,"Chateau Calon Segur 3eme Cru Classe, Saint-Estephe",Bordeaux,2018,06/07/2021,10074752018,1007475
857,30/06/2021,995,128,848,9,147,02/07/2021,"Tignanello, Toscana",Tuscany,2017,06/07/2021,10953912017,1095391
8000,05/07/2021,8299,4,7330,670,969,02/06/2021,"Domaine Leflaive, Chevalier-Montrachet Grand Cru",Burgundy,2018,06/07/2021,10734012018,1073401
1000,05/07/2021,1003,71,910,90,93,03/07/2021,"Tignanello, Toscana",Tuscany,2018,06/07/2021,10953912018,1095391
476,19/07/2021,526,37,364,112,162,12/05/2021,"Chateau Batailley 5eme Cru Classe, Pauillac",Bordeaux,2016,20/07/2021,10063222016,1006322
920,05/07/2021,1104,25,842,78,262,22/08/2020,"Chateau Calon Segur 3eme Cru Classe, Saint-Estephe",Bordeaux,2019,06/07/2021,10074752019,1007475
5290,05/07/2021,5211,7,4160,1130,1051,19/03/2021,"Chateau Margaux Premier Cru Classe, Margaux",Bordeaux,2019,06/07/2021,10127812019,1012781
1516,29/06/2021,1644,60,1398,118,246,01/07/2021,"Gaja, Barbaresco",Piedmont,2017,06/07/2021,10996052017,1099605
750,05/07/2021,989,35,790,-40,199,01/06/2020,"Chateau Calon Segur 3eme Cru Classe, Saint-Estephe",Bordeaux,2011,06/07/2021,10074752011,1007475
1024,05/07/2021,1255,4,1072,-48,183,20/01/2021,"Tignanello, Toscana",Tuscany,2009,06/07/2021,10953912009,1095391
1326,05/07/2021,1560,4,1170,156,390,24/06/2021,"Tignanello, Toscana",Tuscany,2010,06/07/2021,10953912010,1095391
3758,05/07/2021,4290,78,3690,68,600,13/04/2021,"Chateau Margaux Premier Cru Classe, Margaux",Bordeaux,2011,06/07/2021,10127812011,1012781
2380,23/07/2021,2590,137,2178,202,412,19/04/2021,"Chateau Angelus Premier Grand Cru Classe A, Saint-Emilion Grand Cru",Bordeaux,2014,24/07/2021,10060452014,1006045
820,05/07/2021,937,6,735,85,202,09/09/2020,"Chateau Calon Segur 3eme Cru Classe, Saint-Estephe",Bordeaux,2012,06/07/2021,10074752012,1007475
450,20/07/2021,532,2,300,150,232,15/12/2019,"Chateau Batailley 5eme Cru Classe, Pauillac",Bordeaux,2004,21/07/2021,10063222004,1006322
2380,23/07/2021,2590,137,2178,202,412,19/04/2021,"Chateau Angelus Premier Grand Cru Classe A, Saint-Emilion Grand Cru",Bordeaux,2014,24/07/2021,10060452014,1006045
3750,05/07/2021,4178,41,3560,190,618,20/11/2020,"Chateau Margaux Premier Cru Classe, Margaux",Bordeaux,2012,06/07/2021,10127812012,1012781
3740,05/07/2021,4000,49,3520,220,480,07/04/2021,"Chateau Margaux Premier Cru Classe, Margaux",Bordeaux,2013,06/07/2021,10127812013,1012781
2380,21/07/2021,2594,143,2178,202,416,19/04/2021,"Chateau Angelus Premier Grand Cru Classe A, Saint-Emilion Grand Cru",Bordeaux,2014,22/07/2021,10060452014,1006045
686,05/07/2021,809,7,682,4,127,15/09/2020,"Chateau Calon Segur 3eme Cru Classe, Saint-Estephe",Bordeaux,2013,06/07/2021,10074752013,1007475
960,05/07/2021,1256,12,850,110,406,28/01/2021,"Tignanello, Toscana",Tuscany,2012,06/07/2021,10953912012,1095391
2380,21/07/2021,2594,143,2178,202,416,19/04/2021,"Chateau Angelus Premier Grand Cru Classe A, Saint-Emilion Grand Cru",Bordeaux,2014,22/07/2021,10060452014,1006045
3720,05/07/2021,4324,123,3480,240,844,17/06/2021,"Chateau Margaux Premier Cru Classe, Margaux",Bordeaux,2014,06/07/2021,10127812014,1012781
1090,05/07/2021,1159,7,860,230,299,08/03/2021,"Tignanello, Toscana",Tuscany,2013,06/07/2021,10953912013,1095391
984,05/07/2021,1104,42,830,154,274,22/06/2021,"Tignanello, Toscana",Tuscany,2014,06/07/2021,10953912014,1095391
850,05/07/2021,1084,81,822,28,262,28/06/2021,"Chateau Calon Segur 3eme Cru Classe, Saint-Estephe",Bordeaux,2015,06/07/2021,10074752015,1007475
10400,05/07/2021,11872,49,9800,600,2072,11/06/2021,"Chateau Margaux Premier Cru Classe, Margaux",Bordeaux,2015,06/07/2021,10127812015,1012781
870,06/07/2021,966,5,705,165,261,01/02/2021,"Chateau Calon Segur 3eme Cru Classe, Saint-Estephe",Bordeaux,2002,07/07/2021,10074752002,1007475
3826,06/07/2021,4507,54,4116,-290,391,25/02/2021,"Chateau Margaux Premier Cru Classe, Margaux",Bordeaux,2004,07/07/2021,10127812004,1012781
4450,06/07/2021,4717,21,4400,50,317,29/09/2020,"Chateau Margaux Premier Cru Classe, Margaux",Bordeaux,2001,07/07/2021,10127812001,1012781
2350,19/07/2021,2594,143,2178,172,416,19/04/2021,"Chateau Angelus Premier Grand Cru Classe A, Saint-Emilion Grand Cru",Bordeaux,2014,20/07/2021,10060452014,1006045
800,06/07/2021,922,18,745,55,177,16/11/2020,"Chateau Calon Segur 3eme Cru Classe, Saint-Estephe",Bordeaux,2004,07/07/2021,10074752004,1007475
2350,19/07/2021,2594,143,2178,172,416,19/04/2021,"Chateau Angelus Premier Grand Cru Classe A, Saint-Emilion Grand Cru",Bordeaux,2014,20/07/2021,10060452014,1006045
1040,07/07/2021,1205,22,940,100,265,18/03/2021,"Chateau Calon Segur 3eme Cru Classe, Saint-Estephe",Bordeaux,2000,09/07/2021,10074752000,1007475
870,08/07/2021,966,5,705,165,261,01/02/2021,"Chateau Calon Segur 3eme Cru Classe, Saint-Estephe",Bordeaux,2002,09/07/2021,10074752002,1007475
8200,08/07/2021,9039,12,8100,100,939,21/06/2021,"Chateau Margaux Premier Cru Classe, Margaux",Bordeaux,2000,09/07/2021,10127812000,1012781
2350,16/07/2021,2597,146,2178,172,419,19/04/2021,"Chateau Angelus Premier Grand Cru Classe A, Saint-Emilion Grand Cru",Bordeaux,2014,17/07/2021,10060452014,1006045
4450,08/07/2021,4802,23,4400,50,402,29/09/2020,"Chateau Margaux Premier Cru Classe, Margaux",Bordeaux,2001,09/07/2021,10127812001,1012781
3900,07/07/2021,4425,22,3684,216,741,10/06/2020,"Chateau Margaux Premier Cru Classe, Margaux",Bordeaux,2002,09/07/2021,10127812002,1012781
3826,08/07/2021,4554,50,4116,-290,438,25/02/2021,"Chateau Margaux Premier Cru Classe, Margaux",Bordeaux,2004,09/07/2021,10127812004,1012781
4850,02/07/2021,6067,24,4650,200,1417,21/06/2021,"Chateau Margaux Premier Cru Classe, Margaux",Bordeaux,2003,09/07/2021,10127812003,1012781
2350,16/07/2021,2597,146,2178,172,419,19/04/2021,"Chateau Angelus Premier Grand Cru Classe A, Saint-Emilion Grand Cru",Bordeaux,2014,17/07/2021,10060452014,1006045
2350,14/07/2021,2599,146,2178,172,421,19/04/2021,"Chateau Angelus Premier Grand Cru Classe A, Saint-Emilion Grand Cru",Bordeaux,2014,15/07/2021,10060452014,1006045
980,07/07/2021,922,18,745,235,177,16/11/2020,"Chateau Calon Segur 3eme Cru Classe, Saint-Estephe",Bordeaux,2004,09/07/2021,10074752004,1007475
2350,14/07/2021,2599,146,2178,172,421,19/04/2021,"Chateau Angelus Premier Grand Cru Classe A, Saint-Emilion Grand Cru",Bordeaux,2014,15/07/2021,10060452014,1006045
907,07/07/2021,926,18,805,102,121,20/11/2019,"Chateau Calon Segur 3eme Cru Classe, Saint-Estephe",Bordeaux,2001,09/07/2021,10074752001,1007475
2350,14/07/2021,2597,146,2178,172,419,19/04/2021,"Chateau Angelus Premier Grand Cru Classe A, Saint-Emilion Grand Cru",Bordeaux,2014,16/07/2021,10060452014,1006045
6400,08/07/2021,7254,26,6776,-376,478,10/06/2021,"Chateau Margaux Premier Cru Classe, Margaux",Bordeaux,2005,09/07/2021,10127812005,1012781
2350,14/07/2021,2597,146,2178,172,419,19/04/2021,"Chateau Angelus Premier Grand Cru Classe A, Saint-Emilion Grand Cru",Bordeaux,2014,16/07/2021,10060452014,1006045
1000,07/07/2021,1167,80,988,12,179,28/05/2021,"Chateau Calon Segur 3eme Cru Classe, Saint-Estephe",Bordeaux,2005,09/07/2021,10074752005,1007475
870,06/07/2021,966,5,705,165,261,01/02/2021,"Chateau Calon Segur 3eme Cru Classe, Saint-Estephe",Bordeaux,2002,07/07/2021,10074752002,1007475
4450,06/07/2021,4717,21,4400,50,317,29/09/2020,"Chateau Margaux Premier Cru Classe, Margaux",Bordeaux,2001,07/07/2021,10127812001,1012781
3826,06/07/2021,4507,54,4116,-290,391,25/02/2021,"Chateau Margaux Premier Cru Classe, Margaux",Bordeaux,2004,07/07/2021,10127812004,1012781
2350,12/07/2021,2599,146,2178,172,421,19/04/2021,"Chateau Angelus Premier Grand Cru Classe A, Saint-Emilion Grand Cru",Bordeaux,2014,13/07/2021,10060452014,1006045
800,06/07/2021,922,18,745,55,177,16/11/2020,"Chateau Calon Segur 3eme Cru Classe, Saint-Estephe",Bordeaux,2004,07/07/2021,10074752004,1007475
2350,12/07/2021,2599,146,2178,172,421,19/04/2021,"Chateau Angelus Premier Grand Cru Classe A, Saint-Emilion Grand Cru",Bordeaux,2014,13/07/2021,10060452014,1006045
6400,06/07/2021,7276,24,6776,-376,500,10/06/2021,"Chateau Margaux Premier Cru Classe, Margaux",Bordeaux,2005,07/07/2021,10127812005,1012781
2350,09/07/2021,2597,144,2178,172,419,19/04/2021,"Chateau Angelus Premier Grand Cru Classe A, Saint-Emilion Grand Cru",Bordeaux,2014,10/07/2021,10060452014,1006045
589,20/07/2021,622,49,520,69,102,17/06/2021,"Chateau Batailley 5eme Cru Classe, Pauillac",Bordeaux,2005,21/07/2021,10063222005,1006322
895,06/07/2021,926,42,863,32,63,10/05/2021,"Chateau Calon Segur 3eme Cru Classe, Saint-Estephe",Bordeaux,2006,07/07/2021,10074752006,1007475
3900,06/07/2021,4655,88,3822,78,833,20/06/2021,"Chateau Margaux Premier Cru Classe, Margaux",Bordeaux,2006,07/07/2021,10127812006,1012781
2350,09/07/2021,2597,144,2178,172,419,19/04/2021,"Chateau Angelus Premier Grand Cru Classe A, Saint-Emilion Grand Cru",Bordeaux,2014,10/07/2021,10060452014,1006045
3900,06/07/2021,4291,82,3750,150,541,28/06/2021,"Chateau Margaux Premier Cru Classe, Margaux",Bordeaux,2008,07/07/2021,10127812008,1012781
975,06/07/2021,1230,49,1026,-51,204,24/06/2021,"Chateau Calon Segur 3eme Cru Classe, Saint-Estephe",Bordeaux,2009,07/07/2021,10074752009,1007475
589,20/07/2021,622,49,520,69,102,17/06/2021,"Chateau Batailley 5eme Cru Classe, Pauillac",Bordeaux,2005,21/07/2021,10063222005,1006322
1850,06/07/2021,1831,1,1180,670,651,10/03/2017,"Gaja, Barbaresco",Piedmont,2005,07/07/2021,10996052005,1099605
1408,06/07/2021,1605,2,1150,258,455,21/04/2019,"Tignanello, Toscana",Tuscany,2005,07/07/2021,10953912005,1095391
2500,06/07/2021,2632,3,2220,280,412,14/06/2021,"Gaja, Barbaresco",Piedmont,2001,07/07/2021,10996052001,1099605
2098,06/07/2021,2366,3,2190,-92,176,01/05/2021,"Gaja, Barbaresco",Piedmont,2004,07/07/2021,10996052004,1099605
520,06/07/2021,563,3,460,60,103,05/05/2020,"Tua Rita, Giusto di Notri, Toscana",Tuscany,2008,07/07/2021,11058072008,1105807
660,06/07/2021,727,5,390,270,337,18/08/2017,"Tua Rita, Giusto di Notri, Toscana",Tuscany,2006,07/07/2021,11058072006,1105807
1678,06/07/2021,1683,4,1420,258,263,29/06/2021,"Tignanello, Toscana",Tuscany,2004,07/07/2021,10953912004,1095391
1299,06/07/2021,1579,7,1010,289,569,18/12/2020,"Tignanello, Toscana",Tuscany,2008,07/07/2021,10953912008,1095391
1245,06/07/2021,1615,2,882,363,733,26/04/2019,"Tignanello, Toscana",Tuscany,2003,07/07/2021,10953912003,1095391
1408,06/07/2021,1389,4,1238,170,151,02/11/2020,"Tignanello, Toscana",Tuscany,2006,07/07/2021,10953912006,1095391
1408,06/07/2021,1410,1,996,412,414,14/06/2019,"Tignanello, Toscana",Tuscany,2000,07/07/2021,10953912000,1095391
6400,06/07/2021,7579,50,5950,450,1629,23/06/2021,"Chateau Margaux Premier Cru Classe, Margaux",Bordeaux,2010,07/07/2021,10127812010,1012781
990,06/07/2021,1134,16,990,0,144,16/06/2021,"Chateau Calon Segur 3eme Cru Classe, Saint-Estephe",Bordeaux,2010,07/07/2021,10074752010,1007475
8400,06/07/2021,8400,1,5960,2440,2440,01/08/2017,"Domaine Leflaive, Chevalier-Montrachet Grand Cru",Burgundy,2010,07/07/2021,10734012010,1073401
3758,06/07/2021,4290,78,3690,68,600,13/04/2021,"Chateau Margaux Premier Cru Classe, Margaux",Bordeaux,2011,07/07/2021,10127812011,1012781
2350,07/07/2021,2597,145,2178,172,419,19/04/2021,"Chateau Angelus Premier Grand Cru Classe A, Saint-Emilion Grand Cru",Bordeaux,2014,08/07/2021,10060452014,1006045
960,30/06/2021,1074,8,880,80,194,22/06/2021,"Tignanello, Toscana",Tuscany,2011,07/07/2021,10953912011,1095391
2350,07/07/2021,2597,145,2178,172,419,19/04/2021,"Chateau Angelus Premier Grand Cru Classe A, Saint-Emilion Grand Cru",Bordeaux,2014,08/07/2021,10060452014,1006045
510,20/07/2021,595,401,494,16,101,20/04/2021,"Chateau Batailley 5eme Cru Classe, Pauillac",Bordeaux,2010,21/07/2021,10063222010,1006322
820,06/07/2021,937,6,735,85,202,09/09/2020,"Chateau Calon Segur 3eme Cru Classe, Saint-Estephe",Bordeaux,2012,07/07/2021,10074752012,1007475
13200,06/07/2021,12867,1,12850,350,17,30/11/2020,"Jacques-Frederic Mugnier, Chambolle-Musigny Premier Cru, Les Amoureuses",Burgundy,2011,07/07/2021,10496422011,1049642
3740,06/07/2021,4000,49,3520,220,480,07/04/2021,"Chateau Margaux Premier Cru Classe, Margaux",Bordeaux,2013,07/07/2021,10127812013,1012781
2350,07/07/2021,2597,144,2178,172,419,19/04/2021,"Chateau Angelus Premier Grand Cru Classe A, Saint-Emilion Grand Cru",Bordeaux,2014,09/07/2021,10060452014,1006045
510,20/07/2021,595,401,494,16,101,20/04/2021,"Chateau Batailley 5eme Cru Classe, Pauillac",Bordeaux,2010,21/07/2021,10063222010,1006322
686,06/07/2021,809,7,682,4,127,15/09/2020,"Chateau Calon Segur 3eme Cru Classe, Saint-Estephe",Bordeaux,2013,07/07/2021,10074752013,1007475
960,05/07/2021,1285,11,850,110,435,28/01/2021,"Tignanello, Toscana",Tuscany,2012,07/07/2021,10953912012,1095391
3800,06/07/2021,4324,122,3480,320,844,17/06/2021,"Chateau Margaux Premier Cru Classe, Margaux",Bordeaux,2014,07/07/2021,10127812014,1012781
790,02/07/2021,903,21,801,-11,102,31/05/2021,"Chateau Calon Segur 3eme Cru Classe, Saint-Estephe",Bordeaux,2014,07/07/2021,10074752014,1007475
400,20/07/2021,423,6,408,-8,15,14/07/2021,"Chateau Batailley 5eme Cru Classe, Pauillac",Bordeaux,2012,21/07/2021,10063222012,1006322
1550,06/07/2021,1557,1,1300,250,257,27/04/2021,"Gaja, Barbaresco",Piedmont,2012,07/07/2021,10996052012,1099605
1090,05/07/2021,1154,6,860,230,294,08/03/2021,"Tignanello, Toscana",Tuscany,2013,07/07/2021,10953912013,1095391
984,06/07/2021,1104,42,830,154,274,22/06/2021,"Tignanello, Toscana",Tuscany,2014,07/07/2021,10953912014,1095391
1400,06/07/2021,1527,14,1300,100,227,30/06/2021,"Gaja, Barbaresco",Piedmont,2013,07/07/2021,10996052013,1099605
900,06/07/2021,1082,82,822,78,260,28/06/2021,"Chateau Calon Segur 3eme Cru Classe, Saint-Estephe",Bordeaux,2015,07/07/2021,10074752015,1007475
10400,06/07/2021,11872,49,9800,600,2072,11/06/2021,"Chateau Margaux Premier Cru Classe, Margaux",Bordeaux,2015,07/07/2021,10127812015,1012781
14520,06/07/2021,14520,1,12000,2520,2520,28/05/2020,"Jacques-Frederic Mugnier, Chambolle-Musigny Premier Cru, Les Amoureuses",Burgundy,2014,07/07/2021,10496422014,1049642
5415,05/07/2021,5824,122,5500,-85,324,06/07/2021,"Chateau Margaux Premier Cru Classe, Margaux",Bordeaux,2016,07/07/2021,10127812016,1012781
1100,06/07/2021,1219,78,1036,64,183,27/05/2021,"Chateau Calon Segur 3eme Cru Classe, Saint-Estephe",Bordeaux,2016,07/07/2021,10074752016,1007475
2350,07/07/2021,2597,144,2178,172,419,19/04/2021,"Chateau Angelus Premier Grand Cru Classe A, Saint-Emilion Grand Cru",Bordeaux,2014,09/07/2021,10060452014,1006045
400,20/07/2021,423,6,408,-8,15,14/07/2021,"Chateau Batailley 5eme Cru Classe, Pauillac",Bordeaux,2012,21/07/2021,10063222012,1006322
1238,05/07/2021,1289,64,1144,94,145,06/07/2021,"Tignanello, Toscana",Tuscany,2016,07/07/2021,10953912016,1095391
7906,06/07/2021,7792,2,7124,782,668,15/02/2019,"Domaine Leflaive, Chevalier-Montrachet Grand Cru",Burgundy,2016,07/07/2021,10734012016,1073401
2350,05/07/2021,2597,145,2178,172,419,19/04/2021,"Chateau Angelus Premier Grand Cru Classe A, Saint-Emilion Grand Cru",Bordeaux,2014,06/07/2021,10060452014,1006045
780,06/07/2021,929,102,740,40,189,21/05/2021,"Chateau Calon Segur 3eme Cru Classe, Saint-Estephe",Bordeaux,2017,07/07/2021,10074752017,1007475
3790,05/07/2021,4271,102,3950,-160,321,30/06/2021,"Chateau Margaux Premier Cru Classe, Margaux",Bordeaux,2017,07/07/2021,10127812017,1012781
460,06/07/2021,488,157,420,40,68,28/05/2021,"Tua Rita, Giusto di Notri, Toscana",Tuscany,2016,07/07/2021,11058072016,1105807
8000,06/07/2021,8684,5,6974,1026,1710,14/03/2021,"Domaine Leflaive, Chevalier-Montrachet Grand Cru",Burgundy,2017,07/07/2021,10734012017,1073401
2350,05/07/2021,2597,145,2178,172,419,19/04/2021,"Chateau Angelus Premier Grand Cru Classe A, Saint-Emilion Grand Cru",Bordeaux,2014,06/07/2021,10060452014,1006045
5600,05/07/2021,5853,100,5254,346,599,26/05/2021,"Chateau Margaux Premier Cru Classe, Margaux",Bordeaux,2018,07/07/2021,10127812018,1012781
1080,06/07/2021,1214,51,950,130,264,03/05/2021,"Chateau Calon Segur 3eme Cru Classe, Saint-Estephe",Bordeaux,2018,07/07/2021,10074752018,1007475
857,30/06/2021,1005,122,848,9,157,02/07/2021,"Tignanello, Toscana",Tuscany,2017,07/07/2021,10953912017,1095391
8000,06/07/2021,8299,4,7330,670,969,02/06/2021,"Domaine Leflaive, Chevalier-Montrachet Grand Cru",Burgundy,2018,07/07/2021,10734012018,1073401
1000,06/07/2021,1001,76,936,64,65,06/07/2021,"Tignanello, Toscana",Tuscany,2018,07/07/2021,10953912018,1095391
2350,02/07/2021,2597,146,2178,172,419,19/04/2021,"Chateau Angelus Premier Grand Cru Classe A, Saint-Emilion Grand Cru",Bordeaux,2014,05/07/2021,10060452014,1006045
320,20/07/2021,320,109,304,16,16,10/01/2021,"Chateau Batailley 5eme Cru Classe, Pauillac",Bordeaux,2013,21/07/2021,10063222013,1006322
920,06/07/2021,1038,36,842,78,196,22/08/2020,"Chateau Calon Segur 3eme Cru Classe, Saint-Estephe",Bordeaux,2019,07/07/2021,10074752019,1007475
1516,06/07/2021,1644,60,1398,118,246,01/07/2021,"Gaja, Barbaresco",Piedmont,2017,07/07/2021,10996052017,1099605
895,08/07/2021,921,39,863,32,58,10/05/2021,"Chateau Calon Segur 3eme Cru Classe, Saint-Estephe",Bordeaux,2006,09/07/2021,10074752006,1007475
3900,08/07/2021,4710,80,3822,78,888,20/06/2021,"Chateau Margaux Premier Cru Classe, Margaux",Bordeaux,2006,09/07/2021,10127812006,1012781
3560,07/07/2021,4237,83,3525,35,712,18/06/2021,"Chateau Margaux Premier Cru Classe, Margaux",Bordeaux,2007,09/07/2021,10127812007,1012781
880,08/07/2021,980,7,725,155,255,13/04/2021,"Chateau Calon Segur 3eme Cru Classe, Saint-Estephe",Bordeaux,2007,09/07/2021,10074752007,1007475
2350,02/07/2021,2625,196,2178,172,447,19/04/2021,"Chateau Angelus Premier Grand Cru Classe A, Saint-Emilion Grand Cru",Bordeaux,2014,03/07/2021,10060452014,1006045
3900,08/07/2021,4354,63,3750,150,604,28/06/2021,"Chateau Margaux Premier Cru Classe, Margaux",Bordeaux,2008,09/07/2021,10127812008,1012781
895,08/07/2021,978,10,781,114,197,16/11/2020,"Chateau Calon Segur 3eme Cru Classe, Saint-Estephe",Bordeaux,2008,09/07/2021,10074752008,1007475
6830,07/07/2021,7778,43,7086,-256,692,11/06/2021,"Chateau Margaux Premier Cru Classe, Margaux",Bordeaux,2009,09/07/2021,10127812009,1012781
1000,07/07/2021,1238,51,1026,-26,212,24/06/2021,"Chateau Calon Segur 3eme Cru Classe, Saint-Estephe",Bordeaux,2009,09/07/2021,10074752009,1007475
2350,02/07/2021,2625,196,2178,172,447,19/04/2021,"Chateau Angelus Premier Grand Cru Classe A, Saint-Emilion Grand Cru",Bordeaux,2014,03/07/2021,10060452014,1006045
2500,08/07/2021,2632,3,2220,280,412,14/06/2021,"Gaja, Barbaresco",Piedmont,2001,09/07/2021,10996052001,1099605
2098,08/07/2021,2366,3,2190,-92,176,01/05/2021,"Gaja, Barbaresco",Piedmont,2004,09/07/2021,10996052004,1099605
1592,08/07/2021,1754,6,1378,214,376,29/07/2020,"Tignanello, Toscana",Tuscany,2001,09/07/2021,10953912001,1095391
1248,08/07/2021,1323,5,1238,10,85,02/11/2020,"Tignanello, Toscana",Tuscany,2006,09/07/2021,10953912006,1095391
1300,08/07/2021,1385,2,1200,100,185,06/03/2021,"Tignanello, Toscana",Tuscany,2007,09/07/2021,10953912007,1095391
6400,08/07/2021,7647,43,6190,210,1457,08/07/2021,"Chateau Margaux Premier Cru Classe, Margaux",Bordeaux,2010,09/07/2021,10127812010,1012781
360,20/07/2021,370,71,360,0,10,14/07/2021,"Chateau Batailley 5eme Cru Classe, Pauillac",Bordeaux,2014,21/07/2021,10063222014,1006322
990,08/07/2021,1134,16,990,0,144,16/06/2021,"Chateau Calon Segur 3eme Cru Classe, Saint-Estephe",Bordeaux,2010,09/07/2021,10074752010,1007475
1024,07/07/2021,1307,3,1072,-48,235,20/01/2021,"Tignanello, Toscana",Tuscany,2009,09/07/2021,10953912009,1095391
3600,07/07/2021,4345,69,3690,-90,655,13/04/2021,"Chateau Margaux Premier Cru Classe, Margaux",Bordeaux,2011,09/07/2021,10127812011,1012781
2350,02/07/2021,2597,146,2178,172,419,19/04/2021,"Chateau Angelus Premier Grand Cru Classe A, Saint-Emilion Grand Cru",Bordeaux,2014,05/07/2021,10060452014,1006045
975,06/07/2021,1230,49,1026,-51,204,24/06/2021,"Chateau Calon Segur 3eme Cru Classe, Saint-Estephe",Bordeaux,2009,07/07/2021,10074752009,1007475
503,20/07/2021,589,6,312,191,277,12/03/2021,"Chateau Batailley 5eme Cru Classe, Pauillac",Bordeaux,2015,31/07/2021,10063222015,1006322
1408,06/07/2021,1605,2,1150,258,455,21/04/2019,"Tignanello, Toscana",Tuscany,2005,07/07/2021,10953912005,1095391
2500,06/07/2021,2632,3,2220,280,412,14/06/2021,"Gaja, Barbaresco",Piedmont,2001,07/07/2021,10996052001,1099605
2098,06/07/2021,2366,3,2190,-92,176,01/05/2021,"Gaja, Barbaresco",Piedmont,2004,07/07/2021,10996052004,1099605
1299,06/07/2021,1579,7,1010,289,569,18/12/2020,"Tignanello, Toscana",Tuscany,2008,07/07/2021,10953912008,1095391
1245,06/07/2021,1615,2,882,363,733,26/04/2019,"Tignanello, Toscana",Tuscany,2003,07/07/2021,10953912003,1095391
1408,06/07/2021,1389,4,1238,170,151,02/11/2020,"Tignanello, Toscana",Tuscany,2006,07/07/2021,10953912006,1095391
1678,06/07/2021,1683,4,1420,258,263,29/06/2021,"Tignanello, Toscana",Tuscany,2004,07/07/2021,10953912004,1095391
1408,06/07/2021,1410,1,996,412,414,14/06/2019,"Tignanello, Toscana",Tuscany,2000,07/07/2021,10953912000,1095391
6400,06/07/2021,7579,50,5950,450,1629,23/06/2021,"Chateau Margaux Premier Cru Classe, Margaux",Bordeaux,2010,07/07/2021,10127812010,1012781
990,06/07/2021,1134,16,990,0,144,16/06/2021,"Chateau Calon Segur 3eme Cru Classe, Saint-Estephe",Bordeaux,2010,07/07/2021,10074752010,1007475
3758,06/07/2021,4290,78,3690,68,600,13/04/2021,"Chateau Margaux Premier Cru Classe, Margaux",Bordeaux,2011,07/07/2021,10127812011,1012781
2350,30/06/2021,2622,199,2178,172,444,19/04/2021,"Chateau Angelus Premier Grand Cru Classe A, Saint-Emilion Grand Cru",Bordeaux,2014,01/07/2021,10060452014,1006045
960,30/06/2021,1074,8,880,80,194,22/06/2021,"Tignanello, Toscana",Tuscany,2011,07/07/2021,10953912011,1095391
2350,30/06/2021,2622,199,2178,172,444,19/04/2021,"Chateau Angelus Premier Grand Cru Classe A, Saint-Emilion Grand Cru",Bordeaux,2014,01/07/2021,10060452014,1006045
503,20/07/2021,539,30,312,191,227,12/03/2021,"Chateau Batailley 5eme Cru Classe, Pauillac",Bordeaux,2015,29/07/2021,10063222015,1006322
820,06/07/2021,937,6,735,85,202,09/09/2020,"Chateau Calon Segur 3eme Cru Classe, Saint-Estephe",Bordeaux,2012,07/07/2021,10074752012,1007475
3740,06/07/2021,4000,49,3520,220,480,07/04/2021,"Chateau Margaux Premier Cru Classe, Margaux",Bordeaux,2013,07/07/2021,10127812013,1012781
2350,28/06/2021,2622,199,2178,172,444,19/04/2021,"Chateau Angelus Premier Grand Cru Classe A, Saint-Emilion Grand Cru",Bordeaux,2014,29/06/2021,10060452014,1006045
686,06/07/2021,809,7,682,4,127,15/09/2020,"Chateau Calon Segur 3eme Cru Classe, Saint-Estephe",Bordeaux,2013,07/07/2021,10074752013,1007475
960,05/07/2021,1285,11,850,110,435,28/01/2021,"Tignanello, Toscana",Tuscany,2012,07/07/2021,10953912012,1095391
3800,06/07/2021,4324,122,3480,320,844,17/06/2021,"Chateau Margaux Premier Cru Classe, Margaux",Bordeaux,2014,07/07/2021,10127812014,1012781
790,02/07/2021,903,21,801,-11,102,31/05/2021,"Chateau Calon Segur 3eme Cru Classe, Saint-Estephe",Bordeaux,2014,07/07/2021,10074752014,1007475
1090,05/07/2021,1154,6,860,230,294,08/03/2021,"Tignanello, Toscana",Tuscany,2013,07/07/2021,10953912013,1095391
984,06/07/2021,1104,42,830,154,274,22/06/2021,"Tignanello, Toscana",Tuscany,2014,07/07/2021,10953912014,1095391
900,06/07/2021,1082,82,822,78,260,28/06/2021,"Chateau Calon Segur 3eme Cru Classe, Saint-Estephe",Bordeaux,2015,07/07/2021,10074752015,1007475
10400,06/07/2021,11872,49,9800,600,2072,11/06/2021,"Chateau Margaux Premier Cru Classe, Margaux",Bordeaux,2015,07/07/2021,10127812015,1012781
1040,07/07/2021,1204,24,940,100,264,18/03/2021,"Chateau Calon Segur 3eme Cru Classe, Saint-Estephe",Bordeaux,2000,08/07/2021,10074752000,1007475
870,07/07/2021,966,5,705,165,261,01/02/2021,"Chateau Calon Segur 3eme Cru Classe, Saint-Estephe",Bordeaux,2002,08/07/2021,10074752002,1007475
8200,07/07/2021,9044,12,8100,100,944,21/06/2021,"Chateau Margaux Premier Cru Classe, Margaux",Bordeaux,2000,08/07/2021,10127812000,1012781
900,07/07/2021,1156,20,800,100,356,21/11/2019,"Chateau Calon Segur 3eme Cru Classe, Saint-Estephe",Bordeaux,2003,08/07/2021,10074752003,1007475
4450,07/07/2021,4727,20,4400,50,327,29/09/2020,"Chateau Margaux Premier Cru Classe, Margaux",Bordeaux,2001,08/07/2021,10127812001,1012781
3900,07/07/2021,4466,26,3684,216,782,10/06/2020,"Chateau Margaux Premier Cru Classe, Margaux",Bordeaux,2002,08/07/2021,10127812002,1012781
3826,07/07/2021,4490,60,4116,-290,374,25/02/2021,"Chateau Margaux Premier Cru Classe, Margaux",Bordeaux,2004,08/07/2021,10127812004,1012781
820,08/07/2021,937,6,735,85,202,09/09/2020,"Chateau Calon Segur 3eme Cru Classe, Saint-Estephe",Bordeaux,2012,09/07/2021,10074752012,1007475
2350,28/06/2021,2622,199,2178,172,444,19/04/2021,"Chateau Angelus Premier Grand Cru Classe A, Saint-Emilion Grand Cru",Bordeaux,2014,29/06/2021,10060452014,1006045
503,20/07/2021,534,30,312,191,222,12/03/2021,"Chateau Batailley 5eme Cru Classe, Pauillac",Bordeaux,2015,21/07/2021,10063222015,1006322
3750,05/07/2021,4282,40,3560,190,722,20/11/2020,"Chateau Margaux Premier Cru Classe, Margaux",Bordeaux,2012,09/07/2021,10127812012,1012781
3740,08/07/2021,4070,26,3520,220,550,07/04/2021,"Chateau Margaux Premier Cru Classe, Margaux",Bordeaux,2013,09/07/2021,10127812013,1012781
2350,23/06/2021,2622,202,2178,172,444,19/04/2021,"Chateau Angelus Premier Grand Cru Classe A, Saint-Emilion Grand Cru",Bordeaux,2014,24/06/2021,10060452014,1006045
686,08/07/2021,809,7,682,4,127,15/09/2020,"Chateau Calon Segur 3eme Cru Classe, Saint-Estephe",Bordeaux,2013,09/07/2021,10074752013,1007475
2350,23/06/2021,2622,202,2178,172,444,19/04/2021,"Chateau Angelus Premier Grand Cru Classe A, Saint-Emilion Grand Cru",Bordeaux,2014,24/06/2021,10060452014,1006045
2350,23/06/2021,2623,199,2178,172,445,19/04/2021,"Chateau Angelus Premier Grand Cru Classe A, Saint-Emilion Grand Cru",Bordeaux,2014,25/06/2021,10060452014,1006045
2350,23/06/2021,2623,199,2178,172,445,19/04/2021,"Chateau Angelus Premier Grand Cru Classe A, Saint-Emilion Grand Cru",Bordeaux,2014,25/06/2021,10060452014,1006045
907,07/07/2021,924,18,805,102,119,20/11/2019,"Chateau Calon Segur 3eme Cru Classe, Saint-Estephe",Bordeaux,2001,08/07/2021,10074752001,1007475
503,20/07/2021,538,30,312,191,226,12/03/2021,"Chateau Batailley 5eme Cru Classe, Pauillac",Bordeaux,2015,30/07/2021,10063222015,1006322
2350,21/06/2021,2622,202,2178,172,444,19/04/2021,"Chateau Angelus Premier Grand Cru Classe A, Saint-Emilion Grand Cru",Bordeaux,2014,23/06/2021,10060452014,1006045
503,20/07/2021,581,5,312,191,269,12/03/2021,"Chateau Batailley 5eme Cru Classe, Pauillac",Bordeaux,2015,02/08/2021,10063222015,1006322
6400,06/07/2021,7359,31,6776,-376,583,10/06/2021,"Chateau Margaux Premier Cru Classe, Margaux",Bordeaux,2005,08/07/2021,10127812005,1012781
1000,07/07/2021,1160,87,988,12,172,28/05/2021,"Chateau Calon Segur 3eme Cru Classe, Saint-Estephe",Bordeaux,2005,08/07/2021,10074752005,1007475
476,20/07/2021,526,37,364,112,162,12/05/2021,"Chateau Batailley 5eme Cru Classe, Pauillac",Bordeaux,2016,21/07/2021,10063222016,1006322
895,07/07/2021,926,42,863,32,63,10/05/2021,"Chateau Calon Segur 3eme Cru Classe, Saint-Estephe",Bordeaux,2006,08/07/2021,10074752006,1007475
3900,07/07/2021,4642,92,3822,78,820,20/06/2021,"Chateau Margaux Premier Cru Classe, Margaux",Bordeaux,2006,08/07/2021,10127812006,1012781
2350,21/06/2021,2622,202,2178,172,444,19/04/2021,"Chateau Angelus Premier Grand Cru Classe A, Saint-Emilion Grand Cru",Bordeaux,2014,23/06/2021,10060452014,1006045
685,21/07/2021,1033,3,470,215,563,29/03/2018,"Chateau Batailley 5eme Cru Classe, Pauillac",Bordeaux,2000,22/07/2021,10063222000,1006322
3560,07/07/2021,4191,39,3525,35,666,18/06/2021,"Chateau Margaux Premier Cru Classe, Margaux",Bordeaux,2007,08/07/2021,10127812007,1012781
880,07/07/2021,967,9,725,155,242,13/04/2021,"Chateau Calon Segur 3eme Cru Classe, Saint-Estephe",Bordeaux,2007,08/07/2021,10074752007,1007475
2350,21/06/2021,2599,182,2178,172,421,19/04/2021,"Chateau Angelus Premier Grand Cru Classe A, Saint-Emilion Grand Cru",Bordeaux,2014,22/06/2021,10060452014,1006045
2350,21/06/2021,2599,182,2178,172,421,19/04/2021,"Chateau Angelus Premier Grand Cru Classe A, Saint-Emilion Grand Cru",Bordeaux,2014,22/06/2021,10060452014,1006045
3900,07/07/2021,4319,83,3750,150,569,28/06/2021,"Chateau Margaux Premier Cru Classe, Margaux",Bordeaux,2008,08/07/2021,10127812008,1012781
895,07/07/2021,978,10,781,114,197,16/11/2020,"Chateau Calon Segur 3eme Cru Classe, Saint-Estephe",Bordeaux,2008,08/07/2021,10074752008,1007475
685,21/07/2021,1033,3,470,215,563,29/03/2018,"Chateau Batailley 5eme Cru Classe, Pauillac",Bordeaux,2000,22/07/2021,10063222000,1006322
6830,07/07/2021,7749,61,7086,-256,663,11/06/2021,"Chateau Margaux Premier Cru Classe, Margaux",Bordeaux,2009,08/07/2021,10127812009,1012781
450,21/07/2021,532,2,300,150,232,15/12/2019,"Chateau Batailley 5eme Cru Classe, Pauillac",Bordeaux,2004,22/07/2021,10063222004,1006322
2350,17/06/2021,2601,188,2178,172,423,19/04/2021,"Chateau Angelus Premier Grand Cru Classe A, Saint-Emilion Grand Cru",Bordeaux,2014,21/06/2021,10060452014,1006045
1850,07/07/2021,1831,1,1180,670,651,10/03/2017,"Gaja, Barbaresco",Piedmont,2005,08/07/2021,10996052005,1099605
1800,07/07/2021,1733,2,1300,500,433,30/05/2019,"Gaja, Barbaresco",Piedmont,2007,08/07/2021,10996052007,1099605
2098,07/07/2021,2366,3,2190,-92,176,01/05/2021,"Gaja, Barbaresco",Piedmont,2004,08/07/2021,10996052004,1099605
2500,07/07/2021,2632,3,2220,280,412,14/06/2021,"Gaja, Barbaresco",Piedmont,2001,08/07/2021,10996052001,1099605
520,07/07/2021,563,3,460,60,103,05/05/2020,"Tua Rita, Giusto di Notri, Toscana",Tuscany,2008,08/07/2021,11058072008,1105807
660,07/07/2021,727,5,390,270,337,18/08/2017,"Tua Rita, Giusto di Notri, Toscana",Tuscany,2006,08/07/2021,11058072006,1105807
1700,07/07/2021,1847,4,1378,322,469,29/07/2020,"Tignanello, Toscana",Tuscany,2001,08/07/2021,10953912001,1095391
1408,07/07/2021,1389,4,1238,170,151,02/11/2020,"Tignanello, Toscana",Tuscany,2006,08/07/2021,10953912006,1095391
6400,07/07/2021,7562,52,5950,450,1612,23/06/2021,"Chateau Margaux Premier Cru Classe, Margaux",Bordeaux,2010,08/07/2021,10127812010,1012781
990,07/07/2021,1134,16,990,0,144,16/06/2021,"Chateau Calon Segur 3eme Cru Classe, Saint-Estephe",Bordeaux,2010,08/07/2021,10074752010,1007475
589,21/07/2021,622,49,520,69,102,17/06/2021,"Chateau Batailley 5eme Cru Classe, Pauillac",Bordeaux,2005,22/07/2021,10063222005,1006322
750,07/07/2021,989,35,790,-40,199,01/06/2020,"Chateau Calon Segur 3eme Cru Classe, Saint-Estephe",Bordeaux,2011,08/07/2021,10074752011,1007475
8400,07/07/2021,8400,1,5960,2440,2440,01/08/2017,"Domaine Leflaive, Chevalier-Montrachet Grand Cru",Burgundy,2010,08/07/2021,10734012010,1073401
1024,07/07/2021,1255,4,1072,-48,183,20/01/2021,"Tignanello, Toscana",Tuscany,2009,08/07/2021,10953912009,1095391
1326,07/07/2021,1560,4,1170,156,390,24/06/2021,"Tignanello, Toscana",Tuscany,2010,08/07/2021,10953912010,1095391
3600,07/07/2021,4284,81,3690,-90,594,13/04/2021,"Chateau Margaux Premier Cru Classe, Margaux",Bordeaux,2011,08/07/2021,10127812011,1012781
2350,17/06/2021,2604,190,2178,172,426,19/04/2021,"Chateau Angelus Premier Grand Cru Classe A, Saint-Emilion Grand Cru",Bordeaux,2014,18/06/2021,10060452014,1006045
2199,07/07/2021,2225,2,1340,859,885,13/03/2020,"Gaja, Barbaresco",Piedmont,2009,08/07/2021,10996052009,1099605
1050,07/07/2021,1074,8,880,170,194,22/06/2021,"Tignanello, Toscana",Tuscany,2011,08/07/2021,10953912011,1095391
2350,17/06/2021,2602,190,2178,172,424,19/04/2021,"Chateau Angelus Premier Grand Cru Classe A, Saint-Emilion Grand Cru",Bordeaux,2014,19/06/2021,10060452014,1006045
589,21/07/2021,622,49,520,69,102,17/06/2021,"Chateau Batailley 5eme Cru Classe, Pauillac",Bordeaux,2005,22/07/2021,10063222005,1006322
820,07/07/2021,937,6,735,85,202,09/09/2020,"Chateau Calon Segur 3eme Cru Classe, Saint-Estephe",Bordeaux,2012,08/07/2021,10074752012,1007475
3750,05/07/2021,4272,47,3560,190,712,20/11/2020,"Chateau Margaux Premier Cru Classe, Margaux",Bordeaux,2012,08/07/2021,10127812012,1012781
13200,07/07/2021,12867,1,12850,350,17,30/11/2020,"Jacques-Frederic Mugnier, Chambolle-Musigny Premier Cru, Les Amoureuses",Burgundy,2011,08/07/2021,10496422011,1049642
3740,07/07/2021,4000,49,3520,220,480,07/04/2021,"Chateau Margaux Premier Cru Classe, Margaux",Bordeaux,2013,08/07/2021,10127812013,1012781
2350,17/06/2021,2601,188,2178,172,423,19/04/2021,"Chateau Angelus Premier Grand Cru Classe A, Saint-Emilion Grand Cru",Bordeaux,2014,21/06/2021,10060452014,1006045
500,21/07/2021,504,7,450,50,54,25/05/2021,"Chateau Batailley 5eme Cru Classe, Pauillac",Bordeaux,2009,22/07/2021,10063222009,1006322
686,07/07/2021,809,7,682,4,127,15/09/2020,"Chateau Calon Segur 3eme Cru Classe, Saint-Estephe",Bordeaux,2013,08/07/2021,10074752013,1007475
1380,07/07/2021,1442,7,1352,28,90,23/09/2020,"Gaja, Barbaresco",Piedmont,2011,08/07/2021,10996052011,1099605
960,07/07/2021,1285,11,850,110,435,28/01/2021,"Tignanello, Toscana",Tuscany,2012,08/07/2021,10953912012,1095391
2350,17/06/2021,2604,190,2178,172,426,19/04/2021,"Chateau Angelus Premier Grand Cru Classe A, Saint-Emilion Grand Cru",Bordeaux,2014,18/06/2021,10060452014,1006045
3800,07/07/2021,4339,126,3480,320,859,17/06/2021,"Chateau Margaux Premier Cru Classe, Margaux",Bordeaux,2014,08/07/2021,10127812014,1012781
500,21/07/2021,504,7,450,50,54,25/05/2021,"Chateau Batailley 5eme Cru Classe, Pauillac",Bordeaux,2009,22/07/2021,10063222009,1006322
1550,07/07/2021,1557,1,1300,250,257,27/04/2021,"Gaja, Barbaresco",Piedmont,2012,08/07/2021,10996052012,1099605
1090,07/07/2021,1140,7,860,230,280,08/03/2021,"Tignanello, Toscana",Tuscany,2013,08/07/2021,10953912013,1095391
984,07/07/2021,1104,42,830,154,274,22/06/2021,"Tignanello, Toscana",Tuscany,2014,08/07/2021,10953912014,1095391
1400,07/07/2021,1529,14,1300,100,229,30/06/2021,"Gaja, Barbaresco",Piedmont,2013,08/07/2021,10996052013,1099605
900,07/07/2021,1082,82,822,78,260,28/06/2021,"Chateau Calon Segur 3eme Cru Classe, Saint-Estephe",Bordeaux,2015,08/07/2021,10074752015,1007475
10400,07/07/2021,11822,52,9800,600,2022,11/06/2021,"Chateau Margaux Premier Cru Classe, Margaux",Bordeaux,2015,08/07/2021,10127812015,1012781
14520,07/07/2021,14520,1,12000,2520,2520,28/05/2020,"Jacques-Frederic Mugnier, Chambolle-Musigny Premier Cru, Les Amoureuses",Burgundy,2014,08/07/2021,10496422014,1049642
1130,07/07/2021,1167,15,1012,118,155,02/07/2021,"Tignanello, Toscana",Tuscany,2015,08/07/2021,10953912015,1095391
5415,05/07/2021,5821,127,5500,-85,321,06/07/2021,"Chateau Margaux Premier Cru Classe, Margaux",Bordeaux,2016,08/07/2021,10127812016,1012781
1083,07/07/2021,1217,79,1036,47,181,27/05/2021,"Chateau Calon Segur 3eme Cru Classe, Saint-Estephe",Bordeaux,2016,08/07/2021,10074752016,1007475
500,21/07/2021,507,6,450,50,57,25/05/2021,"Chateau Batailley 5eme Cru Classe, Pauillac",Bordeaux,2009,23/07/2021,10063222009,1006322
1240,07/07/2021,1291,68,1144,96,147,06/07/2021,"Tignanello, Toscana",Tuscany,2016,08/07/2021,10953912016,1095391
780,07/07/2021,929,102,740,40,189,21/05/2021,"Chateau Calon Segur 3eme Cru Classe, Saint-Estephe",Bordeaux,2017,08/07/2021,10074752017,1007475
3790,07/07/2021,4395,121,3950,-160,445,30/06/2021,"Chateau Margaux Premier Cru Classe, Margaux",Bordeaux,2017,08/07/2021,10127812017,1012781
1350,07/07/2021,1481,55,1260,90,221,18/02/2021,"Gaja, Barbaresco",Piedmont,2015,08/07/2021,10996052015,1099605
460,07/07/2021,488,157,420,40,68,28/05/2021,"Tua Rita, Giusto di Notri, Toscana",Tuscany,2016,08/07/2021,11058072016,1105807
8000,07/07/2021,8684,5,6974,1026,1710,14/03/2021,"Domaine Leflaive, Chevalier-Montrachet Grand Cru",Burgundy,2017,08/07/2021,10734012017,1073401
7527,05/07/2021,9750,3,7290,237,2460,21/08/2020,"Domaine Denis Mortet, Chambertin Grand Cru",Burgundy,2017,08/07/2021,10490202017,1049020
15600,07/07/2021,15271,5,13000,2600,2271,29/04/2021,"Jacques-Frederic Mugnier, Chambolle-Musigny Premier Cru, Les Amoureuses",Burgundy,2017,08/07/2021,10496422017,1049642
2350,17/06/2021,2602,190,2178,172,424,19/04/2021,"Chateau Angelus Premier Grand Cru Classe A, Saint-Emilion Grand Cru",Bordeaux,2014,19/06/2021,10060452014,1006045
5600,07/07/2021,5853,100,5254,346,599,26/05/2021,"Chateau Margaux Premier Cru Classe, Margaux",Bordeaux,2018,08/07/2021,10127812018,1012781
1080,07/07/2021,1228,47,950,130,278,03/05/2021,"Chateau Calon Segur 3eme Cru Classe, Saint-Estephe",Bordeaux,2018,08/07/2021,10074752018,1007475
857,07/07/2021,1003,131,848,9,155,02/07/2021,"Tignanello, Toscana",Tuscany,2017,08/07/2021,10953912017,1095391
8000,07/07/2021,8299,4,7330,670,969,02/06/2021,"Domaine Leflaive, Chevalier-Montrachet Grand Cru",Burgundy,2018,08/07/2021,10734012018,1073401
860,07/07/2021,1001,76,936,-76,65,06/07/2021,"Tignanello, Toscana",Tuscany,2018,08/07/2021,10953912018,1095391
2350,15/06/2021,2602,193,2178,172,424,19/04/2021,"Chateau Angelus Premier Grand Cru Classe A, Saint-Emilion Grand Cru",Bordeaux,2014,16/06/2021,10060452014,1006045
500,21/07/2021,507,6,450,50,57,25/05/2021,"Chateau Batailley 5eme Cru Classe, Pauillac",Bordeaux,2009,23/07/2021,10063222009,1006322
920,07/07/2021,1038,36,842,78,196,22/08/2020,"Chateau Calon Segur 3eme Cru Classe, Saint-Estephe",Bordeaux,2019,08/07/2021,10074752019,1007475
960,07/07/2021,1271,12,850,110,421,28/01/2021,"Tignanello, Toscana",Tuscany,2012,09/07/2021,10953912012,1095391
2350,15/06/2021,2602,193,2178,172,424,19/04/2021,"Chateau Angelus Premier Grand Cru Classe A, Saint-Emilion Grand Cru",Bordeaux,2014,16/06/2021,10060452014,1006045
3800,08/07/2021,4345,121,3480,320,865,17/06/2021,"Chateau Margaux Premier Cru Classe, Margaux",Bordeaux,2014,09/07/2021,10127812014,1012781
1090,08/07/2021,1140,7,860,230,280,08/03/2021,"Tignanello, Toscana",Tuscany,2013,09/07/2021,10953912013,1095391
984,08/07/2021,1106,45,830,154,276,22/06/2021,"Tignanello, Toscana",Tuscany,2014,09/07/2021,10953912014,1095391
9600,08/07/2021,9623,1,8000,1600,1623,30/01/2020,"Domaine Leflaive, Chevalier-Montrachet Grand Cru",Burgundy,2014,09/07/2021,10734012014,1073401
940,08/07/2021,1092,76,822,118,270,28/06/2021,"Chateau Calon Segur 3eme Cru Classe, Saint-Estephe",Bordeaux,2015,09/07/2021,10074752015,1007475
10400,08/07/2021,11900,47,9800,600,2100,11/06/2021,"Chateau Margaux Premier Cru Classe, Margaux",Bordeaux,2015,09/07/2021,10127812015,1012781
2350,11/06/2021,2596,193,2178,172,418,19/04/2021,"Chateau Angelus Premier Grand Cru Classe A, Saint-Emilion Grand Cru",Bordeaux,2014,12/06/2021,10060452014,1006045
1040,07/07/2021,1135,14,940,100,195,18/03/2021,"Chateau Calon Segur 3eme Cru Classe, Saint-Estephe",Bordeaux,2000,10/07/2021,10074752000,1007475
870,09/07/2021,966,5,705,165,261,01/02/2021,"Chateau Calon Segur 3eme Cru Classe, Saint-Estephe",Bordeaux,2002,10/07/2021,10074752002,1007475
8100,09/07/2021,8967,13,8100,0,867,21/06/2021,"Chateau Margaux Premier Cru Classe, Margaux",Bordeaux,2000,10/07/2021,10127812000,1012781
900,09/07/2021,1156,20,800,100,356,21/11/2019,"Chateau Calon Segur 3eme Cru Classe, Saint-Estephe",Bordeaux,2003,10/07/2021,10074752003,1007475
4450,09/07/2021,4802,23,4400,50,402,29/09/2020,"Chateau Margaux Premier Cru Classe, Margaux",Bordeaux,2001,10/07/2021,10127812001,1012781
3900,09/07/2021,4425,22,3684,216,741,10/06/2020,"Chateau Margaux Premier Cru Classe, Margaux",Bordeaux,2002,10/07/2021,10127812002,1012781
3826,09/07/2021,4571,47,4116,-290,455,25/02/2021,"Chateau Margaux Premier Cru Classe, Margaux",Bordeaux,2004,10/07/2021,10127812004,1012781
4850,09/07/2021,6067,24,4650,200,1417,21/06/2021,"Chateau Margaux Premier Cru Classe, Margaux",Bordeaux,2003,10/07/2021,10127812003,1012781
2350,11/06/2021,2596,193,2178,172,418,19/04/2021,"Chateau Angelus Premier Grand Cru Classe A, Saint-Emilion Grand Cru",Bordeaux,2014,12/06/2021,10060452014,1006045
2350,09/06/2021,2595,193,2178,172,417,19/04/2021,"Chateau Angelus Premier Grand Cru Classe A, Saint-Emilion Grand Cru",Bordeaux,2014,10/06/2021,10060452014,1006045
980,09/07/2021,930,17,745,235,185,16/11/2020,"Chateau Calon Segur 3eme Cru Classe, Saint-Estephe",Bordeaux,2004,10/07/2021,10074752004,1007475
1040,07/07/2021,1204,24,940,100,264,18/03/2021,"Chateau Calon Segur 3eme Cru Classe, Saint-Estephe",Bordeaux,2000,08/07/2021,10074752000,1007475
870,07/07/2021,966,5,705,165,261,01/02/2021,"Chateau Calon Segur 3eme Cru Classe, Saint-Estephe",Bordeaux,2002,08/07/2021,10074752002,1007475
8200,07/07/2021,9044,12,8100,100,944,21/06/2021,"Chateau Margaux Premier Cru Classe, Margaux",Bordeaux,2000,08/07/2021,10127812000,1012781
900,07/07/2021,1156,20,800,100,356,21/11/2019,"Chateau Calon Segur 3eme Cru Classe, Saint-Estephe",Bordeaux,2003,08/07/2021,10074752003,1007475
4450,07/07/2021,4727,20,4400,50,327,29/09/2020,"Chateau Margaux Premier Cru Classe, Margaux",Bordeaux,2001,08/07/2021,10127812001,1012781
3900,07/07/2021,4466,26,3684,216,782,10/06/2020,"Chateau Margaux Premier Cru Classe, Margaux",Bordeaux,2002,08/07/2021,10127812002,1012781
3826,07/07/2021,4490,60,4116,-290,374,25/02/2021,"Chateau Margaux Premier Cru Classe, Margaux",Bordeaux,2004,08/07/2021,10127812004,1012781
2350,09/06/2021,2596,193,2178,172,418,19/04/2021,"Chateau Angelus Premier Grand Cru Classe A, Saint-Emilion Grand Cru",Bordeaux,2014,11/06/2021,10060452014,1006045
2350,09/06/2021,2595,193,2178,172,417,19/04/2021,"Chateau Angelus Premier Grand Cru Classe A, Saint-Emilion Grand Cru",Bordeaux,2014,10/06/2021,10060452014,1006045
2350,09/06/2021,2596,193,2178,172,418,19/04/2021,"Chateau Angelus Premier Grand Cru Classe A, Saint-Emilion Grand Cru",Bordeaux,2014,11/06/2021,10060452014,1006045
907,07/07/2021,924,18,805,102,119,20/11/2019,"Chateau Calon Segur 3eme Cru Classe, Saint-Estephe",Bordeaux,2001,08/07/2021,10074752001,1007475
510,21/07/2021,595,402,494,16,101,20/04/2021,"Chateau Batailley 5eme Cru Classe, Pauillac",Bordeaux,2010,22/07/2021,10063222010,1006322
2350,07/06/2021,2595,193,2178,172,417,19/04/2021,"Chateau Angelus Premier Grand Cru Classe A, Saint-Emilion Grand Cru",Bordeaux,2014,08/06/2021,10060452014,1006045
510,21/07/2021,595,402,494,16,101,20/04/2021,"Chateau Batailley 5eme Cru Classe, Pauillac",Bordeaux,2010,22/07/2021,10063222010,1006322
6400,06/07/2021,7359,31,6776,-376,583,10/06/2021,"Chateau Margaux Premier Cru Classe, Margaux",Bordeaux,2005,08/07/2021,10127812005,1012781
1000,07/07/2021,1160,87,988,12,172,28/05/2021,"Chateau Calon Segur 3eme Cru Classe, Saint-Estephe",Bordeaux,2005,08/07/2021,10074752005,1007475
2350,07/06/2021,2595,193,2178,172,417,19/04/2021,"Chateau Angelus Premier Grand Cru Classe A, Saint-Emilion Grand Cru",Bordeaux,2014,08/06/2021,10060452014,1006045
895,07/07/2021,926,42,863,32,63,10/05/2021,"Chateau Calon Segur 3eme Cru Classe, Saint-Estephe",Bordeaux,2006,08/07/2021,10074752006,1007475
3900,07/07/2021,4642,92,3822,78,820,20/06/2021,"Chateau Margaux Premier Cru Classe, Margaux",Bordeaux,2006,08/07/2021,10127812006,1012781
380,21/07/2021,422,5,320,60,102,09/07/2021,"Chateau Batailley 5eme Cru Classe, Pauillac",Bordeaux,2011,22/07/2021,10063222011,1006322
3560,07/07/2021,4191,39,3525,35,666,18/06/2021,"Chateau Margaux Premier Cru Classe, Margaux",Bordeaux,2007,08/07/2021,10127812007,1012781
880,07/07/2021,967,9,725,155,242,13/04/2021,"Chateau Calon Segur 3eme Cru Classe, Saint-Estephe",Bordeaux,2007,08/07/2021,10074752007,1007475
2350,03/06/2021,2592,183,2178,172,414,19/04/2021,"Chateau Angelus Premier Grand Cru Classe A, Saint-Emilion Grand Cru",Bordeaux,2014,04/06/2021,10060452014,1006045
2350,03/06/2021,2595,193,2178,172,417,19/04/2021,"Chateau Angelus Premier Grand Cru Classe A, Saint-Emilion Grand Cru",Bordeaux,2014,05/06/2021,10060452014,1006045
3900,07/07/2021,4319,83,3750,150,569,28/06/2021,"Chateau Margaux Premier Cru Classe, Margaux",Bordeaux,2008,08/07/2021,10127812008,1012781
895,07/07/2021,978,10,781,114,197,16/11/2020,"Chateau Calon Segur 3eme Cru Classe, Saint-Estephe",Bordeaux,2008,08/07/2021,10074752008,1007475
6830,07/07/2021,7749,61,7086,-256,663,11/06/2021,"Chateau Margaux Premier Cru Classe, Margaux",Bordeaux,2009,08/07/2021,10127812009,1012781
900,07/07/2021,1082,82,822,78,260,28/06/2021,"Chateau Calon Segur 3eme Cru Classe, Saint-Estephe",Bordeaux,2015,08/07/2021,10074752015,1007475
10400,07/07/2021,11822,52,9800,600,2022,11/06/2021,"Chateau Margaux Premier Cru Classe, Margaux",Bordeaux,2015,08/07/2021,10127812015,1012781
1040,07/07/2021,1205,22,940,100,265,18/03/2021,"Chateau Calon Segur 3eme Cru Classe, Saint-Estephe",Bordeaux,2000,09/07/2021,10074752000,1007475
870,08/07/2021,966,5,705,165,261,01/02/2021,"Chateau Calon Segur 3eme Cru Classe, Saint-Estephe",Bordeaux,2002,09/07/2021,10074752002,1007475
8200,08/07/2021,9039,12,8100,100,939,21/06/2021,"Chateau Margaux Premier Cru Classe, Margaux",Bordeaux,2000,09/07/2021,10127812000,1012781
2350,03/06/2021,2592,183,2178,172,414,19/04/2021,"Chateau Angelus Premier Grand Cru Classe A, Saint-Emilion Grand Cru",Bordeaux,2014,04/06/2021,10060452014,1006045
4450,08/07/2021,4802,23,4400,50,402,29/09/2020,"Chateau Margaux Premier Cru Classe, Margaux",Bordeaux,2001,09/07/2021,10127812001,1012781
3900,07/07/2021,4425,22,3684,216,741,10/06/2020,"Chateau Margaux Premier Cru Classe, Margaux",Bordeaux,2002,09/07/2021,10127812002,1012781
3826,08/07/2021,4554,50,4116,-290,438,25/02/2021,"Chateau Margaux Premier Cru Classe, Margaux",Bordeaux,2004,09/07/2021,10127812004,1012781
4850,02/07/2021,6067,24,4650,200,1417,21/06/2021,"Chateau Margaux Premier Cru Classe, Margaux",Bordeaux,2003,09/07/2021,10127812003,1012781
2350,03/06/2021,2595,193,2178,172,417,19/04/2021,"Chateau Angelus Premier Grand Cru Classe A, Saint-Emilion Grand Cru",Bordeaux,2014,05/06/2021,10060452014,1006045
2273,31/05/2021,2591,183,2178,95,413,19/04/2021,"Chateau Angelus Premier Grand Cru Classe A, Saint-Emilion Grand Cru",Bordeaux,2014,03/06/2021,10060452014,1006045
980,07/07/2021,922,18,745,235,177,16/11/2020,"Chateau Calon Segur 3eme Cru Classe, Saint-Estephe",Bordeaux,2004,09/07/2021,10074752004,1007475
2273,31/05/2021,2546,133,2178,95,368,19/04/2021,"Chateau Angelus Premier Grand Cru Classe A, Saint-Emilion Grand Cru",Bordeaux,2014,01/06/2021,10060452014,1006045
907,07/07/2021,926,18,805,102,121,20/11/2019,"Chateau Calon Segur 3eme Cru Classe, Saint-Estephe",Bordeaux,2001,09/07/2021,10074752001,1007475
2273,31/05/2021,2548,133,2178,95,370,19/04/2021,"Chateau Angelus Premier Grand Cru Classe A, Saint-Emilion Grand Cru",Bordeaux,2014,02/06/2021,10060452014,1006045
2273,31/05/2021,2546,133,2178,95,368,19/04/2021,"Chateau Angelus Premier Grand Cru Classe A, Saint-Emilion Grand Cru",Bordeaux,2014,01/06/2021,10060452014,1006045
6400,08/07/2021,7254,26,6776,-376,478,10/06/2021,"Chateau Margaux Premier Cru Classe, Margaux",Bordeaux,2005,09/07/2021,10127812005,1012781
1000,07/07/2021,1167,80,988,12,179,28/05/2021,"Chateau Calon Segur 3eme Cru Classe, Saint-Estephe",Bordeaux,2005,09/07/2021,10074752005,1007475
380,21/07/2021,422,5,320,60,102,09/07/2021,"Chateau Batailley 5eme Cru Classe, Pauillac",Bordeaux,2011,22/07/2021,10063222011,1006322
400,21/07/2021,420,7,408,-8,12,14/07/2021,"Chateau Batailley 5eme Cru Classe, Pauillac",Bordeaux,2012,22/07/2021,10063222012,1006322
3900,08/07/2021,4710,80,3822,78,888,20/06/2021,"Chateau Margaux Premier Cru Classe, Margaux",Bordeaux,2006,09/07/2021,10127812006,1012781
895,08/07/2021,921,39,863,32,58,10/05/2021,"Chateau Calon Segur 3eme Cru Classe, Saint-Estephe",Bordeaux,2006,09/07/2021,10074752006,1007475
3560,07/07/2021,4237,83,3525,35,712,18/06/2021,"Chateau Margaux Premier Cru Classe, Margaux",Bordeaux,2007,09/07/2021,10127812007,1012781
880,08/07/2021,980,7,725,155,255,13/04/2021,"Chateau Calon Segur 3eme Cru Classe, Saint-Estephe",Bordeaux,2007,09/07/2021,10074752007,1007475
2273,31/05/2021,2591,183,2178,95,413,19/04/2021,"Chateau Angelus Premier Grand Cru Classe A, Saint-Emilion Grand Cru",Bordeaux,2014,03/06/2021,10060452014,1006045
3900,08/07/2021,4354,63,3750,150,604,28/06/2021,"Chateau Margaux Premier Cru Classe, Margaux",Bordeaux,2008,09/07/2021,10127812008,1012781
895,08/07/2021,978,10,781,114,197,16/11/2020,"Chateau Calon Segur 3eme Cru Classe, Saint-Estephe",Bordeaux,2008,09/07/2021,10074752008,1007475
6830,07/07/2021,7778,43,7086,-256,692,11/06/2021,"Chateau Margaux Premier Cru Classe, Margaux",Bordeaux,2009,09/07/2021,10127812009,1012781
1000,07/07/2021,1238,51,1026,-26,212,24/06/2021,"Chateau Calon Segur 3eme Cru Classe, Saint-Estephe",Bordeaux,2009,09/07/2021,10074752009,1007475
2273,31/05/2021,2548,133,2178,95,370,19/04/2021,"Chateau Angelus Premier Grand Cru Classe A, Saint-Emilion Grand Cru",Bordeaux,2014,02/06/2021,10060452014,1006045
1850,08/07/2021,1831,1,1180,670,651,10/03/2017,"Gaja, Barbaresco",Piedmont,2005,09/07/2021,10996052005,1099605
2500,08/07/2021,2632,3,2220,280,412,14/06/2021,"Gaja, Barbaresco",Piedmont,2001,09/07/2021,10996052001,1099605
2098,08/07/2021,2366,3,2190,-92,176,01/05/2021,"Gaja, Barbaresco",Piedmont,2004,09/07/2021,10996052004,1099605
520,08/07/2021,563,3,460,60,103,05/05/2020,"Tua Rita, Giusto di Notri, Toscana",Tuscany,2008,09/07/2021,11058072008,1105807
660,08/07/2021,727,5,390,270,337,18/08/2017,"Tua Rita, Giusto di Notri, Toscana",Tuscany,2006,09/07/2021,11058072006,1105807
1592,08/07/2021,1754,6,1378,214,376,29/07/2020,"Tignanello, Toscana",Tuscany,2001,09/07/2021,10953912001,1095391
1248,08/07/2021,1323,5,1238,10,85,02/11/2020,"Tignanello, Toscana",Tuscany,2006,09/07/2021,10953912006,1095391
1300,08/07/2021,1385,2,1200,100,185,06/03/2021,"Tignanello, Toscana",Tuscany,2007,09/07/2021,10953912007,1095391
6400,08/07/2021,7647,43,6190,210,1457,08/07/2021,"Chateau Margaux Premier Cru Classe, Margaux",Bordeaux,2010,09/07/2021,10127812010,1012781
400,21/07/2021,420,7,408,-8,12,14/07/2021,"Chateau Batailley 5eme Cru Classe, Pauillac",Bordeaux,2012,22/07/2021,10063222012,1006322
990,08/07/2021,1134,16,990,0,144,16/06/2021,"Chateau Calon Segur 3eme Cru Classe, Saint-Estephe",Bordeaux,2010,09/07/2021,10074752010,1007475
8400,08/07/2021,8400,1,5960,2440,2440,01/08/2017,"Domaine Leflaive, Chevalier-Montrachet Grand Cru",Burgundy,2010,09/07/2021,10734012010,1073401
1024,07/07/2021,1307,3,1072,-48,235,20/01/2021,"Tignanello, Toscana",Tuscany,2009,09/07/2021,10953912009,1095391
3600,07/07/2021,4345,69,3690,-90,655,13/04/2021,"Chateau Margaux Premier Cru Classe, Margaux",Bordeaux,2011,09/07/2021,10127812011,1012781
2320,28/05/2021,2547,134,2178,142,369,19/04/2021,"Chateau Angelus Premier Grand Cru Classe A, Saint-Emilion Grand Cru",Bordeaux,2014,29/05/2021,10060452014,1006045
6099,08/06/2021,9982,1,6500,-401,3482,26/05/2021,"Domaine Leflaive, Chevalier-Montrachet Grand Cru",Burgundy,2011,09/07/2021,10734012011,1073401
2320,28/05/2021,2547,134,2178,142,369,19/04/2021,"Chateau Angelus Premier Grand Cru Classe A, Saint-Emilion Grand Cru",Bordeaux,2014,29/05/2021,10060452014,1006045
320,21/07/2021,320,109,304,16,16,10/01/2021,"Chateau Batailley 5eme Cru Classe, Pauillac",Bordeaux,2013,22/07/2021,10063222013,1006322
820,08/07/2021,937,6,735,85,202,09/09/2020,"Chateau Calon Segur 3eme Cru Classe, Saint-Estephe",Bordeaux,2012,09/07/2021,10074752012,1007475
3750,05/07/2021,4282,40,3560,190,722,20/11/2020,"Chateau Margaux Premier Cru Classe, Margaux",Bordeaux,2012,09/07/2021,10127812012,1012781
13200,08/07/2021,12867,1,12850,350,17,30/11/2020,"Jacques-Frederic Mugnier, Chambolle-Musigny Premier Cru, Les Amoureuses",Burgundy,2011,09/07/2021,10496422011,1049642
6400,08/07/2021,17200,1,4500,1900,12700,08/04/2015,"Domaine Leflaive, Chevalier-Montrachet Grand Cru",Burgundy,2012,09/07/2021,10734012012,1073401
3740,08/07/2021,4070,26,3520,220,550,07/04/2021,"Chateau Margaux Premier Cru Classe, Margaux",Bordeaux,2013,09/07/2021,10127812013,1012781
2320,26/05/2021,2545,133,2178,142,367,19/04/2021,"Chateau Angelus Premier Grand Cru Classe A, Saint-Emilion Grand Cru",Bordeaux,2014,27/05/2021,10060452014,1006045
360,21/07/2021,370,71,360,0,10,14/07/2021,"Chateau Batailley 5eme Cru Classe, Pauillac",Bordeaux,2014,22/07/2021,10063222014,1006322
686,08/07/2021,809,7,682,4,127,15/09/2020,"Chateau Calon Segur 3eme Cru Classe, Saint-Estephe",Bordeaux,2013,09/07/2021,10074752013,1007475
960,07/07/2021,1271,12,850,110,421,28/01/2021,"Tignanello, Toscana",Tuscany,2012,09/07/2021,10953912012,1095391
2320,26/05/2021,2545,133,2178,142,367,19/04/2021,"Chateau Angelus Premier Grand Cru Classe A, Saint-Emilion Grand Cru",Bordeaux,2014,27/05/2021,10060452014,1006045
3800,08/07/2021,4345,121,3480,320,865,17/06/2021,"Chateau Margaux Premier Cru Classe, Margaux",Bordeaux,2014,09/07/2021,10127812014,1012781
476,21/07/2021,526,37,364,112,162,12/05/2021,"Chateau Batailley 5eme Cru Classe, Pauillac",Bordeaux,2016,22/07/2021,10063222016,1006322
1550,08/07/2021,1557,1,1300,250,257,27/04/2021,"Gaja, Barbaresco",Piedmont,2012,09/07/2021,10996052012,1099605
1090,08/07/2021,1140,7,860,230,280,08/03/2021,"Tignanello, Toscana",Tuscany,2013,09/07/2021,10953912013,1095391
984,08/07/2021,1106,45,830,154,276,22/06/2021,"Tignanello, Toscana",Tuscany,2014,09/07/2021,10953912014,1095391
1400,08/07/2021,1529,14,1300,100,229,30/06/2021,"Gaja, Barbaresco",Piedmont,2013,09/07/2021,10996052013,1099605
9600,08/07/2021,9623,1,8000,1600,1623,30/01/2020,"Domaine Leflaive, Chevalier-Montrachet Grand Cru",Burgundy,2014,09/07/2021,10734012014,1073401
2320,24/05/2021,2541,146,2178,142,363,19/04/2021,"Chateau Angelus Premier Grand Cru Classe A, Saint-Emilion Grand Cru",Bordeaux,2014,25/05/2021,10060452014,1006045
940,08/07/2021,1092,76,822,118,270,28/06/2021,"Chateau Calon Segur 3eme Cru Classe, Saint-Estephe",Bordeaux,2015,09/07/2021,10074752015,1007475
10400,08/07/2021,11900,47,9800,600,2100,11/06/2021,"Chateau Margaux Premier Cru Classe, Margaux",Bordeaux,2015,09/07/2021,10127812015,1012781
14520,08/07/2021,14520,1,12000,2520,2520,28/05/2020,"Jacques-Frederic Mugnier, Chambolle-Musigny Premier Cru, Les Amoureuses",Burgundy,2014,09/07/2021,10496422014,1049642
1130,07/07/2021,1160,13,1012,118,148,02/07/2021,"Tignanello, Toscana",Tuscany,2015,09/07/2021,10953912015,1095391
487,29/06/2021,538,21,388,99,150,29/09/2020,"Tua Rita, Giusto di Notri, Toscana",Tuscany,2015,09/07/2021,11058072015,1105807
5415,05/07/2021,5847,121,5500,-85,347,06/07/2021,"Chateau Margaux Premier Cru Classe, Margaux",Bordeaux,2016,09/07/2021,10127812016,1012781
2320,24/05/2021,2548,136,2178,142,370,19/04/2021,"Chateau Angelus Premier Grand Cru Classe A, Saint-Emilion Grand Cru",Bordeaux,2014,26/05/2021,10060452014,1006045
1240,08/07/2021,1281,88,1144,96,137,06/07/2021,"Tignanello, Toscana",Tuscany,2016,09/07/2021,10953912016,1095391
7906,06/07/2021,7946,1,7124,782,822,15/02/2019,"Domaine Leflaive, Chevalier-Montrachet Grand Cru",Burgundy,2016,09/07/2021,10734012016,1073401
1500,08/07/2021,1675,42,1400,100,275,08/07/2021,"Gaja, Barbaresco",Piedmont,2016,09/07/2021,10996052016,1099605
2320,24/05/2021,2548,136,2178,142,370,19/04/2021,"Chateau Angelus Premier Grand Cru Classe A, Saint-Emilion Grand Cru",Bordeaux,2014,26/05/2021,10060452014,1006045
780,08/07/2021,935,79,740,40,195,21/05/2021,"Chateau Calon Segur 3eme Cru Classe, Saint-Estephe",Bordeaux,2017,09/07/2021,10074752017,1007475
450,22/07/2021,532,2,300,150,232,15/12/2019,"Chateau Batailley 5eme Cru Classe, Pauillac",Bordeaux,2004,23/07/2021,10063222004,1006322
3790,07/07/2021,4453,123,3950,-160,503,30/06/2021,"Chateau Margaux Premier Cru Classe, Margaux",Bordeaux,2017,09/07/2021,10127812017,1012781
460,08/07/2021,487,154,420,40,67,28/05/2021,"Tua Rita, Giusto di Notri, Toscana",Tuscany,2016,09/07/2021,11058072016,1105807
8000,08/07/2021,8656,5,6974,1026,1682,14/03/2021,"Domaine Leflaive, Chevalier-Montrachet Grand Cru",Burgundy,2017,09/07/2021,10734012017,1073401
2320,24/05/2021,2541,146,2178,142,363,19/04/2021,"Chateau Angelus Premier Grand Cru Classe A, Saint-Emilion Grand Cru",Bordeaux,2014,25/05/2021,10060452014,1006045
5415,08/07/2021,5829,95,5254,161,575,26/05/2021,"Chateau Margaux Premier Cru Classe, Margaux",Bordeaux,2018,09/07/2021,10127812018,1012781
1080,08/07/2021,1241,40,950,130,291,03/05/2021,"Chateau Calon Segur 3eme Cru Classe, Saint-Estephe",Bordeaux,2018,09/07/2021,10074752018,1007475
857,07/07/2021,1006,121,848,9,158,02/07/2021,"Tignanello, Toscana",Tuscany,2017,09/07/2021,10953912017,1095391
487,29/06/2021,540,34,320,167,220,24/03/2021,"Tua Rita, Giusto di Notri, Toscana",Tuscany,2017,09/07/2021,11058072017,1105807
8000,08/07/2021,8299,4,7330,670,969,02/06/2021,"Domaine Leflaive, Chevalier-Montrachet Grand Cru",Burgundy,2018,09/07/2021,10734012018,1073401
860,07/07/2021,1023,94,936,-76,87,06/07/2021,"Tignanello, Toscana",Tuscany,2018,09/07/2021,10953912018,1095391
2320,20/05/2021,2545,147,2178,142,367,19/04/2021,"Chateau Angelus Premier Grand Cru Classe A, Saint-Emilion Grand Cru",Bordeaux,2014,22/05/2021,10060452014,1006045
589,22/07/2021,622,49,520,69,102,17/06/2021,"Chateau Batailley 5eme Cru Classe, Pauillac",Bordeaux,2005,23/07/2021,10063222005,1006322
920,08/07/2021,1038,36,842,78,196,22/08/2020,"Chateau Calon Segur 3eme Cru Classe, Saint-Estephe",Bordeaux,2019,09/07/2021,10074752019,1007475
5290,08/07/2021,4988,11,4160,1130,828,19/03/2021,"Chateau Margaux Premier Cru Classe, Margaux",Bordeaux,2019,09/07/2021,10127812019,1012781
1408,08/07/2021,1638,61,1398,10,240,01/07/2021,"Gaja, Barbaresco",Piedmont,2017,09/07/2021,10996052017,1099605
430,08/07/2021,457,102,380,50,77,25/03/2021,"Tua Rita, Giusto di Notri, Toscana",Tuscany,2018,09/07/2021,11058072018,1105807
1408,08/07/2021,1477,22,1820,-412,-343,08/07/2021,"Gaja, Barbaresco",Piedmont,2018,09/07/2021,10996052018,1099605
2320,20/05/2021,2539,143,2178,142,361,19/04/2021,"Chateau Angelus Premier Grand Cru Classe A, Saint-Emilion Grand Cru",Bordeaux,2014,21/05/2021,10060452014,1006045
589,22/07/2021,622,49,520,69,102,17/06/2021,"Chateau Batailley 5eme Cru Classe, Pauillac",Bordeaux,2005,23/07/2021,10063222005,1006322
6400,05/08/2021,7596,65,6188,212,1408,16/07/2021,"Chateau Margaux Premier Cru Classe, Margaux",Bordeaux,2010,06/08/2021,10127812010,1012781
1100,05/08/2021,1218,80,1036,64,182,27/05/2021,"Chateau Calon Segur 3eme Cru Classe, Saint-Estephe",Bordeaux,2016,06/08/2021,10074752016,1007475
3800,06/08/2021,4539,56,3525,275,1014,18/06/2021,"Chateau Margaux Premier Cru Classe, Margaux",Bordeaux,2007,09/08/2021,10127812007,1012781
10620,06/08/2021,12032,46,9800,820,2232,11/06/2021,"Chateau Margaux Premier Cru Classe, Margaux",Bordeaux,2015,09/08/2021,10127812015,1012781
1400,06/08/2021,1424,8,1360,40,64,18/07/2021,"Gaja, Barbaresco",Piedmont,2013,09/08/2021,10996052013,1099605
1100,06/08/2021,1221,70,1036,64,185,27/05/2021,"Chateau Calon Segur 3eme Cru Classe, Saint-Estephe",Bordeaux,2016,09/08/2021,10074752016,1007475
1440,06/08/2021,1681,31,1510,-70,171,18/07/2021,"Gaja, Barbaresco",Piedmont,2016,09/08/2021,10996052016,1099605
520,06/08/2021,571,3,460,60,111,05/05/2020,"Tua Rita, Giusto di Notri, Toscana",Tuscany,2008,09/08/2021,11058072008,1105807
686,06/08/2021,769,22,682,4,87,15/09/2020,"Chateau Calon Segur 3eme Cru Classe, Saint-Estephe",Bordeaux,2013,09/08/2021,10074752013,1007475
2320,20/05/2021,2539,143,2178,142,361,19/04/2021,"Chateau Angelus Premier Grand Cru Classe A, Saint-Emilion Grand Cru",Bordeaux,2014,21/05/2021,10060452014,1006045
780,06/08/2021,938,100,740,40,198,21/05/2021,"Chateau Calon Segur 3eme Cru Classe, Saint-Estephe",Bordeaux,2017,09/08/2021,10074752017,1007475
1300,08/07/2021,1401,2,1200,100,201,06/03/2021,"Tignanello, Toscana",Tuscany,2007,09/08/2021,10953912007,1095391
5600,06/08/2021,5272,9,4160,1440,1112,19/03/2021,"Chateau Margaux Premier Cru Classe, Margaux",Bordeaux,2019,09/08/2021,10127812019,1012781
940,06/08/2021,1076,76,866,74,210,20/07/2021,"Chateau Calon Segur 3eme Cru Classe, Saint-Estephe",Bordeaux,2015,09/08/2021,10074752015,1007475
2320,20/05/2021,2545,147,2178,142,367,19/04/2021,"Chateau Angelus Premier Grand Cru Classe A, Saint-Emilion Grand Cru",Bordeaux,2014,22/05/2021,10060452014,1006045
5415,30/07/2021,5884,135,5500,-85,384,06/07/2021,"Chateau Margaux Premier Cru Classe, Margaux",Bordeaux,2016,09/08/2021,10127812016,1012781
1080,06/08/2021,1218,44,1058,22,160,14/07/2021,"Chateau Calon Segur 3eme Cru Classe, Saint-Estephe",Bordeaux,2018,09/08/2021,10074752018,1007475
1040,04/08/2021,1386,68,940,100,446,18/03/2021,"Chateau Calon Segur 3eme Cru Classe, Saint-Estephe",Bordeaux,2000,09/08/2021,10074752000,1007475
3840,06/08/2021,4617,214,3950,-110,667,30/06/2021,"Chateau Margaux Premier Cru Classe, Margaux",Bordeaux,2017,09/08/2021,10127812017,1012781
2320,18/05/2021,2537,141,2178,142,359,19/04/2021,"Chateau Angelus Premier Grand Cru Classe A, Saint-Emilion Grand Cru",Bordeaux,2014,19/05/2021,10060452014,1006045
866,05/08/2021,963,8,705,161,258,01/02/2021,"Chateau Calon Segur 3eme Cru Classe, Saint-Estephe",Bordeaux,2002,09/08/2021,10074752002,1007475
8252,05/08/2021,10029,3,7290,962,2739,21/08/2020,"Domaine Denis Mortet, Chambertin Grand Cru",Burgundy,2017,09/08/2021,10490202017,1049020
1130,04/08/2021,1291,14,1012,118,279,02/07/2021,"Tignanello, Toscana",Tuscany,2015,09/08/2021,10953912015,1095391
3800,06/08/2021,4338,124,3600,200,738,02/08/2021,"Chateau Margaux Premier Cru Classe, Margaux",Bordeaux,2014,09/08/2021,10127812014,1012781
510,22/07/2021,595,402,494,16,101,20/04/2021,"Chateau Batailley 5eme Cru Classe, Pauillac",Bordeaux,2010,23/07/2021,10063222010,1006322
2320,18/05/2021,2538,142,2178,142,360,19/04/2021,"Chateau Angelus Premier Grand Cru Classe A, Saint-Emilion Grand Cru",Bordeaux,2014,20/05/2021,10060452014,1006045
790,06/08/2021,870,15,801,-11,69,31/05/2021,"Chateau Calon Segur 3eme Cru Classe, Saint-Estephe",Bordeaux,2014,09/08/2021,10074752014,1007475
3900,06/08/2021,4654,91,3822,78,832,20/06/2021,"Chateau Margaux Premier Cru Classe, Margaux",Bordeaux,2006,09/08/2021,10127812006,1012781
2320,18/05/2021,2537,141,2178,142,359,19/04/2021,"Chateau Angelus Premier Grand Cru Classe A, Saint-Emilion Grand Cru",Bordeaux,2014,19/05/2021,10060452014,1006045
510,22/07/2021,595,402,494,16,101,20/04/2021,"Chateau Batailley 5eme Cru Classe, Pauillac",Bordeaux,2010,23/07/2021,10063222010,1006322
907,26/07/2021,952,22,805,102,147,20/11/2019,"Chateau Calon Segur 3eme Cru Classe, Saint-Estephe",Bordeaux,2001,27/07/2021,10074752001,1007475
320,22/07/2021,320,109,304,16,16,10/01/2021,"Chateau Batailley 5eme Cru Classe, Pauillac",Bordeaux,2013,23/07/2021,10063222013,1006322
2320,18/05/2021,2538,142,2178,142,360,19/04/2021,"Chateau Angelus Premier Grand Cru Classe A, Saint-Emilion Grand Cru",Bordeaux,2014,20/05/2021,10060452014,1006045
360,22/07/2021,370,71,360,0,10,14/07/2021,"Chateau Batailley 5eme Cru Classe, Pauillac",Bordeaux,2014,23/07/2021,10063222014,1006322
6500,26/07/2021,7517,25,6400,100,1117,22/07/2021,"Chateau Margaux Premier Cru Classe, Margaux",Bordeaux,2005,27/07/2021,10127812005,1012781
2320,14/05/2021,2537,141,2178,142,359,19/04/2021,"Chateau Angelus Premier Grand Cru Classe A, Saint-Emilion Grand Cru",Bordeaux,2014,17/05/2021,10060452014,1006045
1040,07/07/2021,1135,14,940,100,195,18/03/2021,"Chateau Calon Segur 3eme Cru Classe, Saint-Estephe",Bordeaux,2000,10/07/2021,10074752000,1007475
870,09/07/2021,966,5,705,165,261,01/02/2021,"Chateau Calon Segur 3eme Cru Classe, Saint-Estephe",Bordeaux,2002,10/07/2021,10074752002,1007475
8100,09/07/2021,8967,13,8100,0,867,21/06/2021,"Chateau Margaux Premier Cru Classe, Margaux",Bordeaux,2000,10/07/2021,10127812000,1012781
900,09/07/2021,1156,20,800,100,356,21/11/2019,"Chateau Calon Segur 3eme Cru Classe, Saint-Estephe",Bordeaux,2003,10/07/2021,10074752003,1007475
4450,09/07/2021,4802,23,4400,50,402,29/09/2020,"Chateau Margaux Premier Cru Classe, Margaux",Bordeaux,2001,10/07/2021,10127812001,1012781
3900,09/07/2021,4425,22,3684,216,741,10/06/2020,"Chateau Margaux Premier Cru Classe, Margaux",Bordeaux,2002,10/07/2021,10127812002,1012781
3826,09/07/2021,4571,47,4116,-290,455,25/02/2021,"Chateau Margaux Premier Cru Classe, Margaux",Bordeaux,2004,10/07/2021,10127812004,1012781
4850,09/07/2021,6067,24,4650,200,1417,21/06/2021,"Chateau Margaux Premier Cru Classe, Margaux",Bordeaux,2003,10/07/2021,10127812003,1012781
2320,14/05/2021,2537,141,2178,142,359,19/04/2021,"Chateau Angelus Premier Grand Cru Classe A, Saint-Emilion Grand Cru",Bordeaux,2014,17/05/2021,10060452014,1006045
2320,14/05/2021,2542,147,2178,142,364,19/04/2021,"Chateau Angelus Premier Grand Cru Classe A, Saint-Emilion Grand Cru",Bordeaux,2014,15/05/2021,10060452014,1006045
980,09/07/2021,930,17,745,235,185,16/11/2020,"Chateau Calon Segur 3eme Cru Classe, Saint-Estephe",Bordeaux,2004,10/07/2021,10074752004,1007475
2320,14/05/2021,2542,147,2178,142,364,19/04/2021,"Chateau Angelus Premier Grand Cru Classe A, Saint-Emilion Grand Cru",Bordeaux,2014,15/05/2021,10060452014,1006045
907,09/07/2021,926,18,805,102,121,20/11/2019,"Chateau Calon Segur 3eme Cru Classe, Saint-Estephe",Bordeaux,2001,10/07/2021,10074752001,1007475
476,22/07/2021,526,37,364,112,162,12/05/2021,"Chateau Batailley 5eme Cru Classe, Pauillac",Bordeaux,2016,23/07/2021,10063222016,1006322
2320,12/05/2021,2542,149,2178,142,364,19/04/2021,"Chateau Angelus Premier Grand Cru Classe A, Saint-Emilion Grand Cru",Bordeaux,2014,13/05/2021,10060452014,1006045
6400,09/07/2021,7254,26,6776,-376,478,10/06/2021,"Chateau Margaux Premier Cru Classe, Margaux",Bordeaux,2005,10/07/2021,10127812005,1012781
2320,12/05/2021,2541,147,2178,142,363,19/04/2021,"Chateau Angelus Premier Grand Cru Classe A, Saint-Emilion Grand Cru",Bordeaux,2014,14/05/2021,10060452014,1006045
1000,09/07/2021,1167,80,988,12,179,28/05/2021,"Chateau Calon Segur 3eme Cru Classe, Saint-Estephe",Bordeaux,2005,10/07/2021,10074752005,1007475
2320,12/05/2021,2542,149,2178,142,364,19/04/2021,"Chateau Angelus Premier Grand Cru Classe A, Saint-Emilion Grand Cru",Bordeaux,2014,13/05/2021,10060452014,1006045
895,09/07/2021,921,39,863,32,58,10/05/2021,"Chateau Calon Segur 3eme Cru Classe, Saint-Estephe",Bordeaux,2006,10/07/2021,10074752006,1007475
3900,09/07/2021,4710,80,3822,78,888,20/06/2021,"Chateau Margaux Premier Cru Classe, Margaux",Bordeaux,2006,10/07/2021,10127812006,1012781
3560,09/07/2021,4235,82,3525,35,710,18/06/2021,"Chateau Margaux Premier Cru Classe, Margaux",Bordeaux,2007,10/07/2021,10127812007,1012781
880,09/07/2021,980,7,725,155,255,13/04/2021,"Chateau Calon Segur 3eme Cru Classe, Saint-Estephe",Bordeaux,2007,10/07/2021,10074752007,1007475
2320,12/05/2021,2541,147,2178,142,363,19/04/2021,"Chateau Angelus Premier Grand Cru Classe A, Saint-Emilion Grand Cru",Bordeaux,2014,14/05/2021,10060452014,1006045
2320,10/05/2021,2542,149,2178,142,364,19/04/2021,"Chateau Angelus Premier Grand Cru Classe A, Saint-Emilion Grand Cru",Bordeaux,2014,12/05/2021,10060452014,1006045
3950,09/07/2021,4354,63,3750,200,604,28/06/2021,"Chateau Margaux Premier Cru Classe, Margaux",Bordeaux,2008,10/07/2021,10127812008,1012781
895,09/07/2021,978,10,781,114,197,16/11/2020,"Chateau Calon Segur 3eme Cru Classe, Saint-Estephe",Bordeaux,2008,10/07/2021,10074752008,1007475
6880,09/07/2021,7779,43,7086,-206,693,11/06/2021,"Chateau Margaux Premier Cru Classe, Margaux",Bordeaux,2009,10/07/2021,10127812009,1012781
1000,09/07/2021,1238,51,1026,-26,212,24/06/2021,"Chateau Calon Segur 3eme Cru Classe, Saint-Estephe",Bordeaux,2009,10/07/2021,10074752009,1007475
2320,10/05/2021,2527,123,2178,142,349,19/04/2021,"Chateau Angelus Premier Grand Cru Classe A, Saint-Emilion Grand Cru",Bordeaux,2014,11/05/2021,10060452014,1006045
2500,09/07/2021,2632,3,2220,280,412,14/06/2021,"Gaja, Barbaresco",Piedmont,2001,10/07/2021,10996052001,1099605
2098,09/07/2021,2366,3,2190,-92,176,01/05/2021,"Gaja, Barbaresco",Piedmont,2004,10/07/2021,10996052004,1099605
1408,06/07/2021,1412,1,996,412,416,14/06/2019,"Tignanello, Toscana",Tuscany,2000,10/07/2021,10953912000,1095391
6400,09/07/2021,7647,43,6190,210,1457,08/07/2021,"Chateau Margaux Premier Cru Classe, Margaux",Bordeaux,2010,10/07/2021,10127812010,1012781
685,23/07/2021,914,2,470,215,444,29/03/2018,"Chateau Batailley 5eme Cru Classe, Pauillac",Bordeaux,2000,24/07/2021,10063222000,1006322
990,09/07/2021,1134,16,990,0,144,16/06/2021,"Chateau Calon Segur 3eme Cru Classe, Saint-Estephe",Bordeaux,2010,10/07/2021,10074752010,1007475
2320,10/05/2021,2542,149,2178,142,364,19/04/2021,"Chateau Angelus Premier Grand Cru Classe A, Saint-Emilion Grand Cru",Bordeaux,2014,12/05/2021,10060452014,1006045
750,09/07/2021,989,35,790,-40,199,01/06/2020,"Chateau Calon Segur 3eme Cru Classe, Saint-Estephe",Bordeaux,2011,10/07/2021,10074752011,1007475
1024,09/07/2021,1306,3,1072,-48,234,20/01/2021,"Tignanello, Toscana",Tuscany,2009,10/07/2021,10953912009,1095391
1326,09/07/2021,1559,4,1170,156,389,24/06/2021,"Tignanello, Toscana",Tuscany,2010,10/07/2021,10953912010,1095391
2320,10/05/2021,2527,123,2178,142,349,19/04/2021,"Chateau Angelus Premier Grand Cru Classe A, Saint-Emilion Grand Cru",Bordeaux,2014,11/05/2021,10060452014,1006045
685,23/07/2021,914,2,470,215,444,29/03/2018,"Chateau Batailley 5eme Cru Classe, Pauillac",Bordeaux,2000,24/07/2021,10063222000,1006322
1050,09/07/2021,1074,8,880,170,194,22/06/2021,"Tignanello, Toscana",Tuscany,2011,10/07/2021,10953912011,1095391
2320,07/05/2021,2521,117,2178,142,343,19/04/2021,"Chateau Angelus Premier Grand Cru Classe A, Saint-Emilion Grand Cru",Bordeaux,2014,10/05/2021,10060452014,1006045
420,23/07/2021,470,4,220,200,250,17/06/2015,"Chateau Batailley 5eme Cru Classe, Pauillac",Bordeaux,2002,24/07/2021,10063222002,1006322
820,09/07/2021,937,6,735,85,202,09/09/2020,"Chateau Calon Segur 3eme Cru Classe, Saint-Estephe",Bordeaux,2012,10/07/2021,10074752012,1007475
3740,09/07/2021,4064,26,3520,220,544,07/04/2021,"Chateau Margaux Premier Cru Classe, Margaux",Bordeaux,2013,10/07/2021,10127812013,1012781
2320,07/05/2021,2536,122,2178,142,358,19/04/2021,"Chateau Angelus Premier Grand Cru Classe A, Saint-Emilion Grand Cru",Bordeaux,2014,08/05/2021,10060452014,1006045
686,09/07/2021,809,7,682,4,127,15/09/2020,"Chateau Calon Segur 3eme Cru Classe, Saint-Estephe",Bordeaux,2013,10/07/2021,10074752013,1007475
2320,07/05/2021,2521,117,2178,142,343,19/04/2021,"Chateau Angelus Premier Grand Cru Classe A, Saint-Emilion Grand Cru",Bordeaux,2014,10/05/2021,10060452014,1006045
907,09/07/2021,926,18,805,102,121,20/11/2019,"Chateau Calon Segur 3eme Cru Classe, Saint-Estephe",Bordeaux,2001,10/07/2021,10074752001,1007475
450,23/07/2021,532,2,300,150,232,15/12/2019,"Chateau Batailley 5eme Cru Classe, Pauillac",Bordeaux,2004,24/07/2021,10063222004,1006322
2320,07/05/2021,2536,122,2178,142,358,19/04/2021,"Chateau Angelus Premier Grand Cru Classe A, Saint-Emilion Grand Cru",Bordeaux,2014,08/05/2021,10060452014,1006045
588,23/07/2021,624,49,520,68,104,17/06/2021,"Chateau Batailley 5eme Cru Classe, Pauillac",Bordeaux,2005,24/07/2021,10063222005,1006322
6400,09/07/2021,7254,26,6776,-376,478,10/06/2021,"Chateau Margaux Premier Cru Classe, Margaux",Bordeaux,2005,10/07/2021,10127812005,1012781
2320,05/05/2021,2543,125,2178,142,365,19/04/2021,"Chateau Angelus Premier Grand Cru Classe A, Saint-Emilion Grand Cru",Bordeaux,2014,06/05/2021,10060452014,1006045
1000,09/07/2021,1167,80,988,12,179,28/05/2021,"Chateau Calon Segur 3eme Cru Classe, Saint-Estephe",Bordeaux,2005,10/07/2021,10074752005,1007475
588,23/07/2021,624,49,520,68,104,17/06/2021,"Chateau Batailley 5eme Cru Classe, Pauillac",Bordeaux,2005,24/07/2021,10063222005,1006322
465,23/07/2021,458,2,400,65,58,11/05/2021,"Chateau Batailley 5eme Cru Classe, Pauillac",Bordeaux,2006,24/07/2021,10063222006,1006322
465,23/07/2021,458,2,400,65,58,11/05/2021,"Chateau Batailley 5eme Cru Classe, Pauillac",Bordeaux,2006,24/07/2021,10063222006,1006322
2320,05/05/2021,2543,125,2178,142,365,19/04/2021,"Chateau Angelus Premier Grand Cru Classe A, Saint-Emilion Grand Cru",Bordeaux,2014,06/05/2021,10060452014,1006045
895,09/07/2021,921,39,863,32,58,10/05/2021,"Chateau Calon Segur 3eme Cru Classe, Saint-Estephe",Bordeaux,2006,10/07/2021,10074752006,1007475
3900,09/07/2021,4710,80,3822,78,888,20/06/2021,"Chateau Margaux Premier Cru Classe, Margaux",Bordeaux,2006,10/07/2021,10127812006,1012781
450,23/07/2021,431,3,332,118,99,06/10/2020,"Chateau Batailley 5eme Cru Classe, Pauillac",Bordeaux,2008,24/07/2021,10063222008,1006322
3560,09/07/2021,4235,82,3525,35,710,18/06/2021,"Chateau Margaux Premier Cru Classe, Margaux",Bordeaux,2007,10/07/2021,10127812007,1012781
880,09/07/2021,980,7,725,155,255,13/04/2021,"Chateau Calon Segur 3eme Cru Classe, Saint-Estephe",Bordeaux,2007,10/07/2021,10074752007,1007475
2320,03/05/2021,2545,124,2178,142,367,19/04/2021,"Chateau Angelus Premier Grand Cru Classe A, Saint-Emilion Grand Cru",Bordeaux,2014,04/05/2021,10060452014,1006045
2320,03/05/2021,2542,124,2178,142,364,19/04/2021,"Chateau Angelus Premier Grand Cru Classe A, Saint-Emilion Grand Cru",Bordeaux,2014,05/05/2021,10060452014,1006045
3950,09/07/2021,4354,63,3750,200,604,28/06/2021,"Chateau Margaux Premier Cru Classe, Margaux",Bordeaux,2008,10/07/2021,10127812008,1012781
895,09/07/2021,978,10,781,114,197,16/11/2020,"Chateau Calon Segur 3eme Cru Classe, Saint-Estephe",Bordeaux,2008,10/07/2021,10074752008,1007475
500,23/07/2021,513,7,450,50,63,25/05/2021,"Chateau Batailley 5eme Cru Classe, Pauillac",Bordeaux,2009,24/07/2021,10063222009,1006322
6880,09/07/2021,7779,43,7086,-206,693,11/06/2021,"Chateau Margaux Premier Cru Classe, Margaux",Bordeaux,2009,10/07/2021,10127812009,1012781
1000,09/07/2021,1238,51,1026,-26,212,24/06/2021,"Chateau Calon Segur 3eme Cru Classe, Saint-Estephe",Bordeaux,2009,10/07/2021,10074752009,1007475
2320,03/05/2021,2545,124,2178,142,367,19/04/2021,"Chateau Angelus Premier Grand Cru Classe A, Saint-Emilion Grand Cru",Bordeaux,2014,04/05/2021,10060452014,1006045
7000,10/05/2021,6011,0,5360,1640,651,18/09/2020,"Domaine Leflaive, Chevalier-Montrachet Grand Cru",Burgundy,2009,10/07/2021,10734012009,1073401
1850,09/07/2021,1831,1,1180,670,651,10/03/2017,"Gaja, Barbaresco",Piedmont,2005,10/07/2021,10996052005,1099605
2500,09/07/2021,2632,3,2220,280,412,14/06/2021,"Gaja, Barbaresco",Piedmont,2001,10/07/2021,10996052001,1099605
2098,09/07/2021,2366,3,2190,-92,176,01/05/2021,"Gaja, Barbaresco",Piedmont,2004,10/07/2021,10996052004,1099605
1800,09/07/2021,1733,2,1300,500,433,30/05/2019,"Gaja, Barbaresco",Piedmont,2007,10/07/2021,10996052007,1099605
520,09/07/2021,563,3,460,60,103,05/05/2020,"Tua Rita, Giusto di Notri, Toscana",Tuscany,2008,10/07/2021,11058072008,1105807
660,09/07/2021,727,5,390,270,337,18/08/2017,"Tua Rita, Giusto di Notri, Toscana",Tuscany,2006,10/07/2021,11058072006,1105807
1408,06/07/2021,1412,1,996,412,416,14/06/2019,"Tignanello, Toscana",Tuscany,2000,10/07/2021,10953912000,1095391
6400,09/07/2021,7647,43,6190,210,1457,08/07/2021,"Chateau Margaux Premier Cru Classe, Margaux",Bordeaux,2010,10/07/2021,10127812010,1012781
500,23/07/2021,513,7,450,50,63,25/05/2021,"Chateau Batailley 5eme Cru Classe, Pauillac",Bordeaux,2009,24/07/2021,10063222009,1006322
990,09/07/2021,1134,16,990,0,144,16/06/2021,"Chateau Calon Segur 3eme Cru Classe, Saint-Estephe",Bordeaux,2010,10/07/2021,10074752010,1007475
2320,03/05/2021,2542,124,2178,142,364,19/04/2021,"Chateau Angelus Premier Grand Cru Classe A, Saint-Emilion Grand Cru",Bordeaux,2014,05/05/2021,10060452014,1006045
750,09/07/2021,989,35,790,-40,199,01/06/2020,"Chateau Calon Segur 3eme Cru Classe, Saint-Estephe",Bordeaux,2011,10/07/2021,10074752011,1007475
8400,09/07/2021,8400,1,5960,2440,2440,01/08/2017,"Domaine Leflaive, Chevalier-Montrachet Grand Cru",Burgundy,2010,10/07/2021,10734012010,1073401
1024,09/07/2021,1306,3,1072,-48,234,20/01/2021,"Tignanello, Toscana",Tuscany,2009,10/07/2021,10953912009,1095391
1326,09/07/2021,1559,4,1170,156,389,24/06/2021,"Tignanello, Toscana",Tuscany,2010,10/07/2021,10953912010,1095391
2580,05/08/2021,3316,56,2500,80,816,26/07/2021,"Chateau Angelus Premier Grand Cru Classe A, Saint-Emilion Grand Cru",Bordeaux,2015,06/08/2021,10060452015,1006045
525,23/07/2021,595,401,494,31,101,20/04/2021,"Chateau Batailley 5eme Cru Classe, Pauillac",Bordeaux,2010,24/07/2021,10063222010,1006322
2199,09/07/2021,2225,2,1340,859,885,13/03/2020,"Gaja, Barbaresco",Piedmont,2009,10/07/2021,10996052009,1099605
1050,09/07/2021,1074,8,880,170,194,22/06/2021,"Tignanello, Toscana",Tuscany,2011,10/07/2021,10953912011,1095391
6099,08/06/2021,12924,1,6500,-401,6424,26/05/2021,"Domaine Leflaive, Chevalier-Montrachet Grand Cru",Burgundy,2011,10/07/2021,10734012011,1073401
2580,05/08/2021,3319,55,2500,80,819,26/07/2021,"Chateau Angelus Premier Grand Cru Classe A, Saint-Emilion Grand Cru",Bordeaux,2015,09/08/2021,10060452015,1006045
525,23/07/2021,595,401,494,31,101,20/04/2021,"Chateau Batailley 5eme Cru Classe, Pauillac",Bordeaux,2010,24/07/2021,10063222010,1006322
820,09/07/2021,937,6,735,85,202,09/09/2020,"Chateau Calon Segur 3eme Cru Classe, Saint-Estephe",Bordeaux,2012,10/07/2021,10074752012,1007475
1800,09/07/2021,1727,1,1440,360,287,04/01/2018,"Gaja, Barbaresco",Piedmont,2010,10/07/2021,10996052010,1099605
13200,09/07/2021,12867,1,12850,350,17,30/11/2020,"Jacques-Frederic Mugnier, Chambolle-Musigny Premier Cru, Les Amoureuses",Burgundy,2011,10/07/2021,10496422011,1049642
3740,09/07/2021,4064,26,3520,220,544,07/04/2021,"Chateau Margaux Premier Cru Classe, Margaux",Bordeaux,2013,10/07/2021,10127812013,1012781
2580,05/08/2021,3319,55,2630,-50,689,09/08/2021,"Chateau Angelus Premier Grand Cru Classe A, Saint-Emilion Grand Cru",Bordeaux,2015,10/08/2021,10060452015,1006045
400,23/07/2021,418,8,408,-8,10,14/07/2021,"Chateau Batailley 5eme Cru Classe, Pauillac",Bordeaux,2012,24/07/2021,10063222012,1006322
686,09/07/2021,809,7,682,4,127,15/09/2020,"Chateau Calon Segur 3eme Cru Classe, Saint-Estephe",Bordeaux,2013,10/07/2021,10074752013,1007475
1380,09/07/2021,1442,7,1352,28,90,23/09/2020,"Gaja, Barbaresco",Piedmont,2011,10/07/2021,10996052011,1099605
960,09/07/2021,1286,11,850,110,436,28/01/2021,"Tignanello, Toscana",Tuscany,2012,10/07/2021,10953912012,1095391
2580,26/07/2021,3409,67,2500,80,909,26/07/2021,"Chateau Angelus Premier Grand Cru Classe A, Saint-Emilion Grand Cru",Bordeaux,2015,03/08/2021,10060452015,1006045
3800,09/07/2021,4345,121,3480,320,865,17/06/2021,"Chateau Margaux Premier Cru Classe, Margaux",Bordeaux,2014,10/07/2021,10127812014,1012781
790,09/07/2021,878,19,801,-11,77,31/05/2021,"Chateau Calon Segur 3eme Cru Classe, Saint-Estephe",Bordeaux,2014,10/07/2021,10074752014,1007475
400,23/07/2021,418,8,408,-8,10,14/07/2021,"Chateau Batailley 5eme Cru Classe, Pauillac",Bordeaux,2012,24/07/2021,10063222012,1006322
1550,09/07/2021,1557,1,1300,250,257,27/04/2021,"Gaja, Barbaresco",Piedmont,2012,10/07/2021,10996052012,1099605
1090,09/07/2021,1140,7,860,230,280,08/03/2021,"Tignanello, Toscana",Tuscany,2013,10/07/2021,10953912013,1095391
984,09/07/2021,1106,45,830,154,276,22/06/2021,"Tignanello, Toscana",Tuscany,2014,10/07/2021,10953912014,1095391
1400,09/07/2021,1530,14,1300,100,230,30/06/2021,"Gaja, Barbaresco",Piedmont,2013,10/07/2021,10996052013,1099605
1300,30/06/2021,1566,15,1300,0,266,09/07/2021,"Gaja, Barbaresco",Piedmont,2014,10/07/2021,10996052014,1099605
940,09/07/2021,1091,77,822,118,269,28/06/2021,"Chateau Calon Segur 3eme Cru Classe, Saint-Estephe",Bordeaux,2015,10/07/2021,10074752015,1007475
10400,09/07/2021,11900,47,9800,600,2100,11/06/2021,"Chateau Margaux Premier Cru Classe, Margaux",Bordeaux,2015,10/07/2021,10127812015,1012781
14520,09/07/2021,14520,1,12000,2520,2520,28/05/2020,"Jacques-Frederic Mugnier, Chambolle-Musigny Premier Cru, Les Amoureuses",Burgundy,2014,10/07/2021,10496422014,1049642
487,29/06/2021,539,20,388,99,151,29/09/2020,"Tua Rita, Giusto di Notri, Toscana",Tuscany,2015,10/07/2021,11058072015,1105807
15705,02/07/2021,16359,0,18750,-3045,-2391,29/08/2018,"Jacques-Frederic Mugnier, Chambolle-Musigny Premier Cru, Les Amoureuses",Burgundy,2015,10/07/2021,10496422015,1049642
2580,26/07/2021,3411,67,2500,80,911,26/07/2021,"Chateau Angelus Premier Grand Cru Classe A, Saint-Emilion Grand Cru",Bordeaux,2015,31/07/2021,10060452015,1006045
320,23/07/2021,320,109,304,16,16,10/01/2021,"Chateau Batailley 5eme Cru Classe, Pauillac",Bordeaux,2013,24/07/2021,10063222013,1006322
1240,09/07/2021,1280,83,1144,96,136,06/07/2021,"Tignanello, Toscana",Tuscany,2016,10/07/2021,10953912016,1095391
1500,09/07/2021,1675,42,1400,100,275,08/07/2021,"Gaja, Barbaresco",Piedmont,2016,10/07/2021,10996052016,1099605
780,09/07/2021,935,78,740,40,195,21/05/2021,"Chateau Calon Segur 3eme Cru Classe, Saint-Estephe",Bordeaux,2017,10/07/2021,10074752017,1007475
3790,09/07/2021,4453,123,3950,-160,503,30/06/2021,"Chateau Margaux Premier Cru Classe, Margaux",Bordeaux,2017,10/07/2021,10127812017,1012781
1350,09/07/2021,1480,56,1260,90,220,18/02/2021,"Gaja, Barbaresco",Piedmont,2015,10/07/2021,10996052015,1099605
460,09/07/2021,487,154,420,40,67,28/05/2021,"Tua Rita, Giusto di Notri, Toscana",Tuscany,2016,10/07/2021,11058072016,1105807
8000,09/07/2021,8656,5,6974,1026,1682,14/03/2021,"Domaine Leflaive, Chevalier-Montrachet Grand Cru",Burgundy,2017,10/07/2021,10734012017,1073401
2580,26/07/2021,3421,66,2500,80,921,26/07/2021,"Chateau Angelus Premier Grand Cru Classe A, Saint-Emilion Grand Cru",Bordeaux,2015,29/07/2021,10060452015,1006045
1080,09/07/2021,1244,40,1060,20,184,09/07/2021,"Chateau Calon Segur 3eme Cru Classe, Saint-Estephe",Bordeaux,2018,10/07/2021,10074752018,1007475
360,23/07/2021,370,71,360,0,10,14/07/2021,"Chateau Batailley 5eme Cru Classe, Pauillac",Bordeaux,2014,24/07/2021,10063222014,1006322
857,07/07/2021,1007,121,848,9,159,02/07/2021,"Tignanello, Toscana",Tuscany,2017,10/07/2021,10953912017,1095391
8000,09/07/2021,8299,4,7330,670,969,02/06/2021,"Domaine Leflaive, Chevalier-Montrachet Grand Cru",Burgundy,2018,10/07/2021,10734012018,1073401
860,09/07/2021,1023,94,936,-76,87,06/07/2021,"Tignanello, Toscana",Tuscany,2018,10/07/2021,10953912018,1095391
2580,26/07/2021,3314,58,2500,80,814,26/07/2021,"Chateau Angelus Premier Grand Cru Classe A, Saint-Emilion Grand Cru",Bordeaux,2015,03/08/2021,10060452015,1006045
415,23/07/2021,523,38,364,51,159,12/05/2021,"Chateau Batailley 5eme Cru Classe, Pauillac",Bordeaux,2016,24/07/2021,10063222016,1006322
920,09/07/2021,1038,36,842,78,196,22/08/2020,"Chateau Calon Segur 3eme Cru Classe, Saint-Estephe",Bordeaux,2019,10/07/2021,10074752019,1007475
1408,09/07/2021,1480,21,1820,-412,-340,08/07/2021,"Gaja, Barbaresco",Piedmont,2018,10/07/2021,10996052018,1099605
990,26/07/2021,1162,64,1029,-39,133,21/07/2021,"Chateau Calon Segur 3eme Cru Classe, Saint-Estephe",Bordeaux,2005,27/07/2021,10074752005,1007475
402,23/07/2021,413,27,357,45,56,06/05/2021,"Chateau Batailley 5eme Cru Classe, Pauillac",Bordeaux,2018,24/07/2021,10063222018,1006322
3900,26/07/2021,4672,89,3822,78,850,20/06/2021,"Chateau Margaux Premier Cru Classe, Margaux",Bordeaux,2006,27/07/2021,10127812006,1012781
3750,26/07/2021,4268,89,3525,225,743,18/06/2021,"Chateau Margaux Premier Cru Classe, Margaux",Bordeaux,2007,27/07/2021,10127812007,1012781
880,26/07/2021,980,7,725,155,255,13/04/2021,"Chateau Calon Segur 3eme Cru Classe, Saint-Estephe",Bordeaux,2007,27/07/2021,10074752007,1007475
2580,26/07/2021,3720,43,2500,80,1220,26/07/2021,"Chateau Angelus Premier Grand Cru Classe A, Saint-Emilion Grand Cru",Bordeaux,2015,27/07/2021,10060452015,1006045
2580,15/07/2021,3712,47,2510,70,1202,16/06/2021,"Chateau Angelus Premier Grand Cru Classe A, Saint-Emilion Grand Cru",Bordeaux,2015,16/07/2021,10060452015,1006045
3950,09/07/2021,4354,63,3870,80,484,10/07/2021,"Chateau Margaux Premier Cru Classe, Margaux",Bordeaux,2008,11/07/2021,10127812008,1012781
685,26/07/2021,914,2,470,215,444,29/03/2018,"Chateau Batailley 5eme Cru Classe, Pauillac",Bordeaux,2000,27/07/2021,10063222000,1006322
1248,08/07/2021,1330,5,1238,10,92,02/11/2020,"Tignanello, Toscana",Tuscany,2006,11/07/2021,10953912006,1095391
2580,15/07/2021,3724,46,2510,70,1214,16/06/2021,"Chateau Angelus Premier Grand Cru Classe A, Saint-Emilion Grand Cru",Bordeaux,2015,19/07/2021,10060452015,1006045
685,26/07/2021,914,2,470,215,444,29/03/2018,"Chateau Batailley 5eme Cru Classe, Pauillac",Bordeaux,2000,27/07/2021,10063222000,1006322
3900,09/07/2021,4712,79,3822,78,890,20/06/2021,"Chateau Margaux Premier Cru Classe, Margaux",Bordeaux,2006,12/07/2021,10127812006,1012781
550,26/07/2021,570,4,420,130,150,09/07/2019,"Chateau Batailley 5eme Cru Classe, Pauillac",Bordeaux,2003,27/07/2021,10063222003,1006322
1050,09/07/2021,1079,8,880,170,199,22/06/2021,"Tignanello, Toscana",Tuscany,2011,12/07/2021,10953912011,1095391
8400,26/07/2021,8400,1,5700,2700,2700,10/09/2020,"Domaine Leflaive, Chevalier-Montrachet Grand Cru",Burgundy,2007,27/07/2021,10734012007,1073401
2580,15/07/2021,3708,43,2510,70,1198,16/06/2021,"Chateau Angelus Premier Grand Cru Classe A, Saint-Emilion Grand Cru",Bordeaux,2015,20/07/2021,10060452015,1006045
3900,26/07/2021,4374,84,3780,120,594,23/07/2021,"Chateau Margaux Premier Cru Classe, Margaux",Bordeaux,2008,27/07/2021,10127812008,1012781
895,26/07/2021,953,8,781,114,172,16/11/2020,"Chateau Calon Segur 3eme Cru Classe, Saint-Estephe",Bordeaux,2008,27/07/2021,10074752008,1007475
550,26/07/2021,603,3,420,130,183,09/07/2019,"Chateau Batailley 5eme Cru Classe, Pauillac",Bordeaux,2003,01/08/2021,10063222003,1006322
6930,26/07/2021,7716,60,7086,-156,630,11/06/2021,"Chateau Margaux Premier Cru Classe, Margaux",Bordeaux,2009,27/07/2021,10127812009,1012781
9000,26/07/2021,8799,1,5400,3600,3399,13/08/2020,"Domaine Leflaive, Chevalier-Montrachet Grand Cru",Burgundy,2008,27/07/2021,10734012008,1073401
996,26/07/2021,1218,54,1026,-30,192,24/06/2021,"Chateau Calon Segur 3eme Cru Classe, Saint-Estephe",Bordeaux,2009,27/07/2021,10074752009,1007475
450,26/07/2021,532,2,300,150,232,15/12/2019,"Chateau Batailley 5eme Cru Classe, Pauillac",Bordeaux,2004,27/07/2021,10063222004,1006322
2580,15/07/2021,3709,43,2510,70,1199,16/06/2021,"Chateau Angelus Premier Grand Cru Classe A, Saint-Emilion Grand Cru",Bordeaux,2015,22/07/2021,10060452015,1006045
870,12/07/2021,966,5,705,165,261,01/02/2021,"Chateau Calon Segur 3eme Cru Classe, Saint-Estephe",Bordeaux,2002,13/07/2021,10074752002,1007475
8100,12/07/2021,8967,13,8100,0,867,21/06/2021,"Chateau Margaux Premier Cru Classe, Margaux",Bordeaux,2000,13/07/2021,10127812000,1012781
2580,05/07/2021,3700,47,2510,70,1190,16/06/2021,"Chateau Angelus Premier Grand Cru Classe A, Saint-Emilion Grand Cru",Bordeaux,2015,06/07/2021,10060452015,1006045
900,12/07/2021,1156,20,800,100,356,21/11/2019,"Chateau Calon Segur 3eme Cru Classe, Saint-Estephe",Bordeaux,2003,13/07/2021,10074752003,1007475
4450,12/07/2021,4805,24,4400,50,405,29/09/2020,"Chateau Margaux Premier Cru Classe, Margaux",Bordeaux,2001,13/07/2021,10127812001,1012781
3900,12/07/2021,4425,22,3684,216,741,10/06/2020,"Chateau Margaux Premier Cru Classe, Margaux",Bordeaux,2002,13/07/2021,10127812002,1012781
3826,12/07/2021,4575,49,4116,-290,459,25/02/2021,"Chateau Margaux Premier Cru Classe, Margaux",Bordeaux,2004,13/07/2021,10127812004,1012781
2580,05/07/2021,3725,46,2510,70,1215,16/06/2021,"Chateau Angelus Premier Grand Cru Classe A, Saint-Emilion Grand Cru",Bordeaux,2015,09/07/2021,10060452015,1006045
980,12/07/2021,974,16,745,235,229,16/11/2020,"Chateau Calon Segur 3eme Cru Classe, Saint-Estephe",Bordeaux,2004,13/07/2021,10074752004,1007475
1130,07/07/2021,1164,13,1012,118,152,02/07/2021,"Tignanello, Toscana",Tuscany,2015,12/07/2021,10953912015,1095391
2580,05/07/2021,3712,47,2510,70,1202,16/06/2021,"Chateau Angelus Premier Grand Cru Classe A, Saint-Emilion Grand Cru",Bordeaux,2015,13/07/2021,10060452015,1006045
1083,07/07/2021,1218,79,1036,47,182,27/05/2021,"Chateau Calon Segur 3eme Cru Classe, Saint-Estephe",Bordeaux,2016,12/07/2021,10074752016,1007475
588,26/07/2021,624,49,520,68,104,17/06/2021,"Chateau Batailley 5eme Cru Classe, Pauillac",Bordeaux,2005,27/07/2021,10063222005,1006322
8000,09/07/2021,8676,4,6974,1026,1702,14/03/2021,"Domaine Leflaive, Chevalier-Montrachet Grand Cru",Burgundy,2017,12/07/2021,10734012017,1073401
1080,09/07/2021,1244,40,1016,64,228,11/07/2021,"Chateau Calon Segur 3eme Cru Classe, Saint-Estephe",Bordeaux,2018,12/07/2021,10074752018,1007475
588,26/07/2021,624,49,520,68,104,17/06/2021,"Chateau Batailley 5eme Cru Classe, Pauillac",Bordeaux,2005,27/07/2021,10063222005,1006322
3900,09/07/2021,4712,79,3822,78,890,20/06/2021,"Chateau Margaux Premier Cru Classe, Margaux",Bordeaux,2006,12/07/2021,10127812006,1012781
2580,24/06/2021,3696,47,2510,70,1186,16/06/2021,"Chateau Angelus Premier Grand Cru Classe A, Saint-Emilion Grand Cru",Bordeaux,2015,05/07/2021,10060452015,1006045
907,12/07/2021,926,18,805,102,121,20/11/2019,"Chateau Calon Segur 3eme Cru Classe, Saint-Estephe",Bordeaux,2001,13/07/2021,10074752001,1007475
465,26/07/2021,458,2,400,65,58,11/05/2021,"Chateau Batailley 5eme Cru Classe, Pauillac",Bordeaux,2006,27/07/2021,10063222006,1006322
2580,24/06/2021,3117,68,2510,70,607,16/06/2021,"Chateau Angelus Premier Grand Cru Classe A, Saint-Emilion Grand Cru",Bordeaux,2015,26/06/2021,10060452015,1006045
465,26/07/2021,458,2,400,65,58,11/05/2021,"Chateau Batailley 5eme Cru Classe, Pauillac",Bordeaux,2006,27/07/2021,10063222006,1006322
6500,12/07/2021,7285,27,6776,-276,509,10/06/2021,"Chateau Margaux Premier Cru Classe, Margaux",Bordeaux,2005,13/07/2021,10127812005,1012781
2580,24/06/2021,3123,68,2510,70,613,16/06/2021,"Chateau Angelus Premier Grand Cru Classe A, Saint-Emilion Grand Cru",Bordeaux,2015,29/06/2021,10060452015,1006045
1000,12/07/2021,1167,81,988,12,179,28/05/2021,"Chateau Calon Segur 3eme Cru Classe, Saint-Estephe",Bordeaux,2005,13/07/2021,10074752005,1007475
895,12/07/2021,921,39,863,32,58,10/05/2021,"Chateau Calon Segur 3eme Cru Classe, Saint-Estephe",Bordeaux,2006,13/07/2021,10074752006,1007475
3900,12/07/2021,4698,82,3822,78,876,20/06/2021,"Chateau Margaux Premier Cru Classe, Margaux",Bordeaux,2006,13/07/2021,10127812006,1012781
450,26/07/2021,431,3,332,118,99,06/10/2020,"Chateau Batailley 5eme Cru Classe, Pauillac",Bordeaux,2008,27/07/2021,10063222008,1006322
3560,12/07/2021,4240,83,3525,35,715,18/06/2021,"Chateau Margaux Premier Cru Classe, Margaux",Bordeaux,2007,13/07/2021,10127812007,1012781
880,12/07/2021,980,7,725,155,255,13/04/2021,"Chateau Calon Segur 3eme Cru Classe, Saint-Estephe",Bordeaux,2007,13/07/2021,10074752007,1007475
2580,24/06/2021,3108,67,2510,70,598,16/06/2021,"Chateau Angelus Premier Grand Cru Classe A, Saint-Emilion Grand Cru",Bordeaux,2015,28/06/2021,10060452015,1006045
960,09/07/2021,1286,11,850,110,436,28/01/2021,"Tignanello, Toscana",Tuscany,2012,10/07/2021,10953912012,1095391
2580,24/06/2021,3113,69,2510,70,603,16/06/2021,"Chateau Angelus Premier Grand Cru Classe A, Saint-Emilion Grand Cru",Bordeaux,2015,25/06/2021,10060452015,1006045
3800,09/07/2021,4345,121,3480,320,865,17/06/2021,"Chateau Margaux Premier Cru Classe, Margaux",Bordeaux,2014,10/07/2021,10127812014,1012781
790,09/07/2021,878,19,801,-11,77,31/05/2021,"Chateau Calon Segur 3eme Cru Classe, Saint-Estephe",Bordeaux,2014,10/07/2021,10074752014,1007475
500,26/07/2021,513,7,450,50,63,25/05/2021,"Chateau Batailley 5eme Cru Classe, Pauillac",Bordeaux,2009,27/07/2021,10063222009,1006322
6400,09/07/2021,7251,25,6776,-376,475,10/06/2021,"Chateau Margaux Premier Cru Classe, Margaux",Bordeaux,2005,11/07/2021,10127812005,1012781
2580,24/06/2021,3569,56,2510,70,1059,16/06/2021,"Chateau Angelus Premier Grand Cru Classe A, Saint-Emilion Grand Cru",Bordeaux,2015,03/07/2021,10060452015,1006045
3950,09/07/2021,4354,63,3870,80,484,10/07/2021,"Chateau Margaux Premier Cru Classe, Margaux",Bordeaux,2008,11/07/2021,10127812008,1012781
500,26/07/2021,513,7,450,50,63,25/05/2021,"Chateau Batailley 5eme Cru Classe, Pauillac",Bordeaux,2009,27/07/2021,10063222009,1006322
1248,08/07/2021,1330,5,1238,10,92,02/11/2020,"Tignanello, Toscana",Tuscany,2006,11/07/2021,10953912006,1095391
2580,14/06/2021,3118,72,2500,80,618,18/05/2021,"Chateau Angelus Premier Grand Cru Classe A, Saint-Emilion Grand Cru",Bordeaux,2015,15/06/2021,10060452015,1006045
1592,06/07/2021,1566,15,1300,292,266,10/07/2021,"Gaja, Barbaresco",Piedmont,2014,11/07/2021,10996052014,1099605
2580,14/06/2021,3118,69,2510,70,608,16/06/2021,"Chateau Angelus Premier Grand Cru Classe A, Saint-Emilion Grand Cru",Bordeaux,2015,21/06/2021,10060452015,1006045
3950,12/07/2021,4350,67,3870,80,480,10/07/2021,"Chateau Margaux Premier Cru Classe, Margaux",Bordeaux,2008,13/07/2021,10127812008,1012781
895,12/07/2021,978,10,781,114,197,16/11/2020,"Chateau Calon Segur 3eme Cru Classe, Saint-Estephe",Bordeaux,2008,13/07/2021,10074752008,1007475
6880,12/07/2021,7753,48,7086,-206,667,11/06/2021,"Chateau Margaux Premier Cru Classe, Margaux",Bordeaux,2009,13/07/2021,10127812009,1012781
1000,12/07/2021,1239,52,1026,-26,213,24/06/2021,"Chateau Calon Segur 3eme Cru Classe, Saint-Estephe",Bordeaux,2009,13/07/2021,10074752009,1007475
525,26/07/2021,595,400,494,31,101,20/04/2021,"Chateau Batailley 5eme Cru Classe, Pauillac",Bordeaux,2010,28/07/2021,10063222010,1006322
2580,14/06/2021,3114,72,2500,80,614,18/05/2021,"Chateau Angelus Premier Grand Cru Classe A, Saint-Emilion Grand Cru",Bordeaux,2015,16/06/2021,10060452015,1006045
2500,12/07/2021,2632,3,2220,280,412,14/06/2021,"Gaja, Barbaresco",Piedmont,2001,13/07/2021,10996052001,1099605
2098,12/07/2021,2366,3,2190,-92,176,01/05/2021,"Gaja, Barbaresco",Piedmont,2004,13/07/2021,10996052004,1099605
1300,08/07/2021,1425,1,1200,100,225,06/03/2021,"Tignanello, Toscana",Tuscany,2007,13/07/2021,10953912007,1095391
6400,12/07/2021,7538,48,6190,210,1348,08/07/2021,"Chateau Margaux Premier Cru Classe, Margaux",Bordeaux,2010,13/07/2021,10127812010,1012781
525,26/07/2021,595,401,494,31,101,20/04/2021,"Chateau Batailley 5eme Cru Classe, Pauillac",Bordeaux,2010,27/07/2021,10063222010,1006322
990,12/07/2021,1134,16,990,0,144,16/06/2021,"Chateau Calon Segur 3eme Cru Classe, Saint-Estephe",Bordeaux,2010,13/07/2021,10074752010,1007475
750,12/07/2021,989,35,790,-40,199,01/06/2020,"Chateau Calon Segur 3eme Cru Classe, Saint-Estephe",Bordeaux,2011,13/07/2021,10074752011,1007475
1024,12/07/2021,1306,3,1072,-48,234,20/01/2021,"Tignanello, Toscana",Tuscany,2009,13/07/2021,10953912009,1095391
1326,12/07/2021,1559,4,1170,156,389,24/06/2021,"Tignanello, Toscana",Tuscany,2010,13/07/2021,10953912010,1095391
3600,07/07/2021,4332,73,3690,-90,642,13/04/2021,"Chateau Margaux Premier Cru Classe, Margaux",Bordeaux,2011,13/07/2021,10127812011,1012781
2580,14/06/2021,3118,72,2510,70,608,16/06/2021,"Chateau Angelus Premier Grand Cru Classe A, Saint-Emilion Grand Cru",Bordeaux,2015,18/06/2021,10060452015,1006045
525,26/07/2021,595,401,494,31,101,20/04/2021,"Chateau Batailley 5eme Cru Classe, Pauillac",Bordeaux,2010,27/07/2021,10063222010,1006322
1050,12/07/2021,1079,8,880,170,199,22/06/2021,"Tignanello, Toscana",Tuscany,2011,13/07/2021,10953912011,1095391
2580,14/06/2021,3114,72,2510,70,604,16/06/2021,"Chateau Angelus Premier Grand Cru Classe A, Saint-Emilion Grand Cru",Bordeaux,2015,17/06/2021,10060452015,1006045
525,26/07/2021,595,400,494,31,101,20/04/2021,"Chateau Batailley 5eme Cru Classe, Pauillac",Bordeaux,2010,28/07/2021,10063222010,1006322
6400,09/07/2021,7251,25,6776,-376,475,10/06/2021,"Chateau Margaux Premier Cru Classe, Margaux",Bordeaux,2005,11/07/2021,10127812005,1012781
2580,14/06/2021,3118,70,2510,70,608,16/06/2021,"Chateau Angelus Premier Grand Cru Classe A, Saint-Emilion Grand Cru",Bordeaux,2015,19/06/2021,10060452015,1006045
400,26/07/2021,418,8,408,-8,10,14/07/2021,"Chateau Batailley 5eme Cru Classe, Pauillac",Bordeaux,2012,27/07/2021,10063222012,1006322
820,12/07/2021,937,6,735,85,202,09/09/2020,"Chateau Calon Segur 3eme Cru Classe, Saint-Estephe",Bordeaux,2012,13/07/2021,10074752012,1007475
3750,05/07/2021,4278,41,3560,190,718,20/11/2020,"Chateau Margaux Premier Cru Classe, Margaux",Bordeaux,2012,13/07/2021,10127812012,1012781
3740,12/07/2021,4067,27,3520,220,547,07/04/2021,"Chateau Margaux Premier Cru Classe, Margaux",Bordeaux,2013,13/07/2021,10127812013,1012781
2580,04/06/2021,3118,71,2500,80,618,18/05/2021,"Chateau Angelus Premier Grand Cru Classe A, Saint-Emilion Grand Cru",Bordeaux,2015,09/06/2021,10060452015,1006045
686,12/07/2021,809,7,682,4,127,15/09/2020,"Chateau Calon Segur 3eme Cru Classe, Saint-Estephe",Bordeaux,2013,13/07/2021,10074752013,1007475
960,12/07/2021,1305,11,850,110,455,28/01/2021,"Tignanello, Toscana",Tuscany,2012,13/07/2021,10953912012,1095391
2580,04/06/2021,3115,72,2500,80,615,18/05/2021,"Chateau Angelus Premier Grand Cru Classe A, Saint-Emilion Grand Cru",Bordeaux,2015,10/06/2021,10060452015,1006045
3800,12/07/2021,4342,123,3480,320,862,17/06/2021,"Chateau Margaux Premier Cru Classe, Margaux",Bordeaux,2014,13/07/2021,10127812014,1012781
1090,12/07/2021,1139,7,860,230,279,08/03/2021,"Tignanello, Toscana",Tuscany,2013,13/07/2021,10953912013,1095391
984,12/07/2021,1106,45,830,154,276,22/06/2021,"Tignanello, Toscana",Tuscany,2014,13/07/2021,10953912014,1095391
940,12/07/2021,1091,77,822,118,269,28/06/2021,"Chateau Calon Segur 3eme Cru Classe, Saint-Estephe",Bordeaux,2015,13/07/2021,10074752015,1007475
10400,12/07/2021,11802,52,9800,600,2002,11/06/2021,"Chateau Margaux Premier Cru Classe, Margaux",Bordeaux,2015,13/07/2021,10127812015,1012781
400,26/07/2021,418,8,408,-8,10,14/07/2021,"Chateau Batailley 5eme Cru Classe, Pauillac",Bordeaux,2012,27/07/2021,10063222012,1006322
1050,09/07/2021,1079,8,880,170,199,22/06/2021,"Tignanello, Toscana",Tuscany,2011,12/07/2021,10953912011,1095391
870,12/07/2021,966,5,705,165,261,01/02/2021,"Chateau Calon Segur 3eme Cru Classe, Saint-Estephe",Bordeaux,2002,13/07/2021,10074752002,1007475
8100,12/07/2021,8967,13,8100,0,867,21/06/2021,"Chateau Margaux Premier Cru Classe, Margaux",Bordeaux,2000,13/07/2021,10127812000,1012781
2580,04/06/2021,3117,70,2500,80,617,18/05/2021,"Chateau Angelus Premier Grand Cru Classe A, Saint-Emilion Grand Cru",Bordeaux,2015,05/06/2021,10060452015,1006045
900,12/07/2021,1156,20,800,100,356,21/11/2019,"Chateau Calon Segur 3eme Cru Classe, Saint-Estephe",Bordeaux,2003,13/07/2021,10074752003,1007475
4450,12/07/2021,4805,24,4400,50,405,29/09/2020,"Chateau Margaux Premier Cru Classe, Margaux",Bordeaux,2001,13/07/2021,10127812001,1012781
3826,12/07/2021,4575,49,4116,-290,459,25/02/2021,"Chateau Margaux Premier Cru Classe, Margaux",Bordeaux,2004,13/07/2021,10127812004,1012781
3900,12/07/2021,4425,22,3684,216,741,10/06/2020,"Chateau Margaux Premier Cru Classe, Margaux",Bordeaux,2002,13/07/2021,10127812002,1012781
2580,04/06/2021,3118,72,2500,80,618,18/05/2021,"Chateau Angelus Premier Grand Cru Classe A, Saint-Emilion Grand Cru",Bordeaux,2015,11/06/2021,10060452015,1006045
980,12/07/2021,974,16,745,235,229,16/11/2020,"Chateau Calon Segur 3eme Cru Classe, Saint-Estephe",Bordeaux,2004,13/07/2021,10074752004,1007475
2518,31/05/2021,3117,73,2500,18,617,18/05/2021,"Chateau Angelus Premier Grand Cru Classe A, Saint-Emilion Grand Cru",Bordeaux,2015,01/06/2021,10060452015,1006045
907,12/07/2021,926,18,805,102,121,20/11/2019,"Chateau Calon Segur 3eme Cru Classe, Saint-Estephe",Bordeaux,2001,13/07/2021,10074752001,1007475
320,26/07/2021,320,109,304,16,16,10/01/2021,"Chateau Batailley 5eme Cru Classe, Pauillac",Bordeaux,2013,27/07/2021,10063222013,1006322
2518,31/05/2021,3121,72,2500,18,621,18/05/2021,"Chateau Angelus Premier Grand Cru Classe A, Saint-Emilion Grand Cru",Bordeaux,2015,03/06/2021,10060452015,1006045
360,26/07/2021,370,71,360,0,10,14/07/2021,"Chateau Batailley 5eme Cru Classe, Pauillac",Bordeaux,2014,27/07/2021,10063222014,1006322
6500,12/07/2021,7285,27,6776,-276,509,10/06/2021,"Chateau Margaux Premier Cru Classe, Margaux",Bordeaux,2005,13/07/2021,10127812005,1012781
2570,28/05/2021,3117,73,2500,70,617,18/05/2021,"Chateau Angelus Premier Grand Cru Classe A, Saint-Emilion Grand Cru",Bordeaux,2015,31/05/2021,10060452015,1006045
1000,12/07/2021,1167,81,988,12,179,28/05/2021,"Chateau Calon Segur 3eme Cru Classe, Saint-Estephe",Bordeaux,2005,13/07/2021,10074752005,1007475
415,26/07/2021,523,38,364,51,159,12/05/2021,"Chateau Batailley 5eme Cru Classe, Pauillac",Bordeaux,2016,27/07/2021,10063222016,1006322
895,12/07/2021,921,39,863,32,58,10/05/2021,"Chateau Calon Segur 3eme Cru Classe, Saint-Estephe",Bordeaux,2006,13/07/2021,10074752006,1007475
3900,12/07/2021,4698,82,3822,78,876,20/06/2021,"Chateau Margaux Premier Cru Classe, Margaux",Bordeaux,2006,13/07/2021,10127812006,1012781
3560,12/07/2021,4240,83,3525,35,715,18/06/2021,"Chateau Margaux Premier Cru Classe, Margaux",Bordeaux,2007,13/07/2021,10127812007,1012781
880,12/07/2021,980,7,725,155,255,13/04/2021,"Chateau Calon Segur 3eme Cru Classe, Saint-Estephe",Bordeaux,2007,13/07/2021,10074752007,1007475
2570,28/05/2021,3130,75,2500,70,630,18/05/2021,"Chateau Angelus Premier Grand Cru Classe A, Saint-Emilion Grand Cru",Bordeaux,2015,29/05/2021,10060452015,1006045
2570,26/05/2021,3123,75,2500,70,623,18/05/2021,"Chateau Angelus Premier Grand Cru Classe A, Saint-Emilion Grand Cru",Bordeaux,2015,27/05/2021,10060452015,1006045
3950,12/07/2021,4350,67,3870,80,480,10/07/2021,"Chateau Margaux Premier Cru Classe, Margaux",Bordeaux,2008,13/07/2021,10127812008,1012781
450,27/07/2021,532,2,300,150,232,15/12/2019,"Chateau Batailley 5eme Cru Classe, Pauillac",Bordeaux,2004,28/07/2021,10063222004,1006322
895,12/07/2021,978,10,781,114,197,16/11/2020,"Chateau Calon Segur 3eme Cru Classe, Saint-Estephe",Bordeaux,2008,13/07/2021,10074752008,1007475
6880,12/07/2021,7753,48,7086,-206,667,11/06/2021,"Chateau Margaux Premier Cru Classe, Margaux",Bordeaux,2009,13/07/2021,10127812009,1012781
1000,12/07/2021,1239,52,1026,-26,213,24/06/2021,"Chateau Calon Segur 3eme Cru Classe, Saint-Estephe",Bordeaux,2009,13/07/2021,10074752009,1007475
320,27/07/2021,320,109,304,16,16,10/01/2021,"Chateau Batailley 5eme Cru Classe, Pauillac",Bordeaux,2013,28/07/2021,10063222013,1006322
2570,26/05/2021,3131,76,2500,70,631,18/05/2021,"Chateau Angelus Premier Grand Cru Classe A, Saint-Emilion Grand Cru",Bordeaux,2015,28/05/2021,10060452015,1006045
6600,12/07/2021,6451,1,5360,1240,1091,18/09/2020,"Domaine Leflaive, Chevalier-Montrachet Grand Cru",Burgundy,2009,13/07/2021,10734012009,1073401
1850,12/07/2021,1831,1,1180,670,651,10/03/2017,"Gaja, Barbaresco",Piedmont,2005,13/07/2021,10996052005,1099605
1800,12/07/2021,1700,1,1300,500,400,30/05/2019,"Gaja, Barbaresco",Piedmont,2007,13/07/2021,10996052007,1099605
2437,12/07/2021,2719,1,1768,669,951,22/05/2020,"Gaja, Barbaresco",Piedmont,2000,13/07/2021,10996052000,1099605
2500,12/07/2021,2632,3,2220,280,412,14/06/2021,"Gaja, Barbaresco",Piedmont,2001,13/07/2021,10996052001,1099605
2098,12/07/2021,2366,3,2190,-92,176,01/05/2021,"Gaja, Barbaresco",Piedmont,2004,13/07/2021,10996052004,1099605
574,12/07/2021,574,1,351,223,223,25/07/2016,"Tua Rita, Giusto di Notri, Toscana",Tuscany,2004,13/07/2021,11058072004,1105807
520,12/07/2021,563,3,460,60,103,05/05/2020,"Tua Rita, Giusto di Notri, Toscana",Tuscany,2008,13/07/2021,11058072008,1105807
660,12/07/2021,727,5,390,270,337,18/08/2017,"Tua Rita, Giusto di Notri, Toscana",Tuscany,2006,13/07/2021,11058072006,1105807
1300,08/07/2021,1425,1,1200,100,225,06/03/2021,"Tignanello, Toscana",Tuscany,2007,13/07/2021,10953912007,1095391
6400,12/07/2021,7538,48,6190,210,1348,08/07/2021,"Chateau Margaux Premier Cru Classe, Margaux",Bordeaux,2010,13/07/2021,10127812010,1012781
360,27/07/2021,370,71,360,0,10,14/07/2021,"Chateau Batailley 5eme Cru Classe, Pauillac",Bordeaux,2014,28/07/2021,10063222014,1006322
990,12/07/2021,1134,16,990,0,144,16/06/2021,"Chateau Calon Segur 3eme Cru Classe, Saint-Estephe",Bordeaux,2010,13/07/2021,10074752010,1007475
750,12/07/2021,989,35,790,-40,199,01/06/2020,"Chateau Calon Segur 3eme Cru Classe, Saint-Estephe",Bordeaux,2011,13/07/2021,10074752011,1007475
8400,12/07/2021,8400,1,5960,2440,2440,01/08/2017,"Domaine Leflaive, Chevalier-Montrachet Grand Cru",Burgundy,2010,13/07/2021,10734012010,1073401
1024,12/07/2021,1306,3,1072,-48,234,20/01/2021,"Tignanello, Toscana",Tuscany,2009,13/07/2021,10953912009,1095391
1326,12/07/2021,1559,4,1170,156,389,24/06/2021,"Tignanello, Toscana",Tuscany,2010,13/07/2021,10953912010,1095391
3600,07/07/2021,4332,73,3690,-90,642,13/04/2021,"Chateau Margaux Premier Cru Classe, Margaux",Bordeaux,2011,13/07/2021,10127812011,1012781
2570,24/05/2021,3123,75,2500,70,623,18/05/2021,"Chateau Angelus Premier Grand Cru Classe A, Saint-Emilion Grand Cru",Bordeaux,2015,26/05/2021,10060452015,1006045
2199,12/07/2021,2229,1,1340,859,889,13/03/2020,"Gaja, Barbaresco",Piedmont,2009,13/07/2021,10996052009,1099605
1050,12/07/2021,1079,8,880,170,199,22/06/2021,"Tignanello, Toscana",Tuscany,2011,13/07/2021,10953912011,1095391
2570,24/05/2021,3050,105,2500,70,550,18/05/2021,"Chateau Angelus Premier Grand Cru Classe A, Saint-Emilion Grand Cru",Bordeaux,2015,25/05/2021,10060452015,1006045
685,28/07/2021,914,2,470,215,444,29/03/2018,"Chateau Batailley 5eme Cru Classe, Pauillac",Bordeaux,2000,29/07/2021,10063222000,1006322
820,12/07/2021,937,6,735,85,202,09/09/2020,"Chateau Calon Segur 3eme Cru Classe, Saint-Estephe",Bordeaux,2012,13/07/2021,10074752012,1007475
3750,05/07/2021,4278,41,3560,190,718,20/11/2020,"Chateau Margaux Premier Cru Classe, Margaux",Bordeaux,2012,13/07/2021,10127812012,1012781
13200,12/07/2021,12867,1,12850,350,17,30/11/2020,"Jacques-Frederic Mugnier, Chambolle-Musigny Premier Cru, Les Amoureuses",Burgundy,2011,13/07/2021,10496422011,1049642
3740,12/07/2021,4067,27,3520,220,547,07/04/2021,"Chateau Margaux Premier Cru Classe, Margaux",Bordeaux,2013,13/07/2021,10127812013,1012781
2580,24/05/2021,3122,72,2500,80,622,18/05/2021,"Chateau Angelus Premier Grand Cru Classe A, Saint-Emilion Grand Cru",Bordeaux,2015,04/06/2021,10060452015,1006045
685,28/07/2021,914,2,470,215,444,29/03/2018,"Chateau Batailley 5eme Cru Classe, Pauillac",Bordeaux,2000,29/07/2021,10063222000,1006322
686,12/07/2021,809,7,682,4,127,15/09/2020,"Chateau Calon Segur 3eme Cru Classe, Saint-Estephe",Bordeaux,2013,13/07/2021,10074752013,1007475
1380,12/07/2021,1442,7,1352,28,90,23/09/2020,"Gaja, Barbaresco",Piedmont,2011,13/07/2021,10996052011,1099605
960,12/07/2021,1305,11,850,110,455,28/01/2021,"Tignanello, Toscana",Tuscany,2012,13/07/2021,10953912012,1095391
2570,20/05/2021,3051,107,2500,70,551,18/05/2021,"Chateau Angelus Premier Grand Cru Classe A, Saint-Emilion Grand Cru",Bordeaux,2015,21/05/2021,10060452015,1006045
3800,12/07/2021,4342,123,3480,320,862,17/06/2021,"Chateau Margaux Premier Cru Classe, Margaux",Bordeaux,2014,13/07/2021,10127812014,1012781
450,28/07/2021,532,2,300,150,232,15/12/2019,"Chateau Batailley 5eme Cru Classe, Pauillac",Bordeaux,2004,29/07/2021,10063222004,1006322
1550,12/07/2021,1557,1,1300,250,257,27/04/2021,"Gaja, Barbaresco",Piedmont,2012,13/07/2021,10996052012,1099605
1090,12/07/2021,1139,7,860,230,279,08/03/2021,"Tignanello, Toscana",Tuscany,2013,13/07/2021,10953912013,1095391
984,12/07/2021,1106,45,830,154,276,22/06/2021,"Tignanello, Toscana",Tuscany,2014,13/07/2021,10953912014,1095391
1400,12/07/2021,1529,14,1300,100,229,30/06/2021,"Gaja, Barbaresco",Piedmont,2013,13/07/2021,10996052013,1099605
2570,20/05/2021,3045,106,2500,70,545,18/05/2021,"Chateau Angelus Premier Grand Cru Classe A, Saint-Emilion Grand Cru",Bordeaux,2015,24/05/2021,10060452015,1006045
940,12/07/2021,1091,77,822,118,269,28/06/2021,"Chateau Calon Segur 3eme Cru Classe, Saint-Estephe",Bordeaux,2015,13/07/2021,10074752015,1007475
10400,12/07/2021,11802,52,9800,600,2002,11/06/2021,"Chateau Margaux Premier Cru Classe, Margaux",Bordeaux,2015,13/07/2021,10127812015,1012781
14520,12/07/2021,14520,1,12000,2520,2520,28/05/2020,"Jacques-Frederic Mugnier, Chambolle-Musigny Premier Cru, Les Amoureuses",Burgundy,2014,13/07/2021,10496422014,1049642
487,12/07/2021,540,20,388,99,152,29/09/2020,"Tua Rita, Giusto di Notri, Toscana",Tuscany,2015,13/07/2021,11058072015,1105807
5415,05/07/2021,5863,118,5500,-85,363,06/07/2021,"Chateau Margaux Premier Cru Classe, Margaux",Bordeaux,2016,13/07/2021,10127812016,1012781
2510,18/05/2021,3060,104,2500,10,560,18/05/2021,"Chateau Angelus Premier Grand Cru Classe A, Saint-Emilion Grand Cru",Bordeaux,2015,19/05/2021,10060452015,1006045
588,28/07/2021,624,49,520,68,104,17/06/2021,"Chateau Batailley 5eme Cru Classe, Pauillac",Bordeaux,2005,29/07/2021,10063222005,1006322
1240,12/07/2021,1282,87,1144,96,138,06/07/2021,"Tignanello, Toscana",Tuscany,2016,13/07/2021,10953912016,1095391
2570,18/05/2021,3051,107,2500,70,551,18/05/2021,"Chateau Angelus Premier Grand Cru Classe A, Saint-Emilion Grand Cru",Bordeaux,2015,20/05/2021,10060452015,1006045
780,12/07/2021,935,78,740,40,195,21/05/2021,"Chateau Calon Segur 3eme Cru Classe, Saint-Estephe",Bordeaux,2017,13/07/2021,10074752017,1007475
588,28/07/2021,624,49,520,68,104,17/06/2021,"Chateau Batailley 5eme Cru Classe, Pauillac",Bordeaux,2005,29/07/2021,10063222005,1006322
3790,12/07/2021,4446,128,3950,-160,496,30/06/2021,"Chateau Margaux Premier Cru Classe, Margaux",Bordeaux,2017,13/07/2021,10127812017,1012781
1350,12/07/2021,1480,56,1260,90,220,18/02/2021,"Gaja, Barbaresco",Piedmont,2015,13/07/2021,10996052015,1099605
460,12/07/2021,487,154,420,40,67,28/05/2021,"Tua Rita, Giusto di Notri, Toscana",Tuscany,2016,13/07/2021,11058072016,1105807
8000,12/07/2021,8676,4,6974,1026,1702,14/03/2021,"Domaine Leflaive, Chevalier-Montrachet Grand Cru",Burgundy,2017,13/07/2021,10734012017,1073401
7527,12/07/2021,9750,3,7290,237,2460,21/08/2020,"Domaine Denis Mortet, Chambertin Grand Cru",Burgundy,2017,13/07/2021,10490202017,1049020
2510,17/05/2021,3062,104,2502,8,560,19/03/2021,"Chateau Angelus Premier Grand Cru Classe A, Saint-Emilion Grand Cru",Bordeaux,2015,18/05/2021,10060452015,1006045
5415,08/07/2021,5830,100,5254,161,576,26/05/2021,"Chateau Margaux Premier Cru Classe, Margaux",Bordeaux,2018,13/07/2021,10127812018,1012781
1080,12/07/2021,1244,40,1016,64,228,11/07/2021,"Chateau Calon Segur 3eme Cru Classe, Saint-Estephe",Bordeaux,2018,13/07/2021,10074752018,1007475
857,07/07/2021,1008,120,848,9,160,02/07/2021,"Tignanello, Toscana",Tuscany,2017,13/07/2021,10953912017,1095391
487,12/07/2021,540,34,320,167,220,24/03/2021,"Tua Rita, Giusto di Notri, Toscana",Tuscany,2017,13/07/2021,11058072017,1105807
8000,12/07/2021,8308,4,7330,670,978,02/06/2021,"Domaine Leflaive, Chevalier-Montrachet Grand Cru",Burgundy,2018,13/07/2021,10734012018,1073401
860,12/07/2021,1022,95,936,-76,86,06/07/2021,"Tignanello, Toscana",Tuscany,2018,13/07/2021,10953912018,1095391
2510,14/05/2021,3062,104,2502,8,560,19/03/2021,"Chateau Angelus Premier Grand Cru Classe A, Saint-Emilion Grand Cru",Bordeaux,2015,17/05/2021,10060452015,1006045
465,28/07/2021,458,2,400,65,58,11/05/2021,"Chateau Batailley 5eme Cru Classe, Pauillac",Bordeaux,2006,29/07/2021,10063222006,1006322
920,12/07/2021,1038,36,842,78,196,22/08/2020,"Chateau Calon Segur 3eme Cru Classe, Saint-Estephe",Bordeaux,2019,13/07/2021,10074752019,1007475
5290,12/07/2021,4988,11,4160,1130,828,19/03/2021,"Chateau Margaux Premier Cru Classe, Margaux",Bordeaux,2019,13/07/2021,10127812019,1012781
1516,12/07/2021,1578,21,1586,-70,-8,12/07/2021,"Gaja, Barbaresco",Piedmont,2018,13/07/2021,10996052018,1099605
1800,26/07/2021,1700,1,1300,500,400,30/05/2019,"Gaja, Barbaresco",Piedmont,2007,27/07/2021,10996052007,1099605
2386,26/07/2021,2397,3,2190,196,207,01/05/2021,"Gaja, Barbaresco",Piedmont,2004,27/07/2021,10996052004,1099605
660,26/07/2021,727,5,390,270,337,18/08/2017,"Tua Rita, Giusto di Notri, Toscana",Tuscany,2006,27/07/2021,11058072006,1105807
520,26/07/2021,563,3,460,60,103,05/05/2020,"Tua Rita, Giusto di Notri, Toscana",Tuscany,2008,27/07/2021,11058072008,1105807
1700,26/07/2021,1657,4,1378,322,279,29/07/2020,"Tignanello, Toscana",Tuscany,2001,27/07/2021,10953912001,1095391
1299,06/07/2021,1523,5,1010,289,513,18/12/2020,"Tignanello, Toscana",Tuscany,2008,27/07/2021,10953912008,1095391
6400,26/07/2021,7552,56,6188,212,1364,16/07/2021,"Chateau Margaux Premier Cru Classe, Margaux",Bordeaux,2010,27/07/2021,10127812010,1012781
990,26/07/2021,1117,17,990,0,127,16/06/2021,"Chateau Calon Segur 3eme Cru Classe, Saint-Estephe",Bordeaux,2010,27/07/2021,10074752010,1007475
465,28/07/2021,458,2,400,65,58,11/05/2021,"Chateau Batailley 5eme Cru Classe, Pauillac",Bordeaux,2006,29/07/2021,10063222006,1006322
750,26/07/2021,892,29,790,-40,102,01/06/2020,"Chateau Calon Segur 3eme Cru Classe, Saint-Estephe",Bordeaux,2011,27/07/2021,10074752011,1007475
1180,26/07/2021,1353,4,1140,40,213,21/07/2021,"Tignanello, Toscana",Tuscany,2009,27/07/2021,10953912009,1095391
1260,26/07/2021,1602,3,1170,90,432,24/06/2021,"Tignanello, Toscana",Tuscany,2010,27/07/2021,10953912010,1095391
3758,26/07/2021,4367,81,3690,68,677,13/04/2021,"Chateau Margaux Premier Cru Classe, Margaux",Bordeaux,2011,27/07/2021,10127812011,1012781
2510,14/05/2021,3058,105,2502,8,556,19/03/2021,"Chateau Angelus Premier Grand Cru Classe A, Saint-Emilion Grand Cru",Bordeaux,2015,15/05/2021,10060452015,1006045
4450,03/08/2021,4739,16,4400,50,339,29/09/2020,"Chateau Margaux Premier Cru Classe, Margaux",Bordeaux,2001,04/08/2021,10127812001,1012781
2199,26/07/2021,2229,1,1340,859,889,13/03/2020,"Gaja, Barbaresco",Piedmont,2009,27/07/2021,10996052009,1099605
1000,26/07/2021,1113,8,880,120,233,22/06/2021,"Tignanello, Toscana",Tuscany,2011,27/07/2021,10953912011,1095391
2510,13/05/2021,3056,105,2502,8,554,19/03/2021,"Chateau Angelus Premier Grand Cru Classe A, Saint-Emilion Grand Cru",Bordeaux,2015,14/05/2021,10060452015,1006045
450,28/07/2021,431,3,332,118,99,06/10/2020,"Chateau Batailley 5eme Cru Classe, Pauillac",Bordeaux,2008,29/07/2021,10063222008,1006322
820,26/07/2021,920,4,735,85,185,09/09/2020,"Chateau Calon Segur 3eme Cru Classe, Saint-Estephe",Bordeaux,2012,27/07/2021,10074752012,1007475
3750,26/07/2021,4292,51,3560,190,732,20/11/2020,"Chateau Margaux Premier Cru Classe, Margaux",Bordeaux,2012,27/07/2021,10127812012,1012781
13200,26/07/2021,12867,1,12850,350,17,30/11/2020,"Jacques-Frederic Mugnier, Chambolle-Musigny Premier Cru, Les Amoureuses",Burgundy,2011,27/07/2021,10496422011,1049642
3700,26/07/2021,4171,36,3520,180,651,07/04/2021,"Chateau Margaux Premier Cru Classe, Margaux",Bordeaux,2013,27/07/2021,10127812013,1012781
2550,12/05/2021,3059,105,2502,48,557,19/03/2021,"Chateau Angelus Premier Grand Cru Classe A, Saint-Emilion Grand Cru",Bordeaux,2015,13/05/2021,10060452015,1006045
500,28/07/2021,513,7,450,50,63,25/05/2021,"Chateau Batailley 5eme Cru Classe, Pauillac",Bordeaux,2009,29/07/2021,10063222009,1006322
800,26/07/2021,792,19,682,118,110,15/09/2020,"Chateau Calon Segur 3eme Cru Classe, Saint-Estephe",Bordeaux,2013,27/07/2021,10074752013,1007475
960,26/07/2021,1267,15,850,110,417,28/01/2021,"Tignanello, Toscana",Tuscany,2012,27/07/2021,10953912012,1095391
2550,11/05/2021,3059,105,2502,48,557,19/03/2021,"Chateau Angelus Premier Grand Cru Classe A, Saint-Emilion Grand Cru",Bordeaux,2015,12/05/2021,10060452015,1006045
3800,26/07/2021,4350,130,3480,320,870,17/06/2021,"Chateau Margaux Premier Cru Classe, Margaux",Bordeaux,2014,27/07/2021,10127812014,1012781
790,26/07/2021,877,18,801,-11,76,31/05/2021,"Chateau Calon Segur 3eme Cru Classe, Saint-Estephe",Bordeaux,2014,27/07/2021,10074752014,1007475
500,28/07/2021,520,7,450,50,70,25/05/2021,"Chateau Batailley 5eme Cru Classe, Pauillac",Bordeaux,2009,30/07/2021,10063222009,1006322
1550,26/07/2021,1550,1,1300,250,250,27/04/2021,"Gaja, Barbaresco",Piedmont,2012,27/07/2021,10996052012,1099605
1080,23/07/2021,1139,8,860,220,279,08/03/2021,"Tignanello, Toscana",Tuscany,2013,27/07/2021,10953912013,1095391
984,26/07/2021,1048,7,854,130,194,15/07/2021,"Tignanello, Toscana",Tuscany,2014,27/07/2021,10953912014,1095391
2550,10/05/2021,3142,73,2502,48,640,19/03/2021,"Chateau Angelus Premier Grand Cru Classe A, Saint-Emilion Grand Cru",Bordeaux,2015,11/05/2021,10060452015,1006045
940,26/07/2021,1074,79,866,74,208,20/07/2021,"Chateau Calon Segur 3eme Cru Classe, Saint-Estephe",Bordeaux,2015,27/07/2021,10074752015,1007475
10620,26/07/2021,11749,44,9800,820,1949,11/06/2021,"Chateau Margaux Premier Cru Classe, Margaux",Bordeaux,2015,27/07/2021,10127812015,1012781
14520,26/07/2021,14520,1,12000,2520,2520,28/05/2020,"Jacques-Frederic Mugnier, Chambolle-Musigny Premier Cru, Les Amoureuses",Burgundy,2014,27/07/2021,10496422014,1049642
1130,21/07/2021,1167,13,1012,118,155,02/07/2021,"Tignanello, Toscana",Tuscany,2015,27/07/2021,10953912015,1095391
480,16/07/2021,537,15,388,92,149,29/09/2020,"Tua Rita, Giusto di Notri, Toscana",Tuscany,2015,27/07/2021,11058072015,1105807
6396,27/05/2021,7852,0,7900,-1504,-48,29/04/2019,"Domaine Leflaive, Chevalier-Montrachet Grand Cru",Burgundy,2015,27/07/2021,10734012015,1073401
16200,26/07/2021,16327,0,18750,-2550,-2423,29/08/2018,"Jacques-Frederic Mugnier, Chambolle-Musigny Premier Cru, Les Amoureuses",Burgundy,2015,27/07/2021,10496422015,1049642
5500,26/07/2021,5882,136,5500,0,382,06/07/2021,"Chateau Margaux Premier Cru Classe, Margaux",Bordeaux,2016,27/07/2021,10127812016,1012781
2550,07/05/2021,3141,72,2502,48,639,19/03/2021,"Chateau Angelus Premier Grand Cru Classe A, Saint-Emilion Grand Cru",Bordeaux,2015,10/05/2021,10060452015,1006045
1100,26/07/2021,1219,77,1036,64,183,27/05/2021,"Chateau Calon Segur 3eme Cru Classe, Saint-Estephe",Bordeaux,2016,27/07/2021,10074752016,1007475
500,28/07/2021,513,7,450,50,63,25/05/2021,"Chateau Batailley 5eme Cru Classe, Pauillac",Bordeaux,2009,29/07/2021,10063222009,1006322
1280,26/07/2021,1365,49,1220,60,145,14/07/2021,"Tignanello, Toscana",Tuscany,2016,27/07/2021,10953912016,1095391
1440,26/07/2021,1677,32,1510,-70,167,18/07/2021,"Gaja, Barbaresco",Piedmont,2016,27/07/2021,10996052016,1099605
2550,07/05/2021,3139,75,2502,48,637,19/03/2021,"Chateau Angelus Premier Grand Cru Classe A, Saint-Emilion Grand Cru",Bordeaux,2015,08/05/2021,10060452015,1006045
780,26/07/2021,938,73,740,40,198,21/05/2021,"Chateau Calon Segur 3eme Cru Classe, Saint-Estephe",Bordeaux,2017,27/07/2021,10074752017,1007475
500,28/07/2021,520,7,450,50,70,25/05/2021,"Chateau Batailley 5eme Cru Classe, Pauillac",Bordeaux,2009,30/07/2021,10063222009,1006322
3820,26/07/2021,4610,198,3950,-130,660,30/06/2021,"Chateau Margaux Premier Cru Classe, Margaux",Bordeaux,2017,27/07/2021,10127812017,1012781
1350,26/07/2021,1480,55,1260,90,220,18/02/2021,"Gaja, Barbaresco",Piedmont,2015,27/07/2021,10996052015,1099605
460,26/07/2021,498,179,420,40,78,28/05/2021,"Tua Rita, Giusto di Notri, Toscana",Tuscany,2016,27/07/2021,11058072016,1105807
8556,21/07/2021,8934,2,6974,1582,1960,14/03/2021,"Domaine Leflaive, Chevalier-Montrachet Grand Cru",Burgundy,2017,27/07/2021,10734012017,1073401
8098,26/07/2021,9748,3,7290,808,2458,21/08/2020,"Domaine Denis Mortet, Chambertin Grand Cru",Burgundy,2017,27/07/2021,10490202017,1049020
870,13/07/2021,966,5,705,165,261,01/02/2021,"Chateau Calon Segur 3eme Cru Classe, Saint-Estephe",Bordeaux,2002,14/07/2021,10074752002,1007475
945,13/07/2021,1156,20,800,145,356,21/11/2019,"Chateau Calon Segur 3eme Cru Classe, Saint-Estephe",Bordeaux,2003,14/07/2021,10074752003,1007475
3939,13/07/2021,4425,22,3684,255,741,10/06/2020,"Chateau Margaux Premier Cru Classe, Margaux",Bordeaux,2002,14/07/2021,10127812002,1012781
3826,13/07/2021,4575,49,4116,-290,459,25/02/2021,"Chateau Margaux Premier Cru Classe, Margaux",Bordeaux,2004,14/07/2021,10127812004,1012781
4450,13/07/2021,4805,24,4400,50,405,29/09/2020,"Chateau Margaux Premier Cru Classe, Margaux",Bordeaux,2001,14/07/2021,10127812001,1012781
2550,06/05/2021,3141,76,2502,48,639,19/03/2021,"Chateau Angelus Premier Grand Cru Classe A, Saint-Emilion Grand Cru",Bordeaux,2015,07/05/2021,10060452015,1006045
840,13/07/2021,977,16,745,95,232,16/11/2020,"Chateau Calon Segur 3eme Cru Classe, Saint-Estephe",Bordeaux,2004,14/07/2021,10074752004,1007475
2550,04/05/2021,3128,74,2502,48,626,19/03/2021,"Chateau Angelus Premier Grand Cru Classe A, Saint-Emilion Grand Cru",Bordeaux,2015,05/05/2021,10060452015,1006045
525,28/07/2021,595,400,494,31,101,20/04/2021,"Chateau Batailley 5eme Cru Classe, Pauillac",Bordeaux,2010,29/07/2021,10063222010,1006322
2550,03/05/2021,3163,88,2502,48,661,19/03/2021,"Chateau Angelus Premier Grand Cru Classe A, Saint-Emilion Grand Cru",Bordeaux,2015,04/05/2021,10060452015,1006045
525,28/07/2021,595,400,494,31,101,20/04/2021,"Chateau Batailley 5eme Cru Classe, Pauillac",Bordeaux,2010,29/07/2021,10063222010,1006322
380,28/07/2021,422,5,320,60,102,09/07/2021,"Chateau Batailley 5eme Cru Classe, Pauillac",Bordeaux,2011,29/07/2021,10063222011,1006322
2960,05/08/2021,3463,143,2844,116,619,29/07/2021,"Chateau Angelus Premier Grand Cru Classe A, Saint-Emilion Grand Cru",Bordeaux,2016,06/08/2021,10060452016,1006045
3900,13/07/2021,4698,82,3822,78,876,20/06/2021,"Chateau Margaux Premier Cru Classe, Margaux",Bordeaux,2006,14/07/2021,10127812006,1012781
895,13/07/2021,921,39,863,32,58,10/05/2021,"Chateau Calon Segur 3eme Cru Classe, Saint-Estephe",Bordeaux,2006,14/07/2021,10074752006,1007475
3750,13/07/2021,4243,84,3525,225,718,18/06/2021,"Chateau Margaux Premier Cru Classe, Margaux",Bordeaux,2007,14/07/2021,10127812007,1012781
880,13/07/2021,980,7,725,155,255,13/04/2021,"Chateau Calon Segur 3eme Cru Classe, Saint-Estephe",Bordeaux,2007,14/07/2021,10074752007,1007475
2960,05/08/2021,3461,144,2844,116,617,29/07/2021,"Chateau Angelus Premier Grand Cru Classe A, Saint-Emilion Grand Cru",Bordeaux,2016,10/08/2021,10060452016,1006045
8400,13/07/2021,8400,1,5700,2700,2700,10/09/2020,"Domaine Leflaive, Chevalier-Montrachet Grand Cru",Burgundy,2007,14/07/2021,10734012007,1073401
3950,13/07/2021,4350,67,3870,80,480,10/07/2021,"Chateau Margaux Premier Cru Classe, Margaux",Bordeaux,2008,14/07/2021,10127812008,1012781
380,28/07/2021,400,4,320,60,80,09/07/2021,"Chateau Batailley 5eme Cru Classe, Pauillac",Bordeaux,2011,30/07/2021,10063222011,1006322
895,13/07/2021,978,10,781,114,197,16/11/2020,"Chateau Calon Segur 3eme Cru Classe, Saint-Estephe",Bordeaux,2008,14/07/2021,10074752008,1007475
6880,12/07/2021,7754,48,7086,-206,668,11/06/2021,"Chateau Margaux Premier Cru Classe, Margaux",Bordeaux,2009,14/07/2021,10127812009,1012781
9000,13/07/2021,10761,2,5400,3600,5361,13/08/2020,"Domaine Leflaive, Chevalier-Montrachet Grand Cru",Burgundy,2008,14/07/2021,10734012008,1073401
6600,13/07/2021,6451,1,5360,1240,1091,18/09/2020,"Domaine Leflaive, Chevalier-Montrachet Grand Cru",Burgundy,2009,14/07/2021,10734012009,1073401
1850,13/07/2021,1831,1,1180,670,651,10/03/2017,"Gaja, Barbaresco",Piedmont,2005,14/07/2021,10996052005,1099605
1408,06/07/2021,1608,3,1150,258,458,21/04/2019,"Tignanello, Toscana",Tuscany,2005,14/07/2021,10953912005,1095391
2500,13/07/2021,2632,3,2220,280,412,14/06/2021,"Gaja, Barbaresco",Piedmont,2001,14/07/2021,10996052001,1099605
2098,13/07/2021,2366,3,2190,-92,176,01/05/2021,"Gaja, Barbaresco",Piedmont,2004,14/07/2021,10996052004,1099605
660,13/07/2021,727,5,390,270,337,18/08/2017,"Tua Rita, Giusto di Notri, Toscana",Tuscany,2006,14/07/2021,11058072006,1105807
520,13/07/2021,563,3,460,60,103,05/05/2020,"Tua Rita, Giusto di Notri, Toscana",Tuscany,2008,14/07/2021,11058072008,1105807
1592,08/07/2021,1756,6,1378,214,378,29/07/2020,"Tignanello, Toscana",Tuscany,2001,14/07/2021,10953912001,1095391
1299,06/07/2021,1566,7,1010,289,556,18/12/2020,"Tignanello, Toscana",Tuscany,2008,14/07/2021,10953912008,1095391
1408,13/07/2021,1754,2,882,526,872,26/04/2019,"Tignanello, Toscana",Tuscany,2003,14/07/2021,10953912003,1095391
1248,08/07/2021,1308,4,1238,10,70,02/11/2020,"Tignanello, Toscana",Tuscany,2006,14/07/2021,10953912006,1095391
1733,13/07/2021,1707,4,1420,313,287,29/06/2021,"Tignanello, Toscana",Tuscany,2004,14/07/2021,10953912004,1095391
1408,06/07/2021,1427,1,996,412,431,14/06/2019,"Tignanello, Toscana",Tuscany,2000,14/07/2021,10953912000,1095391
6400,13/07/2021,7538,48,6190,210,1348,08/07/2021,"Chateau Margaux Premier Cru Classe, Margaux",Bordeaux,2010,14/07/2021,10127812010,1012781
380,28/07/2021,404,5,320,60,84,09/07/2021,"Chateau Batailley 5eme Cru Classe, Pauillac",Bordeaux,2011,31/07/2021,10063222011,1006322
990,13/07/2021,1137,16,990,0,147,16/06/2021,"Chateau Calon Segur 3eme Cru Classe, Saint-Estephe",Bordeaux,2010,14/07/2021,10074752010,1007475
788,13/07/2021,990,36,790,-2,200,01/06/2020,"Chateau Calon Segur 3eme Cru Classe, Saint-Estephe",Bordeaux,2011,14/07/2021,10074752011,1007475
8240,13/07/2021,8400,1,5960,2280,2440,01/08/2017,"Domaine Leflaive, Chevalier-Montrachet Grand Cru",Burgundy,2010,14/07/2021,10734012010,1073401
1024,12/07/2021,1378,3,1072,-48,306,20/01/2021,"Tignanello, Toscana",Tuscany,2009,14/07/2021,10953912009,1095391
2880,30/07/2021,3515,133,2844,36,671,29/07/2021,"Chateau Angelus Premier Grand Cru Classe A, Saint-Emilion Grand Cru",Bordeaux,2016,31/07/2021,10060452016,1006045
1050,12/07/2021,1117,9,880,170,237,22/06/2021,"Tignanello, Toscana",Tuscany,2011,14/07/2021,10953912011,1095391
6156,02/07/2021,12924,1,6500,-344,6424,26/05/2021,"Domaine Leflaive, Chevalier-Montrachet Grand Cru",Burgundy,2011,14/07/2021,10734012011,1073401
2880,29/07/2021,3504,135,2844,36,660,29/07/2021,"Chateau Angelus Premier Grand Cru Classe A, Saint-Emilion Grand Cru",Bordeaux,2016,30/07/2021,10060452016,1006045
820,13/07/2021,937,6,735,85,202,09/09/2020,"Chateau Calon Segur 3eme Cru Classe, Saint-Estephe",Bordeaux,2012,14/07/2021,10074752012,1007475
13200,13/07/2021,12867,1,12850,350,17,30/11/2020,"Jacques-Frederic Mugnier, Chambolle-Musigny Premier Cru, Les Amoureuses",Burgundy,2011,14/07/2021,10496422011,1049642
3740,13/07/2021,4093,25,3520,220,573,07/04/2021,"Chateau Margaux Premier Cru Classe, Margaux",Bordeaux,2013,14/07/2021,10127812013,1012781
2880,28/07/2021,3505,136,2844,36,661,20/07/2021,"Chateau Angelus Premier Grand Cru Classe A, Saint-Emilion Grand Cru",Bordeaux,2016,29/07/2021,10060452016,1006045
380,28/07/2021,422,5,320,60,102,09/07/2021,"Chateau Batailley 5eme Cru Classe, Pauillac",Bordeaux,2011,29/07/2021,10063222011,1006322
686,13/07/2021,809,7,682,4,127,15/09/2020,"Chateau Calon Segur 3eme Cru Classe, Saint-Estephe",Bordeaux,2013,14/07/2021,10074752013,1007475
960,12/07/2021,1346,11,850,110,496,28/01/2021,"Tignanello, Toscana",Tuscany,2012,14/07/2021,10953912012,1095391
3800,13/07/2021,4342,123,3480,320,862,17/06/2021,"Chateau Margaux Premier Cru Classe, Margaux",Bordeaux,2014,14/07/2021,10127812014,1012781
790,09/07/2021,881,19,801,-11,80,31/05/2021,"Chateau Calon Segur 3eme Cru Classe, Saint-Estephe",Bordeaux,2014,14/07/2021,10074752014,1007475
380,28/07/2021,404,5,320,60,84,09/07/2021,"Chateau Batailley 5eme Cru Classe, Pauillac",Bordeaux,2011,31/07/2021,10063222011,1006322
1550,13/07/2021,1557,1,1300,250,257,27/04/2021,"Gaja, Barbaresco",Piedmont,2012,14/07/2021,10996052012,1099605
1090,13/07/2021,1157,6,860,230,297,08/03/2021,"Tignanello, Toscana",Tuscany,2013,14/07/2021,10953912013,1095391
984,13/07/2021,1106,45,830,154,276,22/06/2021,"Tignanello, Toscana",Tuscany,2014,14/07/2021,10953912014,1095391
1390,13/07/2021,1529,14,1300,90,229,30/06/2021,"Gaja, Barbaresco",Piedmont,2013,14/07/2021,10996052013,1099605
1592,13/07/2021,1565,14,1300,292,265,10/07/2021,"Gaja, Barbaresco",Piedmont,2014,14/07/2021,10996052014,1099605
940,13/07/2021,1091,77,822,118,269,28/06/2021,"Chateau Calon Segur 3eme Cru Classe, Saint-Estephe",Bordeaux,2015,14/07/2021,10074752015,1007475
10400,13/07/2021,11802,52,9800,600,2002,11/06/2021,"Chateau Margaux Premier Cru Classe, Margaux",Bordeaux,2015,14/07/2021,10127812015,1012781
14520,13/07/2021,14520,1,12000,2520,2520,28/05/2020,"Jacques-Frederic Mugnier, Chambolle-Musigny Premier Cru, Les Amoureuses",Burgundy,2014,14/07/2021,10496422014,1049642
2880,27/07/2021,3515,128,2844,36,671,20/07/2021,"Chateau Angelus Premier Grand Cru Classe A, Saint-Emilion Grand Cru",Bordeaux,2016,28/07/2021,10060452016,1006045
380,28/07/2021,400,4,320,60,80,09/07/2021,"Chateau Batailley 5eme Cru Classe, Pauillac",Bordeaux,2011,30/07/2021,10063222011,1006322
1240,13/07/2021,1282,87,1144,96,138,06/07/2021,"Tignanello, Toscana",Tuscany,2016,14/07/2021,10953912016,1095391
7906,13/07/2021,7946,1,7124,782,822,15/02/2019,"Domaine Leflaive, Chevalier-Montrachet Grand Cru",Burgundy,2016,14/07/2021,10734012016,1073401
1500,13/07/2021,1675,42,1400,100,275,08/07/2021,"Gaja, Barbaresco",Piedmont,2016,14/07/2021,10996052016,1099605
780,13/07/2021,935,78,740,40,195,21/05/2021,"Chateau Calon Segur 3eme Cru Classe, Saint-Estephe",Bordeaux,2017,14/07/2021,10074752017,1007475
460,13/07/2021,487,154,420,40,67,28/05/2021,"Tua Rita, Giusto di Notri, Toscana",Tuscany,2016,14/07/2021,11058072016,1105807
8000,13/07/2021,8676,4,6974,1026,1702,14/03/2021,"Domaine Leflaive, Chevalier-Montrachet Grand Cru",Burgundy,2017,14/07/2021,10734012017,1073401
2900,26/07/2021,3511,132,2844,56,667,29/07/2021,"Chateau Angelus Premier Grand Cru Classe A, Saint-Emilion Grand Cru",Bordeaux,2016,03/08/2021,10060452016,1006045
1080,13/07/2021,1244,40,1016,64,228,11/07/2021,"Chateau Calon Segur 3eme Cru Classe, Saint-Estephe",Bordeaux,2018,14/07/2021,10074752018,1007475
8000,13/07/2021,8308,4,7330,670,978,02/06/2021,"Domaine Leflaive, Chevalier-Montrachet Grand Cru",Burgundy,2018,14/07/2021,10734012018,1073401
950,13/07/2021,1061,125,932,18,129,13/07/2021,"Tignanello, Toscana",Tuscany,2018,14/07/2021,10953912018,1095391
400,28/07/2021,418,8,408,-8,10,14/07/2021,"Chateau Batailley 5eme Cru Classe, Pauillac",Bordeaux,2012,29/07/2021,10063222012,1006322
840,13/07/2021,1038,36,842,-2,196,22/08/2020,"Chateau Calon Segur 3eme Cru Classe, Saint-Estephe",Bordeaux,2019,14/07/2021,10074752019,1007475
1408,08/07/2021,1636,61,1398,10,238,01/07/2021,"Gaja, Barbaresco",Piedmont,2017,14/07/2021,10996052017,1099605
1516,13/07/2021,1578,21,1586,-70,-8,12/07/2021,"Gaja, Barbaresco",Piedmont,2018,14/07/2021,10996052018,1099605
2900,26/07/2021,3507,132,2844,56,663,29/07/2021,"Chateau Angelus Premier Grand Cru Classe A, Saint-Emilion Grand Cru",Bordeaux,2016,03/08/2021,10060452016,1006045
5600,26/07/2021,5838,103,5254,346,584,26/05/2021,"Chateau Margaux Premier Cru Classe, Margaux",Bordeaux,2018,27/07/2021,10127812018,1012781
900,23/07/2021,989,101,864,36,125,26/07/2021,"Tignanello, Toscana",Tuscany,2017,27/07/2021,10953912017,1095391
487,19/07/2021,537,33,320,167,217,24/03/2021,"Tua Rita, Giusto di Notri, Toscana",Tuscany,2017,27/07/2021,11058072017,1105807
8000,26/07/2021,8642,4,7330,670,1312,02/06/2021,"Domaine Leflaive, Chevalier-Montrachet Grand Cru",Burgundy,2018,27/07/2021,10734012018,1073401
2880,26/07/2021,3517,127,2844,36,673,20/07/2021,"Chateau Angelus Premier Grand Cru Classe A, Saint-Emilion Grand Cru",Bordeaux,2016,27/07/2021,10060452016,1006045
400,28/07/2021,414,8,408,-8,6,14/07/2021,"Chateau Batailley 5eme Cru Classe, Pauillac",Bordeaux,2012,30/07/2021,10063222012,1006322
5290,26/07/2021,4957,10,4160,1130,797,19/03/2021,"Chateau Margaux Premier Cru Classe, Margaux",Bordeaux,2019,27/07/2021,10127812019,1012781
1480,26/07/2021,1604,78,1398,82,206,01/07/2021,"Gaja, Barbaresco",Piedmont,2017,27/07/2021,10996052017,1099605
1624,26/07/2021,1713,22,1598,26,115,26/07/2021,"Gaja, Barbaresco",Piedmont,2018,27/07/2021,10996052018,1099605
790,06/08/2021,868,17,801,-11,67,31/05/2021,"Chateau Calon Segur 3eme Cru Classe, Saint-Estephe",Bordeaux,2014,07/08/2021,10074752014,1007475
400,28/07/2021,418,8,408,-8,10,14/07/2021,"Chateau Batailley 5eme Cru Classe, Pauillac",Bordeaux,2012,29/07/2021,10063222012,1006322
2880,23/07/2021,3500,129,2844,36,656,20/07/2021,"Chateau Angelus Premier Grand Cru Classe A, Saint-Emilion Grand Cru",Bordeaux,2016,24/07/2021,10060452016,1006045
2880,22/07/2021,3500,129,2844,36,656,20/07/2021,"Chateau Angelus Premier Grand Cru Classe A, Saint-Emilion Grand Cru",Bordeaux,2016,23/07/2021,10060452016,1006045
1408,06/07/2021,1425,1,996,412,429,14/06/2019,"Tignanello, Toscana",Tuscany,2000,18/07/2021,10953912000,1095391
1260,16/07/2021,1628,3,1170,90,458,24/06/2021,"Tignanello, Toscana",Tuscany,2010,18/07/2021,10953912010,1095391
400,28/07/2021,414,8,408,-8,6,14/07/2021,"Chateau Batailley 5eme Cru Classe, Pauillac",Bordeaux,2012,30/07/2021,10063222012,1006322
2880,21/07/2021,3501,130,2844,36,657,20/07/2021,"Chateau Angelus Premier Grand Cru Classe A, Saint-Emilion Grand Cru",Bordeaux,2016,22/07/2021,10060452016,1006045
320,28/07/2021,320,109,304,16,16,10/01/2021,"Chateau Batailley 5eme Cru Classe, Pauillac",Bordeaux,2013,29/07/2021,10063222013,1006322
3750,14/07/2021,4242,83,3525,225,717,18/06/2021,"Chateau Margaux Premier Cru Classe, Margaux",Bordeaux,2007,15/07/2021,10127812007,1012781
880,14/07/2021,980,7,725,155,255,13/04/2021,"Chateau Calon Segur 3eme Cru Classe, Saint-Estephe",Bordeaux,2007,15/07/2021,10074752007,1007475
2880,20/07/2021,3501,130,2844,36,657,20/07/2021,"Chateau Angelus Premier Grand Cru Classe A, Saint-Emilion Grand Cru",Bordeaux,2016,21/07/2021,10060452016,1006045
2880,19/07/2021,3500,130,2570,310,930,14/07/2021,"Chateau Angelus Premier Grand Cru Classe A, Saint-Emilion Grand Cru",Bordeaux,2016,20/07/2021,10060452016,1006045
3950,14/07/2021,4350,67,3870,80,480,10/07/2021,"Chateau Margaux Premier Cru Classe, Margaux",Bordeaux,2008,15/07/2021,10127812008,1012781
895,14/07/2021,978,10,781,114,197,16/11/2020,"Chateau Calon Segur 3eme Cru Classe, Saint-Estephe",Bordeaux,2008,15/07/2021,10074752008,1007475
6880,14/07/2021,7754,48,7086,-206,668,11/06/2021,"Chateau Margaux Premier Cru Classe, Margaux",Bordeaux,2009,15/07/2021,10127812009,1012781
1000,14/07/2021,1239,52,1026,-26,213,24/06/2021,"Chateau Calon Segur 3eme Cru Classe, Saint-Estephe",Bordeaux,2009,15/07/2021,10074752009,1007475
2500,14/07/2021,2632,3,2220,280,412,14/06/2021,"Gaja, Barbaresco",Piedmont,2001,15/07/2021,10996052001,1099605
2386,14/07/2021,2397,3,2190,196,207,01/05/2021,"Gaja, Barbaresco",Piedmont,2004,15/07/2021,10996052004,1099605
1300,08/07/2021,1389,2,1200,100,189,06/03/2021,"Tignanello, Toscana",Tuscany,2007,15/07/2021,10953912007,1095391
6400,14/07/2021,7538,48,6190,210,1348,08/07/2021,"Chateau Margaux Premier Cru Classe, Margaux",Bordeaux,2010,15/07/2021,10127812010,1012781
360,28/07/2021,370,71,360,0,10,14/07/2021,"Chateau Batailley 5eme Cru Classe, Pauillac",Bordeaux,2014,29/07/2021,10063222014,1006322
990,14/07/2021,1137,16,990,0,147,16/06/2021,"Chateau Calon Segur 3eme Cru Classe, Saint-Estephe",Bordeaux,2010,15/07/2021,10074752010,1007475
788,14/07/2021,990,36,790,-2,200,01/06/2020,"Chateau Calon Segur 3eme Cru Classe, Saint-Estephe",Bordeaux,2011,15/07/2021,10074752011,1007475
1180,14/07/2021,1378,3,1072,108,306,20/01/2021,"Tignanello, Toscana",Tuscany,2009,15/07/2021,10953912009,1095391
1326,14/07/2021,1559,4,1170,156,389,24/06/2021,"Tignanello, Toscana",Tuscany,2010,15/07/2021,10953912010,1095391
3758,14/07/2021,4333,73,3690,68,643,13/04/2021,"Chateau Margaux Premier Cru Classe, Margaux",Bordeaux,2011,15/07/2021,10127812011,1012781
2880,16/07/2021,3496,121,2570,310,926,14/07/2021,"Chateau Angelus Premier Grand Cru Classe A, Saint-Emilion Grand Cru",Bordeaux,2016,19/07/2021,10060452016,1006045
415,28/07/2021,523,38,364,51,159,12/05/2021,"Chateau Batailley 5eme Cru Classe, Pauillac",Bordeaux,2016,29/07/2021,10063222016,1006322
1050,14/07/2021,1117,9,880,170,237,22/06/2021,"Tignanello, Toscana",Tuscany,2011,15/07/2021,10953912011,1095391
2880,16/07/2021,3490,122,2570,310,920,14/07/2021,"Chateau Angelus Premier Grand Cru Classe A, Saint-Emilion Grand Cru",Bordeaux,2016,17/07/2021,10060452016,1006045
820,14/07/2021,937,6,735,85,202,09/09/2020,"Chateau Calon Segur 3eme Cru Classe, Saint-Estephe",Bordeaux,2012,15/07/2021,10074752012,1007475
3750,05/07/2021,4288,40,3560,190,728,20/11/2020,"Chateau Margaux Premier Cru Classe, Margaux",Bordeaux,2012,15/07/2021,10127812012,1012781
3740,14/07/2021,4095,25,3520,220,575,07/04/2021,"Chateau Margaux Premier Cru Classe, Margaux",Bordeaux,2013,15/07/2021,10127812013,1012781
2880,15/07/2021,3496,124,2570,310,926,14/07/2021,"Chateau Angelus Premier Grand Cru Classe A, Saint-Emilion Grand Cru",Bordeaux,2016,16/07/2021,10060452016,1006045
686,14/07/2021,809,7,682,4,127,15/09/2020,"Chateau Calon Segur 3eme Cru Classe, Saint-Estephe",Bordeaux,2013,15/07/2021,10074752013,1007475
960,14/07/2021,1346,11,850,110,496,28/01/2021,"Tignanello, Toscana",Tuscany,2012,15/07/2021,10953912012,1095391
2880,14/07/2021,3495,124,2570,310,925,14/07/2021,"Chateau Angelus Premier Grand Cru Classe A, Saint-Emilion Grand Cru",Bordeaux,2016,15/07/2021,10060452016,1006045
3800,14/07/2021,4342,123,3480,320,862,17/06/2021,"Chateau Margaux Premier Cru Classe, Margaux",Bordeaux,2014,15/07/2021,10127812014,1012781
1060,14/07/2021,1135,8,860,200,275,08/03/2021,"Tignanello, Toscana",Tuscany,2013,15/07/2021,10953912013,1095391
984,14/07/2021,1106,45,830,154,276,22/06/2021,"Tignanello, Toscana",Tuscany,2014,15/07/2021,10953912014,1095391
940,14/07/2021,1090,75,822,118,268,28/06/2021,"Chateau Calon Segur 3eme Cru Classe, Saint-Estephe",Bordeaux,2015,15/07/2021,10074752015,1007475
10400,14/07/2021,11825,50,9800,600,2025,11/06/2021,"Chateau Margaux Premier Cru Classe, Margaux",Bordeaux,2015,15/07/2021,10127812015,1012781
870,15/07/2021,966,5,705,165,261,01/02/2021,"Chateau Calon Segur 3eme Cru Classe, Saint-Estephe",Bordeaux,2002,16/07/2021,10074752002,1007475
8200,15/07/2021,8936,14,8100,100,836,21/06/2021,"Chateau Margaux Premier Cru Classe, Margaux",Bordeaux,2000,16/07/2021,10127812000,1012781
945,15/07/2021,1128,23,800,145,328,21/11/2019,"Chateau Calon Segur 3eme Cru Classe, Saint-Estephe",Bordeaux,2003,16/07/2021,10074752003,1007475
2880,13/07/2021,3495,124,2600,280,895,06/07/2021,"Chateau Angelus Premier Grand Cru Classe A, Saint-Emilion Grand Cru",Bordeaux,2016,14/07/2021,10060452016,1006045
3939,15/07/2021,4430,22,3684,255,746,10/06/2020,"Chateau Margaux Premier Cru Classe, Margaux",Bordeaux,2002,16/07/2021,10127812002,1012781
4450,15/07/2021,4783,23,4400,50,383,29/09/2020,"Chateau Margaux Premier Cru Classe, Margaux",Bordeaux,2001,16/07/2021,10127812001,1012781
3715,15/07/2021,4581,47,4116,-401,465,25/02/2021,"Chateau Margaux Premier Cru Classe, Margaux",Bordeaux,2004,16/07/2021,10127812004,1012781
2837,29/06/2021,3315,168,2750,87,565,23/06/2021,"Chateau Angelus Premier Grand Cru Classe A, Saint-Emilion Grand Cru",Bordeaux,2016,02/07/2021,10060452016,1006045
2837,29/06/2021,3394,197,2750,87,644,23/06/2021,"Chateau Angelus Premier Grand Cru Classe A, Saint-Emilion Grand Cru",Bordeaux,2016,03/07/2021,10060452016,1006045
840,15/07/2021,977,16,745,95,232,16/11/2020,"Chateau Calon Segur 3eme Cru Classe, Saint-Estephe",Bordeaux,2004,16/07/2021,10074752004,1007475
880,06/08/2021,967,9,725,155,242,13/04/2021,"Chateau Calon Segur 3eme Cru Classe, Saint-Estephe",Bordeaux,2007,07/08/2021,10074752007,1007475
2837,29/06/2021,3394,197,2600,237,794,06/07/2021,"Chateau Angelus Premier Grand Cru Classe A, Saint-Emilion Grand Cru",Bordeaux,2016,07/07/2021,10060452016,1006045
450,29/07/2021,532,2,300,150,232,15/12/2019,"Chateau Batailley 5eme Cru Classe, Pauillac",Bordeaux,2004,30/07/2021,10063222004,1006322
320,29/07/2021,320,109,304,16,16,10/01/2021,"Chateau Batailley 5eme Cru Classe, Pauillac",Bordeaux,2013,30/07/2021,10063222013,1006322
6500,15/07/2021,7413,27,6776,-276,637,10/06/2021,"Chateau Margaux Premier Cru Classe, Margaux",Bordeaux,2005,16/07/2021,10127812005,1012781
2837,29/06/2021,3427,159,2600,237,827,06/07/2021,"Chateau Angelus Premier Grand Cru Classe A, Saint-Emilion Grand Cru",Bordeaux,2016,09/07/2021,10060452016,1006045
990,15/07/2021,1165,83,988,2,177,28/05/2021,"Chateau Calon Segur 3eme Cru Classe, Saint-Estephe",Bordeaux,2005,16/07/2021,10074752005,1007475
360,29/07/2021,370,71,360,0,10,14/07/2021,"Chateau Batailley 5eme Cru Classe, Pauillac",Bordeaux,2014,30/07/2021,10063222014,1006322
895,15/07/2021,921,39,863,32,58,10/05/2021,"Chateau Calon Segur 3eme Cru Classe, Saint-Estephe",Bordeaux,2006,16/07/2021,10074752006,1007475
3900,15/07/2021,4698,82,3822,78,876,20/06/2021,"Chateau Margaux Premier Cru Classe, Margaux",Bordeaux,2006,16/07/2021,10127812006,1012781
3750,15/07/2021,4255,83,3525,225,730,18/06/2021,"Chateau Margaux Premier Cru Classe, Margaux",Bordeaux,2007,16/07/2021,10127812007,1012781
880,15/07/2021,980,7,725,155,255,13/04/2021,"Chateau Calon Segur 3eme Cru Classe, Saint-Estephe",Bordeaux,2007,16/07/2021,10074752007,1007475
2837,29/06/2021,3424,158,2600,237,824,06/07/2021,"Chateau Angelus Premier Grand Cru Classe A, Saint-Emilion Grand Cru",Bordeaux,2016,10/07/2021,10060452016,1006045
8400,15/07/2021,8400,1,5700,2700,2700,10/09/2020,"Domaine Leflaive, Chevalier-Montrachet Grand Cru",Burgundy,2007,16/07/2021,10734012007,1073401
2837,29/06/2021,3518,118,2600,237,918,06/07/2021,"Chateau Angelus Premier Grand Cru Classe A, Saint-Emilion Grand Cru",Bordeaux,2016,12/07/2021,10060452016,1006045
3900,15/07/2021,4349,71,3870,30,479,10/07/2021,"Chateau Margaux Premier Cru Classe, Margaux",Bordeaux,2008,16/07/2021,10127812008,1012781
895,15/07/2021,978,10,781,114,197,16/11/2020,"Chateau Calon Segur 3eme Cru Classe, Saint-Estephe",Bordeaux,2008,16/07/2021,10074752008,1007475
6880,14/07/2021,7747,48,7086,-206,661,11/06/2021,"Chateau Margaux Premier Cru Classe, Margaux",Bordeaux,2009,16/07/2021,10127812009,1012781
9000,15/07/2021,10761,2,5400,3600,5361,13/08/2020,"Domaine Leflaive, Chevalier-Montrachet Grand Cru",Burgundy,2008,16/07/2021,10734012008,1073401
2837,29/06/2021,3494,125,2600,237,894,06/07/2021,"Chateau Angelus Premier Grand Cru Classe A, Saint-Emilion Grand Cru",Bordeaux,2016,13/07/2021,10060452016,1006045
6600,15/07/2021,6451,1,5360,1240,1091,18/09/2020,"Domaine Leflaive, Chevalier-Montrachet Grand Cru",Burgundy,2009,16/07/2021,10734012009,1073401
1850,15/07/2021,1831,1,1180,670,651,10/03/2017,"Gaja, Barbaresco",Piedmont,2005,16/07/2021,10996052005,1099605
2500,15/07/2021,2671,3,2220,280,451,14/06/2021,"Gaja, Barbaresco",Piedmont,2001,16/07/2021,10996052001,1099605
2386,15/07/2021,2397,3,2190,196,207,01/05/2021,"Gaja, Barbaresco",Piedmont,2004,16/07/2021,10996052004,1099605
520,15/07/2021,563,3,460,60,103,05/05/2020,"Tua Rita, Giusto di Notri, Toscana",Tuscany,2008,16/07/2021,11058072008,1105807
660,15/07/2021,727,5,390,270,337,18/08/2017,"Tua Rita, Giusto di Notri, Toscana",Tuscany,2006,16/07/2021,11058072006,1105807
6400,15/07/2021,7572,53,6190,210,1382,08/07/2021,"Chateau Margaux Premier Cru Classe, Margaux",Bordeaux,2010,16/07/2021,10127812010,1012781
685,30/07/2021,914,2,470,215,444,29/03/2018,"Chateau Batailley 5eme Cru Classe, Pauillac",Bordeaux,2000,31/07/2021,10063222000,1006322
990,15/07/2021,1137,16,990,0,147,16/06/2021,"Chateau Calon Segur 3eme Cru Classe, Saint-Estephe",Bordeaux,2010,16/07/2021,10074752010,1007475
2762,28/06/2021,3332,154,2750,12,582,23/06/2021,"Chateau Angelus Premier Grand Cru Classe A, Saint-Emilion Grand Cru",Bordeaux,2016,30/06/2021,10060452016,1006045
788,15/07/2021,990,36,790,-2,200,01/06/2020,"Chateau Calon Segur 3eme Cru Classe, Saint-Estephe",Bordeaux,2011,16/07/2021,10074752011,1007475
1260,15/07/2021,1525,4,1170,90,355,24/06/2021,"Tignanello, Toscana",Tuscany,2010,16/07/2021,10953912010,1095391
3758,15/07/2021,4348,73,3690,68,658,13/04/2021,"Chateau Margaux Premier Cru Classe, Margaux",Bordeaux,2011,16/07/2021,10127812011,1012781
2762,28/06/2021,3340,154,2750,12,590,23/06/2021,"Chateau Angelus Premier Grand Cru Classe A, Saint-Emilion Grand Cru",Bordeaux,2016,29/06/2021,10060452016,1006045
1050,14/07/2021,1134,8,880,170,254,22/06/2021,"Tignanello, Toscana",Tuscany,2011,16/07/2021,10953912011,1095391
2762,28/06/2021,3328,158,2750,12,578,23/06/2021,"Chateau Angelus Premier Grand Cru Classe A, Saint-Emilion Grand Cru",Bordeaux,2016,01/07/2021,10060452016,1006045
685,30/07/2021,914,2,470,215,444,29/03/2018,"Chateau Batailley 5eme Cru Classe, Pauillac",Bordeaux,2000,31/07/2021,10063222000,1006322
820,15/07/2021,937,6,735,85,202,09/09/2020,"Chateau Calon Segur 3eme Cru Classe, Saint-Estephe",Bordeaux,2012,16/07/2021,10074752012,1007475
3617,15/07/2021,4289,40,3560,57,729,20/11/2020,"Chateau Margaux Premier Cru Classe, Margaux",Bordeaux,2012,16/07/2021,10127812012,1012781
1800,09/07/2021,1917,2,1440,360,477,04/01/2018,"Gaja, Barbaresco",Piedmont,2010,16/07/2021,10996052010,1099605
13200,15/07/2021,12867,1,12850,350,17,30/11/2020,"Jacques-Frederic Mugnier, Chambolle-Musigny Premier Cru, Les Amoureuses",Burgundy,2011,16/07/2021,10496422011,1049642
3740,15/07/2021,4095,25,3520,220,575,07/04/2021,"Chateau Margaux Premier Cru Classe, Margaux",Bordeaux,2013,16/07/2021,10127812013,1012781
2880,25/06/2021,3343,157,2750,130,593,23/06/2021,"Chateau Angelus Premier Grand Cru Classe A, Saint-Emilion Grand Cru",Bordeaux,2016,26/06/2021,10060452016,1006045
685,30/07/2021,685,1,470,215,215,29/03/2018,"Chateau Batailley 5eme Cru Classe, Pauillac",Bordeaux,2000,01/08/2021,10063222000,1006322
686,15/07/2021,819,7,682,4,137,15/09/2020,"Chateau Calon Segur 3eme Cru Classe, Saint-Estephe",Bordeaux,2013,16/07/2021,10074752013,1007475
1500,08/07/2021,1442,7,1352,148,90,23/09/2020,"Gaja, Barbaresco",Piedmont,2011,16/07/2021,10996052011,1099605
960,14/07/2021,1329,12,850,110,479,28/01/2021,"Tignanello, Toscana",Tuscany,2012,16/07/2021,10953912012,1095391
2880,25/06/2021,3343,154,2750,130,593,23/06/2021,"Chateau Angelus Premier Grand Cru Classe A, Saint-Emilion Grand Cru",Bordeaux,2016,28/06/2021,10060452016,1006045
3800,15/07/2021,4342,123,3480,320,862,17/06/2021,"Chateau Margaux Premier Cru Classe, Margaux",Bordeaux,2014,16/07/2021,10127812014,1012781
790,09/07/2021,880,19,801,-11,79,31/05/2021,"Chateau Calon Segur 3eme Cru Classe, Saint-Estephe",Bordeaux,2014,16/07/2021,10074752014,1007475
685,30/07/2021,685,1,470,215,215,29/03/2018,"Chateau Batailley 5eme Cru Classe, Pauillac",Bordeaux,2000,01/08/2021,10063222000,1006322
1550,15/07/2021,1550,1,1300,250,250,27/04/2021,"Gaja, Barbaresco",Piedmont,2012,16/07/2021,10996052012,1099605
1060,15/07/2021,1151,10,860,200,291,08/03/2021,"Tignanello, Toscana",Tuscany,2013,16/07/2021,10953912013,1095391
984,15/07/2021,1105,45,854,130,251,15/07/2021,"Tignanello, Toscana",Tuscany,2014,16/07/2021,10953912014,1095391
1390,13/07/2021,1527,14,1300,90,227,30/06/2021,"Gaja, Barbaresco",Piedmont,2013,16/07/2021,10996052013,1099605
2880,24/06/2021,3344,159,2750,130,594,23/06/2021,"Chateau Angelus Premier Grand Cru Classe A, Saint-Emilion Grand Cru",Bordeaux,2016,25/06/2021,10060452016,1006045
940,15/07/2021,1089,75,822,118,267,28/06/2021,"Chateau Calon Segur 3eme Cru Classe, Saint-Estephe",Bordeaux,2015,16/07/2021,10074752015,1007475
10614,07/07/2021,11829,50,9800,814,2029,11/06/2021,"Chateau Margaux Premier Cru Classe, Margaux",Bordeaux,2015,16/07/2021,10127812015,1012781
420,30/07/2021,470,4,220,200,250,17/06/2015,"Chateau Batailley 5eme Cru Classe, Pauillac",Bordeaux,2002,31/07/2021,10063222002,1006322
14520,15/07/2021,14520,1,12000,2520,2520,28/05/2020,"Jacques-Frederic Mugnier, Chambolle-Musigny Premier Cru, Les Amoureuses",Burgundy,2014,16/07/2021,10496422014,1049642
1130,14/07/2021,1170,13,1012,118,158,02/07/2021,"Tignanello, Toscana",Tuscany,2015,16/07/2021,10953912015,1095391
2880,23/06/2021,3341,160,2750,130,591,23/06/2021,"Chateau Angelus Premier Grand Cru Classe A, Saint-Emilion Grand Cru",Bordeaux,2016,24/06/2021,10060452016,1006045
1083,07/07/2021,1220,78,1036,47,184,27/05/2021,"Chateau Calon Segur 3eme Cru Classe, Saint-Estephe",Bordeaux,2016,16/07/2021,10074752016,1007475
450,30/07/2021,532,2,300,150,232,15/12/2019,"Chateau Batailley 5eme Cru Classe, Pauillac",Bordeaux,2004,31/07/2021,10063222004,1006322
1240,14/07/2021,1282,82,1220,20,62,14/07/2021,"Tignanello, Toscana",Tuscany,2016,16/07/2021,10953912016,1095391
1500,15/07/2021,1683,46,1400,100,283,08/07/2021,"Gaja, Barbaresco",Piedmont,2016,16/07/2021,10996052016,1099605
2880,22/06/2021,3341,160,2830,50,511,17/06/2021,"Chateau Angelus Premier Grand Cru Classe A, Saint-Emilion Grand Cru",Bordeaux,2016,23/06/2021,10060452016,1006045
780,15/07/2021,936,77,740,40,196,21/05/2021,"Chateau Calon Segur 3eme Cru Classe, Saint-Estephe",Bordeaux,2017,16/07/2021,10074752017,1007475
588,30/07/2021,625,48,520,68,105,17/06/2021,"Chateau Batailley 5eme Cru Classe, Pauillac",Bordeaux,2005,31/07/2021,10063222005,1006322
3800,15/07/2021,4480,143,3950,-150,530,30/06/2021,"Chateau Margaux Premier Cru Classe, Margaux",Bordeaux,2017,16/07/2021,10127812017,1012781
1350,14/07/2021,1479,56,1260,90,219,18/02/2021,"Gaja, Barbaresco",Piedmont,2015,16/07/2021,10996052015,1099605
460,15/07/2021,487,154,420,40,67,28/05/2021,"Tua Rita, Giusto di Notri, Toscana",Tuscany,2016,16/07/2021,11058072016,1105807
8000,15/07/2021,8676,4,6974,1026,1702,14/03/2021,"Domaine Leflaive, Chevalier-Montrachet Grand Cru",Burgundy,2017,16/07/2021,10734012017,1073401
7527,12/07/2021,9835,3,7290,237,2545,21/08/2020,"Domaine Denis Mortet, Chambertin Grand Cru",Burgundy,2017,16/07/2021,10490202017,1049020
2880,21/06/2021,3339,160,2830,50,509,17/06/2021,"Chateau Angelus Premier Grand Cru Classe A, Saint-Emilion Grand Cru",Bordeaux,2016,22/06/2021,10060452016,1006045
5415,08/07/2021,5855,102,5254,161,601,26/05/2021,"Chateau Margaux Premier Cru Classe, Margaux",Bordeaux,2018,16/07/2021,10127812018,1012781
1080,15/07/2021,1244,40,1058,22,186,14/07/2021,"Chateau Calon Segur 3eme Cru Classe, Saint-Estephe",Bordeaux,2018,16/07/2021,10074752018,1007475
857,14/07/2021,1009,118,848,9,161,15/07/2021,"Tignanello, Toscana",Tuscany,2017,16/07/2021,10953912017,1095391
8000,15/07/2021,8308,4,7330,670,978,02/06/2021,"Domaine Leflaive, Chevalier-Montrachet Grand Cru",Burgundy,2018,16/07/2021,10734012018,1073401
950,13/07/2021,1068,131,910,40,158,14/07/2021,"Tignanello, Toscana",Tuscany,2018,16/07/2021,10953912018,1095391
2880,18/06/2021,3260,175,2830,50,430,17/06/2021,"Chateau Angelus Premier Grand Cru Classe A, Saint-Emilion Grand Cru",Bordeaux,2016,21/06/2021,10060452016,1006045
588,30/07/2021,625,48,520,68,105,17/06/2021,"Chateau Batailley 5eme Cru Classe, Pauillac",Bordeaux,2005,31/07/2021,10063222005,1006322
5290,15/07/2021,4988,11,4160,1130,828,19/03/2021,"Chateau Margaux Premier Cru Classe, Margaux",Bordeaux,2019,16/07/2021,10127812019,1012781
1408,08/07/2021,1623,65,1398,10,225,01/07/2021,"Gaja, Barbaresco",Piedmont,2017,16/07/2021,10996052017,1099605
1624,15/07/2021,1676,21,1586,38,90,12/07/2021,"Gaja, Barbaresco",Piedmont,2018,16/07/2021,10996052018,1099605
880,03/08/2021,967,9,725,155,242,13/04/2021,"Chateau Calon Segur 3eme Cru Classe, Saint-Estephe",Bordeaux,2007,04/08/2021,10074752007,1007475
996,04/08/2021,1245,43,1026,-30,219,24/06/2021,"Chateau Calon Segur 3eme Cru Classe, Saint-Estephe",Bordeaux,2009,05/08/2021,10074752009,1007475
1573,04/08/2021,1674,7,1300,273,374,10/07/2021,"Gaja, Barbaresco",Piedmont,2014,05/08/2021,10996052014,1099605
465,30/07/2021,458,2,400,65,58,11/05/2021,"Chateau Batailley 5eme Cru Classe, Pauillac",Bordeaux,2006,31/07/2021,10063222006,1006322
5200,04/08/2021,5229,8,4160,1040,1069,19/03/2021,"Chateau Margaux Premier Cru Classe, Margaux",Bordeaux,2019,05/08/2021,10127812019,1012781
660,04/08/2021,727,5,390,270,337,18/08/2017,"Tua Rita, Giusto di Notri, Toscana",Tuscany,2006,05/08/2021,11058072006,1105807
3950,04/08/2021,4469,108,3780,170,689,23/07/2021,"Chateau Margaux Premier Cru Classe, Margaux",Bordeaux,2008,05/08/2021,10127812008,1012781
2880,18/06/2021,3258,176,2830,50,428,17/06/2021,"Chateau Angelus Premier Grand Cru Classe A, Saint-Emilion Grand Cru",Bordeaux,2016,19/06/2021,10060452016,1006045
2880,17/06/2021,3274,165,2830,50,444,17/06/2021,"Chateau Angelus Premier Grand Cru Classe A, Saint-Emilion Grand Cru",Bordeaux,2016,18/06/2021,10060452016,1006045
465,30/07/2021,458,2,400,65,58,11/05/2021,"Chateau Batailley 5eme Cru Classe, Pauillac",Bordeaux,2006,31/07/2021,10063222006,1006322
820,15/07/2021,937,6,735,85,202,09/09/2020,"Chateau Calon Segur 3eme Cru Classe, Saint-Estephe",Bordeaux,2012,16/07/2021,10074752012,1007475
3617,15/07/2021,4289,40,3560,57,729,20/11/2020,"Chateau Margaux Premier Cru Classe, Margaux",Bordeaux,2012,16/07/2021,10127812012,1012781
3740,15/07/2021,4095,25,3520,220,575,07/04/2021,"Chateau Margaux Premier Cru Classe, Margaux",Bordeaux,2013,16/07/2021,10127812013,1012781
2850,16/06/2021,3295,156,2740,110,555,14/06/2021,"Chateau Angelus Premier Grand Cru Classe A, Saint-Emilion Grand Cru",Bordeaux,2016,17/06/2021,10060452016,1006045
686,15/07/2021,819,7,682,4,137,15/09/2020,"Chateau Calon Segur 3eme Cru Classe, Saint-Estephe",Bordeaux,2013,16/07/2021,10074752013,1007475
960,14/07/2021,1329,12,850,110,479,28/01/2021,"Tignanello, Toscana",Tuscany,2012,16/07/2021,10953912012,1095391
2850,15/06/2021,3295,156,2740,110,555,14/06/2021,"Chateau Angelus Premier Grand Cru Classe A, Saint-Emilion Grand Cru",Bordeaux,2016,16/06/2021,10060452016,1006045
3800,15/07/2021,4342,123,3480,320,862,17/06/2021,"Chateau Margaux Premier Cru Classe, Margaux",Bordeaux,2014,16/07/2021,10127812014,1012781
790,09/07/2021,880,19,801,-11,79,31/05/2021,"Chateau Calon Segur 3eme Cru Classe, Saint-Estephe",Bordeaux,2014,16/07/2021,10074752014,1007475
1060,15/07/2021,1151,10,860,200,291,08/03/2021,"Tignanello, Toscana",Tuscany,2013,16/07/2021,10953912013,1095391
984,15/07/2021,1105,45,854,130,251,15/07/2021,"Tignanello, Toscana",Tuscany,2014,16/07/2021,10953912014,1095391
940,15/07/2021,1089,75,822,118,267,28/06/2021,"Chateau Calon Segur 3eme Cru Classe, Saint-Estephe",Bordeaux,2015,16/07/2021,10074752015,1007475
10614,07/07/2021,11829,50,9800,814,2029,11/06/2021,"Chateau Margaux Premier Cru Classe, Margaux",Bordeaux,2015,16/07/2021,10127812015,1012781
1040,14/07/2021,1336,39,940,100,396,18/03/2021,"Chateau Calon Segur 3eme Cru Classe, Saint-Estephe",Bordeaux,2000,17/07/2021,10074752000,1007475
870,16/07/2021,966,5,705,165,261,01/02/2021,"Chateau Calon Segur 3eme Cru Classe, Saint-Estephe",Bordeaux,2002,17/07/2021,10074752002,1007475
950,16/07/2021,1131,23,800,150,331,21/11/2019,"Chateau Calon Segur 3eme Cru Classe, Saint-Estephe",Bordeaux,2003,17/07/2021,10074752003,1007475
9000,16/07/2021,8799,1,5400,3600,3399,13/08/2020,"Domaine Leflaive, Chevalier-Montrachet Grand Cru",Burgundy,2008,19/07/2021,10734012008,1073401
2500,16/07/2021,2671,3,2400,100,271,18/07/2021,"Gaja, Barbaresco",Piedmont,2001,19/07/2021,10996052001,1099605
1592,08/07/2021,1638,5,1378,214,260,29/07/2020,"Tignanello, Toscana",Tuscany,2001,19/07/2021,10953912001,1095391
990,16/07/2021,1124,16,990,0,134,16/06/2021,"Chateau Calon Segur 3eme Cru Classe, Saint-Estephe",Bordeaux,2010,19/07/2021,10074752010,1007475
800,16/07/2021,994,36,790,10,204,01/06/2020,"Chateau Calon Segur 3eme Cru Classe, Saint-Estephe",Bordeaux,2011,19/07/2021,10074752011,1007475
6156,02/07/2021,6436,0,6500,-344,-64,26/05/2021,"Domaine Leflaive, Chevalier-Montrachet Grand Cru",Burgundy,2011,19/07/2021,10734012011,1073401
3750,15/07/2021,4284,40,3560,190,724,20/11/2020,"Chateau Margaux Premier Cru Classe, Margaux",Bordeaux,2012,19/07/2021,10127812012,1012781
6400,08/07/2021,6400,0,4500,1900,1900,08/04/2015,"Domaine Leflaive, Chevalier-Montrachet Grand Cru",Burgundy,2012,19/07/2021,10734012012,1073401
17300,17/06/2021,14868,0,6538,10762,8330,05/07/2016,"Jacques-Frederic Mugnier, Chambolle-Musigny Premier Cru, Les Amoureuses",Burgundy,2012,19/07/2021,10496422012,1049642
1390,13/07/2021,1527,14,1360,30,167,18/07/2021,"Gaja, Barbaresco",Piedmont,2013,19/07/2021,10996052013,1099605
2880,14/06/2021,3291,154,2740,140,551,14/06/2021,"Chateau Angelus Premier Grand Cru Classe A, Saint-Emilion Grand Cru",Bordeaux,2016,15/06/2021,10060452016,1006045
1130,14/07/2021,1169,13,1012,118,157,02/07/2021,"Tignanello, Toscana",Tuscany,2015,19/07/2021,10953912015,1095391
2880,11/06/2021,3291,154,2710,170,581,10/06/2021,"Chateau Angelus Premier Grand Cru Classe A, Saint-Emilion Grand Cru",Bordeaux,2016,14/06/2021,10060452016,1006045
1250,16/07/2021,1322,81,1220,30,102,14/07/2021,"Tignanello, Toscana",Tuscany,2016,19/07/2021,10953912016,1095391
1500,16/07/2021,1683,46,1510,-10,173,18/07/2021,"Gaja, Barbaresco",Piedmont,2016,19/07/2021,10996052016,1099605
450,30/07/2021,431,3,332,118,99,06/10/2020,"Chateau Batailley 5eme Cru Classe, Pauillac",Bordeaux,2008,31/07/2021,10063222008,1006322
3826,16/07/2021,4576,46,4116,-290,460,25/02/2021,"Chateau Margaux Premier Cru Classe, Margaux",Bordeaux,2004,17/07/2021,10127812004,1012781
3939,16/07/2021,4430,22,3684,255,746,10/06/2020,"Chateau Margaux Premier Cru Classe, Margaux",Bordeaux,2002,17/07/2021,10127812002,1012781
4450,16/07/2021,4772,24,4400,50,372,29/09/2020,"Chateau Margaux Premier Cru Classe, Margaux",Bordeaux,2001,17/07/2021,10127812001,1012781
4850,16/07/2021,6067,24,4650,200,1417,21/06/2021,"Chateau Margaux Premier Cru Classe, Margaux",Bordeaux,2003,17/07/2021,10127812003,1012781
2880,11/06/2021,3293,155,2710,170,583,10/06/2021,"Chateau Angelus Premier Grand Cru Classe A, Saint-Emilion Grand Cru",Bordeaux,2016,12/06/2021,10060452016,1006045
2880,10/06/2021,3269,165,2710,170,559,10/06/2021,"Chateau Angelus Premier Grand Cru Classe A, Saint-Emilion Grand Cru",Bordeaux,2016,11/06/2021,10060452016,1006045
840,16/07/2021,977,16,745,95,232,16/11/2020,"Chateau Calon Segur 3eme Cru Classe, Saint-Estephe",Bordeaux,2004,17/07/2021,10074752004,1007475
907,16/07/2021,926,18,805,102,121,20/11/2019,"Chateau Calon Segur 3eme Cru Classe, Saint-Estephe",Bordeaux,2001,17/07/2021,10074752001,1007475
450,30/07/2021,446,2,332,118,114,06/10/2020,"Chateau Batailley 5eme Cru Classe, Pauillac",Bordeaux,2008,01/08/2021,10063222008,1006322
500,30/07/2021,520,7,450,50,70,25/05/2021,"Chateau Batailley 5eme Cru Classe, Pauillac",Bordeaux,2009,31/07/2021,10063222009,1006322
6500,16/07/2021,7413,27,6776,-276,637,10/06/2021,"Chateau Margaux Premier Cru Classe, Margaux",Bordeaux,2005,17/07/2021,10127812005,1012781
2837,27/05/2021,3355,133,2710,127,645,04/06/2021,"Chateau Angelus Premier Grand Cru Classe A, Saint-Emilion Grand Cru",Bordeaux,2016,09/06/2021,10060452016,1006045
500,30/07/2021,520,7,450,50,70,25/05/2021,"Chateau Batailley 5eme Cru Classe, Pauillac",Bordeaux,2009,31/07/2021,10063222009,1006322
525,30/07/2021,595,400,494,31,101,20/04/2021,"Chateau Batailley 5eme Cru Classe, Pauillac",Bordeaux,2010,31/07/2021,10063222010,1006322
525,30/07/2021,595,400,494,31,101,20/04/2021,"Chateau Batailley 5eme Cru Classe, Pauillac",Bordeaux,2010,31/07/2021,10063222010,1006322
2837,27/05/2021,3307,174,2710,127,597,04/06/2021,"Chateau Angelus Premier Grand Cru Classe A, Saint-Emilion Grand Cru",Bordeaux,2016,10/06/2021,10060452016,1006045
895,16/07/2021,921,39,863,32,58,10/05/2021,"Chateau Calon Segur 3eme Cru Classe, Saint-Estephe",Bordeaux,2006,17/07/2021,10074752006,1007475
3900,16/07/2021,4698,82,3822,78,876,20/06/2021,"Chateau Margaux Premier Cru Classe, Margaux",Bordeaux,2006,17/07/2021,10127812006,1012781
3750,16/07/2021,4255,82,3525,225,730,18/06/2021,"Chateau Margaux Premier Cru Classe, Margaux",Bordeaux,2007,17/07/2021,10127812007,1012781
880,16/07/2021,980,7,725,155,255,13/04/2021,"Chateau Calon Segur 3eme Cru Classe, Saint-Estephe",Bordeaux,2007,17/07/2021,10074752007,1007475
2837,27/05/2021,3362,130,2720,117,642,27/05/2021,"Chateau Angelus Premier Grand Cru Classe A, Saint-Emilion Grand Cru",Bordeaux,2016,01/06/2021,10060452016,1006045
8400,16/07/2021,8400,1,5700,2700,2700,10/09/2020,"Domaine Leflaive, Chevalier-Montrachet Grand Cru",Burgundy,2007,17/07/2021,10734012007,1073401
2837,27/05/2021,3298,119,2720,117,578,27/05/2021,"Chateau Angelus Premier Grand Cru Classe A, Saint-Emilion Grand Cru",Bordeaux,2016,28/05/2021,10060452016,1006045
3900,16/07/2021,4350,71,3870,30,480,10/07/2021,"Chateau Margaux Premier Cru Classe, Margaux",Bordeaux,2008,17/07/2021,10127812008,1012781
525,30/07/2021,594,399,494,31,100,20/04/2021,"Chateau Batailley 5eme Cru Classe, Pauillac",Bordeaux,2010,01/08/2021,10063222010,1006322
895,16/07/2021,978,10,781,114,197,16/11/2020,"Chateau Calon Segur 3eme Cru Classe, Saint-Estephe",Bordeaux,2008,17/07/2021,10074752008,1007475
6880,16/07/2021,7747,48,7086,-206,661,11/06/2021,"Chateau Margaux Premier Cru Classe, Margaux",Bordeaux,2009,17/07/2021,10127812009,1012781
9000,16/07/2021,10761,2,5400,3600,5361,13/08/2020,"Domaine Leflaive, Chevalier-Montrachet Grand Cru",Burgundy,2008,17/07/2021,10734012008,1073401
1000,16/07/2021,1231,51,1026,-26,205,24/06/2021,"Chateau Calon Segur 3eme Cru Classe, Saint-Estephe",Bordeaux,2009,17/07/2021,10074752009,1007475
525,30/07/2021,594,399,494,31,100,20/04/2021,"Chateau Batailley 5eme Cru Classe, Pauillac",Bordeaux,2010,01/08/2021,10063222010,1006322
2837,27/05/2021,3314,121,2720,117,594,27/05/2021,"Chateau Angelus Premier Grand Cru Classe A, Saint-Emilion Grand Cru",Bordeaux,2016,29/05/2021,10060452016,1006045
1850,16/07/2021,1831,1,1180,670,651,10/03/2017,"Gaja, Barbaresco",Piedmont,2005,17/07/2021,10996052005,1099605
1800,16/07/2021,1700,1,1300,500,400,30/05/2019,"Gaja, Barbaresco",Piedmont,2007,17/07/2021,10996052007,1099605
2437,16/07/2021,2719,1,1768,669,951,22/05/2020,"Gaja, Barbaresco",Piedmont,2000,17/07/2021,10996052000,1099605
2500,16/07/2021,2671,3,2220,280,451,14/06/2021,"Gaja, Barbaresco",Piedmont,2001,17/07/2021,10996052001,1099605
2386,16/07/2021,2397,3,2190,196,207,01/05/2021,"Gaja, Barbaresco",Piedmont,2004,17/07/2021,10996052004,1099605
574,16/07/2021,574,1,351,223,223,25/07/2016,"Tua Rita, Giusto di Notri, Toscana",Tuscany,2004,17/07/2021,11058072004,1105807
520,16/07/2021,563,3,460,60,103,05/05/2020,"Tua Rita, Giusto di Notri, Toscana",Tuscany,2008,17/07/2021,11058072008,1105807
660,16/07/2021,727,5,390,270,337,18/08/2017,"Tua Rita, Giusto di Notri, Toscana",Tuscany,2006,17/07/2021,11058072006,1105807
1300,08/07/2021,1378,2,1200,100,178,06/03/2021,"Tignanello, Toscana",Tuscany,2007,17/07/2021,10953912007,1095391
6400,16/07/2021,7551,54,6188,212,1363,16/07/2021,"Chateau Margaux Premier Cru Classe, Margaux",Bordeaux,2010,17/07/2021,10127812010,1012781
400,30/07/2021,414,8,408,-8,6,14/07/2021,"Chateau Batailley 5eme Cru Classe, Pauillac",Bordeaux,2012,31/07/2021,10063222012,1006322
990,16/07/2021,1137,16,990,0,147,16/06/2021,"Chateau Calon Segur 3eme Cru Classe, Saint-Estephe",Bordeaux,2010,17/07/2021,10074752010,1007475
2837,27/05/2021,3362,130,2710,127,652,04/06/2021,"Chateau Angelus Premier Grand Cru Classe A, Saint-Emilion Grand Cru",Bordeaux,2016,05/06/2021,10060452016,1006045
800,16/07/2021,991,36,790,10,201,01/06/2020,"Chateau Calon Segur 3eme Cru Classe, Saint-Estephe",Bordeaux,2011,17/07/2021,10074752011,1007475
1180,16/07/2021,1378,3,1072,108,306,20/01/2021,"Tignanello, Toscana",Tuscany,2009,17/07/2021,10953912009,1095391
1260,16/07/2021,1525,4,1170,90,355,24/06/2021,"Tignanello, Toscana",Tuscany,2010,17/07/2021,10953912010,1095391
3758,16/07/2021,4348,73,3690,68,658,13/04/2021,"Chateau Margaux Premier Cru Classe, Margaux",Bordeaux,2011,17/07/2021,10127812011,1012781
2199,16/07/2021,2229,1,1340,859,889,13/03/2020,"Gaja, Barbaresco",Piedmont,2009,17/07/2021,10996052009,1099605
1050,16/07/2021,1134,8,880,170,254,22/06/2021,"Tignanello, Toscana",Tuscany,2011,17/07/2021,10953912011,1095391
2880,26/05/2021,3306,119,2750,130,556,21/05/2021,"Chateau Angelus Premier Grand Cru Classe A, Saint-Emilion Grand Cru",Bordeaux,2016,27/05/2021,10060452016,1006045
400,30/07/2021,414,8,408,-8,6,14/07/2021,"Chateau Batailley 5eme Cru Classe, Pauillac",Bordeaux,2012,31/07/2021,10063222012,1006322
820,16/07/2021,924,5,735,85,189,09/09/2020,"Chateau Calon Segur 3eme Cru Classe, Saint-Estephe",Bordeaux,2012,17/07/2021,10074752012,1007475
3750,15/07/2021,4278,41,3560,190,718,20/11/2020,"Chateau Margaux Premier Cru Classe, Margaux",Bordeaux,2012,17/07/2021,10127812012,1012781
13200,16/07/2021,12867,1,12850,350,17,30/11/2020,"Jacques-Frederic Mugnier, Chambolle-Musigny Premier Cru, Les Amoureuses",Burgundy,2011,17/07/2021,10496422011,1049642
3740,16/07/2021,4095,25,3520,220,575,07/04/2021,"Chateau Margaux Premier Cru Classe, Margaux",Bordeaux,2013,17/07/2021,10127812013,1012781
320,30/07/2021,320,103,304,16,16,10/01/2021,"Chateau Batailley 5eme Cru Classe, Pauillac",Bordeaux,2013,31/07/2021,10063222013,1006322
686,16/07/2021,810,6,682,4,128,15/09/2020,"Chateau Calon Segur 3eme Cru Classe, Saint-Estephe",Bordeaux,2013,17/07/2021,10074752013,1007475
5600,10/05/2021,6608,0,4400,1200,2208,06/11/2017,"Domaine Leflaive, Chevalier-Montrachet Grand Cru",Burgundy,2013,17/07/2021,10734012013,1073401
960,16/07/2021,1329,12,850,110,479,28/01/2021,"Tignanello, Toscana",Tuscany,2012,17/07/2021,10953912012,1095391
2800,25/05/2021,3300,121,2750,50,550,21/05/2021,"Chateau Angelus Premier Grand Cru Classe A, Saint-Emilion Grand Cru",Bordeaux,2016,26/05/2021,10060452016,1006045
3800,16/07/2021,4346,122,3480,320,866,17/06/2021,"Chateau Margaux Premier Cru Classe, Margaux",Bordeaux,2014,17/07/2021,10127812014,1012781
790,16/07/2021,879,18,801,-11,78,31/05/2021,"Chateau Calon Segur 3eme Cru Classe, Saint-Estephe",Bordeaux,2014,17/07/2021,10074752014,1007475
360,30/07/2021,373,73,360,0,13,14/07/2021,"Chateau Batailley 5eme Cru Classe, Pauillac",Bordeaux,2014,31/07/2021,10063222014,1006322
1550,16/07/2021,1550,1,1300,250,250,27/04/2021,"Gaja, Barbaresco",Piedmont,2012,17/07/2021,10996052012,1099605
1060,16/07/2021,1150,10,860,200,290,08/03/2021,"Tignanello, Toscana",Tuscany,2013,17/07/2021,10953912013,1095391
984,16/07/2021,1105,45,854,130,251,15/07/2021,"Tignanello, Toscana",Tuscany,2014,17/07/2021,10953912014,1095391
940,16/07/2021,1089,75,822,118,267,28/06/2021,"Chateau Calon Segur 3eme Cru Classe, Saint-Estephe",Bordeaux,2015,17/07/2021,10074752015,1007475
10614,07/07/2021,11812,47,9800,814,2012,11/06/2021,"Chateau Margaux Premier Cru Classe, Margaux",Bordeaux,2015,17/07/2021,10127812015,1012781
14520,16/07/2021,14520,1,12000,2520,2520,28/05/2020,"Jacques-Frederic Mugnier, Chambolle-Musigny Premier Cru, Les Amoureuses",Burgundy,2014,17/07/2021,10496422014,1049642
480,16/07/2021,538,20,388,92,150,29/09/2020,"Tua Rita, Giusto di Notri, Toscana",Tuscany,2015,17/07/2021,11058072015,1105807
16200,16/07/2021,16327,0,18750,-2550,-2423,29/08/2018,"Jacques-Frederic Mugnier, Chambolle-Musigny Premier Cru, Les Amoureuses",Burgundy,2015,17/07/2021,10496422015,1049642
5415,05/07/2021,5860,119,5500,-85,360,06/07/2021,"Chateau Margaux Premier Cru Classe, Margaux",Bordeaux,2016,17/07/2021,10127812016,1012781
2800,24/05/2021,3293,116,2750,50,543,21/05/2021,"Chateau Angelus Premier Grand Cru Classe A, Saint-Emilion Grand Cru",Bordeaux,2016,25/05/2021,10060452016,1006045
1083,07/07/2021,1219,77,1036,47,183,27/05/2021,"Chateau Calon Segur 3eme Cru Classe, Saint-Estephe",Bordeaux,2016,17/07/2021,10074752016,1007475
360,30/07/2021,371,72,360,0,11,14/07/2021,"Chateau Batailley 5eme Cru Classe, Pauillac",Bordeaux,2014,02/08/2021,10063222014,1006322
1250,16/07/2021,1319,83,1220,30,99,14/07/2021,"Tignanello, Toscana",Tuscany,2016,17/07/2021,10953912016,1095391
1500,16/07/2021,1683,46,1400,100,283,08/07/2021,"Gaja, Barbaresco",Piedmont,2016,17/07/2021,10996052016,1099605
2800,21/05/2021,3274,121,2750,50,524,21/05/2021,"Chateau Angelus Premier Grand Cru Classe A, Saint-Emilion Grand Cru",Bordeaux,2016,24/05/2021,10060452016,1006045
780,16/07/2021,934,76,740,40,194,21/05/2021,"Chateau Calon Segur 3eme Cru Classe, Saint-Estephe",Bordeaux,2017,17/07/2021,10074752017,1007475
415,30/07/2021,523,38,364,51,159,12/05/2021,"Chateau Batailley 5eme Cru Classe, Pauillac",Bordeaux,2016,31/07/2021,10063222016,1006322
3800,16/07/2021,4480,143,3950,-150,530,30/06/2021,"Chateau Margaux Premier Cru Classe, Margaux",Bordeaux,2017,17/07/2021,10127812017,1012781
1350,16/07/2021,1479,56,1260,90,219,18/02/2021,"Gaja, Barbaresco",Piedmont,2015,17/07/2021,10996052015,1099605
460,16/07/2021,487,154,420,40,67,28/05/2021,"Tua Rita, Giusto di Notri, Toscana",Tuscany,2016,17/07/2021,11058072016,1105807
8000,16/07/2021,8676,4,6974,1026,1702,14/03/2021,"Domaine Leflaive, Chevalier-Montrachet Grand Cru",Burgundy,2017,17/07/2021,10734012017,1073401
7527,12/07/2021,9833,3,7290,237,2543,21/08/2020,"Domaine Denis Mortet, Chambertin Grand Cru",Burgundy,2017,17/07/2021,10490202017,1049020
15600,14/07/2021,15261,5,13000,2600,2261,29/04/2021,"Jacques-Frederic Mugnier, Chambolle-Musigny Premier Cru, Les Amoureuses",Burgundy,2017,17/07/2021,10496422017,1049642
2800,21/05/2021,3283,122,2750,50,533,21/05/2021,"Chateau Angelus Premier Grand Cru Classe A, Saint-Emilion Grand Cru",Bordeaux,2016,22/05/2021,10060452016,1006045
1080,16/07/2021,1248,39,1058,22,190,14/07/2021,"Chateau Calon Segur 3eme Cru Classe, Saint-Estephe",Bordeaux,2018,17/07/2021,10074752018,1007475
415,30/07/2021,519,37,364,51,155,12/05/2021,"Chateau Batailley 5eme Cru Classe, Pauillac",Bordeaux,2016,02/08/2021,10063222016,1006322
857,14/07/2021,1010,118,848,9,162,15/07/2021,"Tignanello, Toscana",Tuscany,2017,17/07/2021,10953912017,1095391
8000,16/07/2021,8302,4,7330,670,972,02/06/2021,"Domaine Leflaive, Chevalier-Montrachet Grand Cru",Burgundy,2018,17/07/2021,10734012018,1073401
950,13/07/2021,1083,86,910,40,173,14/07/2021,"Tignanello, Toscana",Tuscany,2018,17/07/2021,10953912018,1095391
2800,20/05/2021,3348,97,2600,200,748,20/05/2021,"Chateau Angelus Premier Grand Cru Classe A, Saint-Emilion Grand Cru",Bordeaux,2016,21/05/2021,10060452016,1006045
401,30/07/2021,413,27,357,44,56,06/05/2021,"Chateau Batailley 5eme Cru Classe, Pauillac",Bordeaux,2018,31/07/2021,10063222018,1006322
5290,15/07/2021,4911,10,4160,1130,751,19/03/2021,"Chateau Margaux Premier Cru Classe, Margaux",Bordeaux,2019,17/07/2021,10127812019,1012781
1624,16/07/2021,1676,21,1586,38,90,16/07/2021,"Gaja, Barbaresco",Piedmont,2018,17/07/2021,10996052018,1099605
401,30/07/2021,409,27,357,44,52,06/05/2021,"Chateau Batailley 5eme Cru Classe, Pauillac",Bordeaux,2018,06/08/2021,10063222018,1006322
7812,19/07/2021,7812,0,8540,-728,-728,02/12/2019,"Domaine Leflaive, Chevalier-Montrachet Grand Cru",Burgundy,2001,20/07/2021,10734012001,1073401
1040,14/07/2021,1383,66,940,100,443,18/03/2021,"Chateau Calon Segur 3eme Cru Classe, Saint-Estephe",Bordeaux,2000,20/07/2021,10074752000,1007475
2800,19/05/2021,3333,100,2800,0,533,14/05/2021,"Chateau Angelus Premier Grand Cru Classe A, Saint-Emilion Grand Cru",Bordeaux,2016,20/05/2021,10060452016,1006045
2800,18/05/2021,3333,100,2800,0,533,14/05/2021,"Chateau Angelus Premier Grand Cru Classe A, Saint-Emilion Grand Cru",Bordeaux,2016,19/05/2021,10060452016,1006045
960,16/07/2021,1329,12,850,110,479,28/01/2021,"Tignanello, Toscana",Tuscany,2012,17/07/2021,10953912012,1095391
3800,16/07/2021,4346,122,3480,320,866,17/06/2021,"Chateau Margaux Premier Cru Classe, Margaux",Bordeaux,2014,17/07/2021,10127812014,1012781
2800,14/05/2021,3329,99,2800,0,529,14/05/2021,"Chateau Angelus Premier Grand Cru Classe A, Saint-Emilion Grand Cru",Bordeaux,2016,18/05/2021,10060452016,1006045
790,16/07/2021,879,18,801,-11,78,31/05/2021,"Chateau Calon Segur 3eme Cru Classe, Saint-Estephe",Bordeaux,2014,17/07/2021,10074752014,1007475
1060,16/07/2021,1150,10,860,200,290,08/03/2021,"Tignanello, Toscana",Tuscany,2013,17/07/2021,10953912013,1095391
984,16/07/2021,1105,45,854,130,251,15/07/2021,"Tignanello, Toscana",Tuscany,2014,17/07/2021,10953912014,1095391
940,16/07/2021,1089,75,822,118,267,28/06/2021,"Chateau Calon Segur 3eme Cru Classe, Saint-Estephe",Bordeaux,2015,17/07/2021,10074752015,1007475
10614,07/07/2021,11812,47,9800,814,2012,11/06/2021,"Chateau Margaux Premier Cru Classe, Margaux",Bordeaux,2015,17/07/2021,10127812015,1012781
2800,14/05/2021,3423,81,2800,0,623,14/05/2021,"Chateau Angelus Premier Grand Cru Classe A, Saint-Emilion Grand Cru",Bordeaux,2016,17/05/2021,10060452016,1006045
6500,16/07/2021,7496,25,6776,-276,720,10/06/2021,"Chateau Margaux Premier Cru Classe, Margaux",Bordeaux,2005,18/07/2021,10127812005,1012781
2800,14/05/2021,3401,86,2800,0,601,14/05/2021,"Chateau Angelus Premier Grand Cru Classe A, Saint-Emilion Grand Cru",Bordeaux,2016,15/05/2021,10060452016,1006045
401,30/07/2021,408,26,357,44,51,06/05/2021,"Chateau Batailley 5eme Cru Classe, Pauillac",Bordeaux,2018,02/08/2021,10063222018,1006322
1408,06/07/2021,1425,1,996,412,429,14/06/2019,"Tignanello, Toscana",Tuscany,2000,18/07/2021,10953912000,1095391
1260,16/07/2021,1628,3,1170,90,458,24/06/2021,"Tignanello, Toscana",Tuscany,2010,18/07/2021,10953912010,1095391
2500,16/07/2021,2671,3,2400,100,271,18/07/2021,"Gaja, Barbaresco",Piedmont,2001,19/07/2021,10996052001,1099605
1592,08/07/2021,1638,5,1378,214,260,29/07/2020,"Tignanello, Toscana",Tuscany,2001,19/07/2021,10953912001,1095391
990,16/07/2021,1124,16,990,0,134,16/06/2021,"Chateau Calon Segur 3eme Cru Classe, Saint-Estephe",Bordeaux,2010,19/07/2021,10074752010,1007475
800,16/07/2021,994,36,790,10,204,01/06/2020,"Chateau Calon Segur 3eme Cru Classe, Saint-Estephe",Bordeaux,2011,19/07/2021,10074752011,1007475
3750,15/07/2021,4284,40,3560,190,724,20/11/2020,"Chateau Margaux Premier Cru Classe, Margaux",Bordeaux,2012,19/07/2021,10127812012,1012781
1040,21/07/2021,1383,66,940,100,443,18/03/2021,"Chateau Calon Segur 3eme Cru Classe, Saint-Estephe",Bordeaux,2000,22/07/2021,10074752000,1007475
8200,19/07/2021,9082,15,8100,100,982,21/06/2021,"Chateau Margaux Premier Cru Classe, Margaux",Bordeaux,2000,20/07/2021,10127812000,1012781
950,19/07/2021,1118,23,800,150,318,21/11/2019,"Chateau Calon Segur 3eme Cru Classe, Saint-Estephe",Bordeaux,2003,20/07/2021,10074752003,1007475
2800,12/05/2021,3324,96,2640,160,684,12/05/2021,"Chateau Angelus Premier Grand Cru Classe A, Saint-Emilion Grand Cru",Bordeaux,2016,13/05/2021,10060452016,1006045
4450,19/07/2021,4754,23,4400,50,354,29/09/2020,"Chateau Margaux Premier Cru Classe, Margaux",Bordeaux,2001,20/07/2021,10127812001,1012781
3939,19/07/2021,4416,21,3684,255,732,10/06/2020,"Chateau Margaux Premier Cru Classe, Margaux",Bordeaux,2002,20/07/2021,10127812002,1012781
3826,19/07/2021,4585,47,4116,-290,469,25/02/2021,"Chateau Margaux Premier Cru Classe, Margaux",Bordeaux,2004,20/07/2021,10127812004,1012781
4850,16/07/2021,6003,22,4650,200,1353,21/06/2021,"Chateau Margaux Premier Cru Classe, Margaux",Bordeaux,2003,20/07/2021,10127812003,1012781
2800,12/05/2021,3401,86,2640,160,761,12/05/2021,"Chateau Angelus Premier Grand Cru Classe A, Saint-Emilion Grand Cru",Bordeaux,2016,14/05/2021,10060452016,1006045
2800,10/05/2021,3325,95,2380,420,945,06/05/2021,"Chateau Angelus Premier Grand Cru Classe A, Saint-Emilion Grand Cru",Bordeaux,2016,12/05/2021,10060452016,1006045
840,16/07/2021,1052,20,745,95,307,16/11/2020,"Chateau Calon Segur 3eme Cru Classe, Saint-Estephe",Bordeaux,2004,20/07/2021,10074752004,1007475
2800,10/05/2021,3324,87,2380,420,944,06/05/2021,"Chateau Angelus Premier Grand Cru Classe A, Saint-Emilion Grand Cru",Bordeaux,2016,11/05/2021,10060452016,1006045
907,19/07/2021,926,18,805,102,121,20/11/2019,"Chateau Calon Segur 3eme Cru Classe, Saint-Estephe",Bordeaux,2001,20/07/2021,10074752001,1007475
685,02/08/2021,685,1,470,215,215,29/03/2018,"Chateau Batailley 5eme Cru Classe, Pauillac",Bordeaux,2000,03/08/2021,10063222000,1006322
2800,07/05/2021,3317,88,2380,420,937,06/05/2021,"Chateau Angelus Premier Grand Cru Classe A, Saint-Emilion Grand Cru",Bordeaux,2016,10/05/2021,10060452016,1006045
685,02/08/2021,685,1,470,215,215,29/03/2018,"Chateau Batailley 5eme Cru Classe, Pauillac",Bordeaux,2000,03/08/2021,10063222000,1006322
6500,19/07/2021,7502,24,6776,-276,726,10/06/2021,"Chateau Margaux Premier Cru Classe, Margaux",Bordeaux,2005,20/07/2021,10127812005,1012781
2800,07/05/2021,3261,99,2380,420,881,06/05/2021,"Chateau Angelus Premier Grand Cru Classe A, Saint-Emilion Grand Cru",Bordeaux,2016,08/05/2021,10060452016,1006045
990,19/07/2021,1165,84,988,2,177,28/05/2021,"Chateau Calon Segur 3eme Cru Classe, Saint-Estephe",Bordeaux,2005,20/07/2021,10074752005,1007475
450,02/08/2021,532,2,300,150,232,15/12/2019,"Chateau Batailley 5eme Cru Classe, Pauillac",Bordeaux,2004,03/08/2021,10063222004,1006322
6816,19/07/2021,6816,0,6405,411,411,19/07/2019,"Domaine Leflaive, Chevalier-Montrachet Grand Cru",Burgundy,2005,20/07/2021,10734012005,1073401
895,19/07/2021,916,51,863,32,53,10/05/2021,"Chateau Calon Segur 3eme Cru Classe, Saint-Estephe",Bordeaux,2006,20/07/2021,10074752006,1007475
3900,19/07/2021,4683,79,3822,78,861,20/06/2021,"Chateau Margaux Premier Cru Classe, Margaux",Bordeaux,2006,20/07/2021,10127812006,1012781
2800,05/05/2021,3249,102,2708,92,541,20/04/2021,"Chateau Angelus Premier Grand Cru Classe A, Saint-Emilion Grand Cru",Bordeaux,2016,06/05/2021,10060452016,1006045
3750,19/07/2021,4192,93,3525,225,667,18/06/2021,"Chateau Margaux Premier Cru Classe, Margaux",Bordeaux,2007,20/07/2021,10127812007,1012781
880,19/07/2021,980,7,725,155,255,13/04/2021,"Chateau Calon Segur 3eme Cru Classe, Saint-Estephe",Bordeaux,2007,20/07/2021,10074752007,1007475
2800,05/05/2021,3261,102,2380,420,881,06/05/2021,"Chateau Angelus Premier Grand Cru Classe A, Saint-Emilion Grand Cru",Bordeaux,2016,07/05/2021,10060452016,1006045
8400,19/07/2021,8400,1,5700,2700,2700,10/09/2020,"Domaine Leflaive, Chevalier-Montrachet Grand Cru",Burgundy,2007,20/07/2021,10734012007,1073401
2800,04/05/2021,3248,102,2708,92,540,20/04/2021,"Chateau Angelus Premier Grand Cru Classe A, Saint-Emilion Grand Cru",Bordeaux,2016,05/05/2021,10060452016,1006045
3900,19/07/2021,4355,72,3870,30,485,10/07/2021,"Chateau Margaux Premier Cru Classe, Margaux",Bordeaux,2008,20/07/2021,10127812008,1012781
895,19/07/2021,935,22,781,114,154,16/11/2020,"Chateau Calon Segur 3eme Cru Classe, Saint-Estephe",Bordeaux,2008,20/07/2021,10074752008,1007475
6930,19/07/2021,7697,52,7086,-156,611,11/06/2021,"Chateau Margaux Premier Cru Classe, Margaux",Bordeaux,2009,20/07/2021,10127812009,1012781
9000,19/07/2021,8799,1,5400,3600,3399,13/08/2020,"Domaine Leflaive, Chevalier-Montrachet Grand Cru",Burgundy,2008,20/07/2021,10734012008,1073401
1000,19/07/2021,1231,51,1026,-26,205,24/06/2021,"Chateau Calon Segur 3eme Cru Classe, Saint-Estephe",Bordeaux,2009,20/07/2021,10074752009,1007475
588,02/08/2021,625,48,520,68,105,17/06/2021,"Chateau Batailley 5eme Cru Classe, Pauillac",Bordeaux,2005,03/08/2021,10063222005,1006322
2800,03/05/2021,3225,114,2708,92,517,20/04/2021,"Chateau Angelus Premier Grand Cru Classe A, Saint-Emilion Grand Cru",Bordeaux,2016,04/05/2021,10060452016,1006045
1850,19/07/2021,1831,1,1180,670,651,10/03/2017,"Gaja, Barbaresco",Piedmont,2005,20/07/2021,10996052005,1099605
2500,19/07/2021,2643,3,2400,100,243,18/07/2021,"Gaja, Barbaresco",Piedmont,2001,20/07/2021,10996052001,1099605
2386,19/07/2021,2397,3,2190,196,207,01/05/2021,"Gaja, Barbaresco",Piedmont,2004,20/07/2021,10996052004,1099605
1800,19/07/2021,1700,1,1300,500,400,30/05/2019,"Gaja, Barbaresco",Piedmont,2007,20/07/2021,10996052007,1099605
520,19/07/2021,563,3,460,60,103,05/05/2020,"Tua Rita, Giusto di Notri, Toscana",Tuscany,2008,20/07/2021,11058072008,1105807
660,19/07/2021,727,5,390,270,337,18/08/2017,"Tua Rita, Giusto di Notri, Toscana",Tuscany,2006,20/07/2021,11058072006,1105807
1299,06/07/2021,1516,5,1010,289,506,18/12/2020,"Tignanello, Toscana",Tuscany,2008,20/07/2021,10953912008,1095391
1592,08/07/2021,1657,4,1378,214,279,29/07/2020,"Tignanello, Toscana",Tuscany,2001,20/07/2021,10953912001,1095391
1248,08/07/2021,1310,4,1238,10,72,02/11/2020,"Tignanello, Toscana",Tuscany,2006,20/07/2021,10953912006,1095391
1733,13/07/2021,1713,3,1420,313,293,29/06/2021,"Tignanello, Toscana",Tuscany,2004,20/07/2021,10953912004,1095391
6400,19/07/2021,7569,55,6188,212,1381,16/07/2021,"Chateau Margaux Premier Cru Classe, Margaux",Bordeaux,2010,20/07/2021,10127812010,1012781
588,02/08/2021,625,48,520,68,105,17/06/2021,"Chateau Batailley 5eme Cru Classe, Pauillac",Bordeaux,2005,03/08/2021,10063222005,1006322
990,19/07/2021,1124,16,990,0,134,16/06/2021,"Chateau Calon Segur 3eme Cru Classe, Saint-Estephe",Bordeaux,2010,20/07/2021,10074752010,1007475
2730,09/08/2021,2956,95,2458,272,498,02/08/2021,"Chateau Angelus Premier Grand Cru Classe A, Saint-Emilion Grand Cru",Bordeaux,2017,11/08/2021,10060452017,1006045
750,19/07/2021,893,29,790,-40,103,01/06/2020,"Chateau Calon Segur 3eme Cru Classe, Saint-Estephe",Bordeaux,2011,20/07/2021,10074752011,1007475
1180,19/07/2021,1378,3,1072,108,306,20/01/2021,"Tignanello, Toscana",Tuscany,2009,20/07/2021,10953912009,1095391
1260,19/07/2021,1628,3,1170,90,458,24/06/2021,"Tignanello, Toscana",Tuscany,2010,20/07/2021,10953912010,1095391
3758,19/07/2021,4355,71,3690,68,665,13/04/2021,"Chateau Margaux Premier Cru Classe, Margaux",Bordeaux,2011,20/07/2021,10127812011,1012781
2730,09/08/2021,2954,95,2458,272,496,02/08/2021,"Chateau Angelus Premier Grand Cru Classe A, Saint-Emilion Grand Cru",Bordeaux,2017,10/08/2021,10060452017,1006045
2199,19/07/2021,2229,1,1340,859,889,13/03/2020,"Gaja, Barbaresco",Piedmont,2009,20/07/2021,10996052009,1099605
1050,19/07/2021,1133,7,880,170,253,22/06/2021,"Tignanello, Toscana",Tuscany,2011,20/07/2021,10953912011,1095391
6156,19/07/2021,6292,0,6500,-344,-208,26/05/2021,"Domaine Leflaive, Chevalier-Montrachet Grand Cru",Burgundy,2011,20/07/2021,10734012011,1073401
2730,02/08/2021,2971,99,2458,272,513,02/08/2021,"Chateau Angelus Premier Grand Cru Classe A, Saint-Emilion Grand Cru",Bordeaux,2017,03/08/2021,10060452017,1006045
820,19/07/2021,924,5,735,85,189,09/09/2020,"Chateau Calon Segur 3eme Cru Classe, Saint-Estephe",Bordeaux,2012,20/07/2021,10074752012,1007475
3750,15/07/2021,4275,41,3560,190,715,20/11/2020,"Chateau Margaux Premier Cru Classe, Margaux",Bordeaux,2012,20/07/2021,10127812012,1012781
1800,09/07/2021,2100,1,1440,360,660,04/01/2018,"Gaja, Barbaresco",Piedmont,2010,20/07/2021,10996052010,1099605
13200,19/07/2021,12867,1,12850,350,17,30/11/2020,"Jacques-Frederic Mugnier, Chambolle-Musigny Premier Cru, Les Amoureuses",Burgundy,2011,20/07/2021,10496422011,1049642
420,24/05/2021,607,4,342,78,265,21/08/2020,"Tua Rita, Giusto di Notri, Toscana",Tuscany,2011,20/07/2021,11058072011,1105807
2730,02/08/2021,2962,99,2458,272,504,02/08/2021,"Chateau Angelus Premier Grand Cru Classe A, Saint-Emilion Grand Cru",Bordeaux,2017,03/08/2021,10060452017,1006045
2751,28/07/2021,2982,120,2516,235,466,30/06/2021,"Chateau Angelus Premier Grand Cru Classe A, Saint-Emilion Grand Cru",Bordeaux,2017,31/07/2021,10060452017,1006045
6500,16/07/2021,7496,25,6776,-276,720,10/06/2021,"Chateau Margaux Premier Cru Classe, Margaux",Bordeaux,2005,18/07/2021,10127812005,1012781
2730,28/07/2021,2980,117,2516,214,464,30/06/2021,"Chateau Angelus Premier Grand Cru Classe A, Saint-Emilion Grand Cru",Bordeaux,2017,29/07/2021,10060452017,1006045
465,02/08/2021,458,2,400,65,58,11/05/2021,"Chateau Batailley 5eme Cru Classe, Pauillac",Bordeaux,2006,03/08/2021,10063222006,1006322
3740,19/07/2021,4095,25,3520,220,575,07/04/2021,"Chateau Margaux Premier Cru Classe, Margaux",Bordeaux,2013,20/07/2021,10127812013,1012781
2751,28/07/2021,2962,99,2458,293,504,02/08/2021,"Chateau Angelus Premier Grand Cru Classe A, Saint-Emilion Grand Cru",Bordeaux,2017,05/08/2021,10060452017,1006045
465,02/08/2021,458,2,400,65,58,11/05/2021,"Chateau Batailley 5eme Cru Classe, Pauillac",Bordeaux,2006,03/08/2021,10063222006,1006322
686,16/07/2021,792,19,682,4,110,15/09/2020,"Chateau Calon Segur 3eme Cru Classe, Saint-Estephe",Bordeaux,2013,20/07/2021,10074752013,1007475
600,19/07/2021,600,14,408,192,192,09/04/2019,"Tua Rita, Giusto di Notri, Toscana",Tuscany,2012,20/07/2021,11058072012,1105807
17300,17/06/2021,20592,0,6538,10762,14054,05/07/2016,"Jacques-Frederic Mugnier, Chambolle-Musigny Premier Cru, Les Amoureuses",Burgundy,2012,20/07/2021,10496422012,1049642
960,19/07/2021,1346,11,850,110,496,28/01/2021,"Tignanello, Toscana",Tuscany,2012,20/07/2021,10953912012,1095391
2751,28/07/2021,2950,98,2458,293,492,02/08/2021,"Chateau Angelus Premier Grand Cru Classe A, Saint-Emilion Grand Cru",Bordeaux,2017,06/08/2021,10060452017,1006045
3800,19/07/2021,4351,120,3480,320,871,17/06/2021,"Chateau Margaux Premier Cru Classe, Margaux",Bordeaux,2014,20/07/2021,10127812014,1012781
450,02/08/2021,446,2,332,118,114,06/10/2020,"Chateau Batailley 5eme Cru Classe, Pauillac",Bordeaux,2008,03/08/2021,10063222008,1006322
1550,19/07/2021,1550,1,1300,250,250,27/04/2021,"Gaja, Barbaresco",Piedmont,2012,20/07/2021,10996052012,1099605
1060,19/07/2021,1146,22,860,200,286,08/03/2021,"Tignanello, Toscana",Tuscany,2013,20/07/2021,10953912013,1095391
984,19/07/2021,1048,7,854,130,194,15/07/2021,"Tignanello, Toscana",Tuscany,2014,20/07/2021,10953912014,1095391
9600,08/07/2021,9630,1,8000,1600,1630,30/01/2020,"Domaine Leflaive, Chevalier-Montrachet Grand Cru",Burgundy,2014,20/07/2021,10734012014,1073401
2751,28/07/2021,2953,95,2458,293,495,02/08/2021,"Chateau Angelus Premier Grand Cru Classe A, Saint-Emilion Grand Cru",Bordeaux,2017,07/08/2021,10060452017,1006045
940,19/07/2021,1087,73,822,118,265,28/06/2021,"Chateau Calon Segur 3eme Cru Classe, Saint-Estephe",Bordeaux,2015,20/07/2021,10074752015,1007475
10614,07/07/2021,11685,42,9800,814,1885,11/06/2021,"Chateau Margaux Premier Cru Classe, Margaux",Bordeaux,2015,20/07/2021,10127812015,1012781
14520,19/07/2021,14520,1,12000,2520,2520,28/05/2020,"Jacques-Frederic Mugnier, Chambolle-Musigny Premier Cru, Les Amoureuses",Burgundy,2014,20/07/2021,10496422014,1049642
480,16/07/2021,536,18,388,92,148,29/09/2020,"Tua Rita, Giusto di Notri, Toscana",Tuscany,2015,20/07/2021,11058072015,1105807
5500,19/07/2021,5870,130,5500,0,370,06/07/2021,"Chateau Margaux Premier Cru Classe, Margaux",Bordeaux,2016,20/07/2021,10127812016,1012781
2761,26/07/2021,2982,119,2516,245,466,30/06/2021,"Chateau Angelus Premier Grand Cru Classe A, Saint-Emilion Grand Cru",Bordeaux,2017,27/07/2021,10060452017,1006045
500,02/08/2021,520,7,450,50,70,25/05/2021,"Chateau Batailley 5eme Cru Classe, Pauillac",Bordeaux,2009,03/08/2021,10063222009,1006322
1240,19/07/2021,1354,58,1220,20,134,14/07/2021,"Tignanello, Toscana",Tuscany,2016,20/07/2021,10953912016,1095391
1500,19/07/2021,1700,45,1510,-10,190,18/07/2021,"Gaja, Barbaresco",Piedmont,2016,20/07/2021,10996052016,1099605
2761,26/07/2021,2984,116,2516,245,468,30/06/2021,"Chateau Angelus Premier Grand Cru Classe A, Saint-Emilion Grand Cru",Bordeaux,2017,28/07/2021,10060452017,1006045
780,19/07/2021,938,74,740,40,198,21/05/2021,"Chateau Calon Segur 3eme Cru Classe, Saint-Estephe",Bordeaux,2017,20/07/2021,10074752017,1007475
500,02/08/2021,520,7,450,50,70,25/05/2021,"Chateau Batailley 5eme Cru Classe, Pauillac",Bordeaux,2009,03/08/2021,10063222009,1006322
3800,19/07/2021,4632,188,3950,-150,682,30/06/2021,"Chateau Margaux Premier Cru Classe, Margaux",Bordeaux,2017,20/07/2021,10127812017,1012781
1350,19/07/2021,1483,68,1260,90,223,18/02/2021,"Gaja, Barbaresco",Piedmont,2015,20/07/2021,10996052015,1099605
460,19/07/2021,498,179,420,40,78,28/05/2021,"Tua Rita, Giusto di Notri, Toscana",Tuscany,2016,20/07/2021,11058072016,1105807
8000,19/07/2021,8693,3,6974,1026,1719,14/03/2021,"Domaine Leflaive, Chevalier-Montrachet Grand Cru",Burgundy,2017,20/07/2021,10734012017,1073401
2761,22/07/2021,2983,119,2516,245,467,30/06/2021,"Chateau Angelus Premier Grand Cru Classe A, Saint-Emilion Grand Cru",Bordeaux,2017,23/07/2021,10060452017,1006045
5415,08/07/2021,5922,65,5254,161,668,26/05/2021,"Chateau Margaux Premier Cru Classe, Margaux",Bordeaux,2018,20/07/2021,10127812018,1012781
1080,19/07/2021,1222,52,1058,22,164,14/07/2021,"Chateau Calon Segur 3eme Cru Classe, Saint-Estephe",Bordeaux,2018,20/07/2021,10074752018,1007475
857,14/07/2021,1010,116,848,9,162,15/07/2021,"Tignanello, Toscana",Tuscany,2017,20/07/2021,10953912017,1095391
487,19/07/2021,540,34,320,167,220,24/03/2021,"Tua Rita, Giusto di Notri, Toscana",Tuscany,2017,20/07/2021,11058072017,1105807
8000,19/07/2021,8358,3,7330,670,1028,02/06/2021,"Domaine Leflaive, Chevalier-Montrachet Grand Cru",Burgundy,2018,20/07/2021,10734012018,1073401
1000,19/07/2021,1123,73,910,90,213,14/07/2021,"Tignanello, Toscana",Tuscany,2018,20/07/2021,10953912018,1095391
2761,22/07/2021,2982,118,2516,245,466,30/06/2021,"Chateau Angelus Premier Grand Cru Classe A, Saint-Emilion Grand Cru",Bordeaux,2017,24/07/2021,10060452017,1006045
525,02/08/2021,594,399,494,31,100,20/04/2021,"Chateau Batailley 5eme Cru Classe, Pauillac",Bordeaux,2010,03/08/2021,10063222010,1006322
5290,19/07/2021,4923,10,4160,1130,763,19/03/2021,"Chateau Margaux Premier Cru Classe, Margaux",Bordeaux,2019,20/07/2021,10127812019,1012781
1408,08/07/2021,1616,82,1398,10,218,01/07/2021,"Gaja, Barbaresco",Piedmont,2017,20/07/2021,10996052017,1099605
1624,19/07/2021,1709,23,1572,52,137,19/07/2021,"Gaja, Barbaresco",Piedmont,2018,20/07/2021,10996052018,1099605
960,19/07/2021,1346,11,850,110,496,28/01/2021,"Tignanello, Toscana",Tuscany,2012,20/07/2021,10953912012,1095391
2761,19/07/2021,2973,131,2516,245,457,30/06/2021,"Chateau Angelus Premier Grand Cru Classe A, Saint-Emilion Grand Cru",Bordeaux,2017,20/07/2021,10060452017,1006045
3800,19/07/2021,4351,120,3480,320,871,17/06/2021,"Chateau Margaux Premier Cru Classe, Margaux",Bordeaux,2014,20/07/2021,10127812014,1012781
1060,19/07/2021,1146,22,860,200,286,08/03/2021,"Tignanello, Toscana",Tuscany,2013,20/07/2021,10953912013,1095391
984,19/07/2021,1048,7,854,130,194,15/07/2021,"Tignanello, Toscana",Tuscany,2014,20/07/2021,10953912014,1095391
9600,08/07/2021,9630,1,8000,1600,1630,30/01/2020,"Domaine Leflaive, Chevalier-Montrachet Grand Cru",Burgundy,2014,20/07/2021,10734012014,1073401
940,19/07/2021,1087,73,822,118,265,28/06/2021,"Chateau Calon Segur 3eme Cru Classe, Saint-Estephe",Bordeaux,2015,20/07/2021,10074752015,1007475
10614,07/07/2021,11685,42,9800,814,1885,11/06/2021,"Chateau Margaux Premier Cru Classe, Margaux",Bordeaux,2015,20/07/2021,10127812015,1012781
2761,19/07/2021,2986,119,2516,245,470,30/06/2021,"Chateau Angelus Premier Grand Cru Classe A, Saint-Emilion Grand Cru",Bordeaux,2017,21/07/2021,10060452017,1006045
10800,06/08/2021,10860,2,8000,2800,2860,30/01/2020,"Domaine Leflaive, Chevalier-Montrachet Grand Cru",Burgundy,2014,07/08/2021,10734012014,1073401
8200,20/07/2021,9082,15,8100,100,982,21/06/2021,"Chateau Margaux Premier Cru Classe, Margaux",Bordeaux,2000,21/07/2021,10127812000,1012781
2761,16/07/2021,3023,139,2516,245,507,30/06/2021,"Chateau Angelus Premier Grand Cru Classe A, Saint-Emilion Grand Cru",Bordeaux,2017,17/07/2021,10060452017,1006045
4450,20/07/2021,4750,24,4400,50,350,29/09/2020,"Chateau Margaux Premier Cru Classe, Margaux",Bordeaux,2001,21/07/2021,10127812001,1012781
3939,20/07/2021,4417,22,3684,255,733,10/06/2020,"Chateau Margaux Premier Cru Classe, Margaux",Bordeaux,2002,21/07/2021,10127812002,1012781
3826,20/07/2021,4585,47,4116,-290,469,25/02/2021,"Chateau Margaux Premier Cru Classe, Margaux",Bordeaux,2004,21/07/2021,10127812004,1012781
4850,16/07/2021,6002,22,4650,200,1352,21/06/2021,"Chateau Margaux Premier Cru Classe, Margaux",Bordeaux,2003,21/07/2021,10127812003,1012781
2761,15/07/2021,3023,139,2516,245,507,30/06/2021,"Chateau Angelus Premier Grand Cru Classe A, Saint-Emilion Grand Cru",Bordeaux,2017,16/07/2021,10060452017,1006045
907,19/07/2021,952,22,805,102,147,20/11/2019,"Chateau Calon Segur 3eme Cru Classe, Saint-Estephe",Bordeaux,2001,21/07/2021,10074752001,1007475
525,02/08/2021,595,397,494,31,101,20/04/2021,"Chateau Batailley 5eme Cru Classe, Pauillac",Bordeaux,2010,03/08/2021,10063222010,1006322
2761,12/07/2021,3006,136,2516,245,490,30/06/2021,"Chateau Angelus Premier Grand Cru Classe A, Saint-Emilion Grand Cru",Bordeaux,2017,13/07/2021,10060452017,1006045
6500,20/07/2021,7503,24,6776,-276,727,10/06/2021,"Chateau Margaux Premier Cru Classe, Margaux",Bordeaux,2005,21/07/2021,10127812005,1012781
525,02/08/2021,595,397,494,31,101,20/04/2021,"Chateau Batailley 5eme Cru Classe, Pauillac",Bordeaux,2010,04/08/2021,10063222010,1006322
6850,20/07/2021,6847,1,6405,445,442,19/07/2019,"Domaine Leflaive, Chevalier-Montrachet Grand Cru",Burgundy,2005,21/07/2021,10734012005,1073401
895,20/07/2021,928,41,863,32,65,10/05/2021,"Chateau Calon Segur 3eme Cru Classe, Saint-Estephe",Bordeaux,2006,21/07/2021,10074752006,1007475
3900,20/07/2021,4683,79,3822,78,861,20/06/2021,"Chateau Margaux Premier Cru Classe, Margaux",Bordeaux,2006,21/07/2021,10127812006,1012781
3750,20/07/2021,4258,81,3525,225,733,18/06/2021,"Chateau Margaux Premier Cru Classe, Margaux",Bordeaux,2007,21/07/2021,10127812007,1012781
880,20/07/2021,980,7,725,155,255,13/04/2021,"Chateau Calon Segur 3eme Cru Classe, Saint-Estephe",Bordeaux,2007,21/07/2021,10074752007,1007475
2761,08/07/2021,3009,131,2516,245,493,30/06/2021,"Chateau Angelus Premier Grand Cru Classe A, Saint-Emilion Grand Cru",Bordeaux,2017,09/07/2021,10060452017,1006045
8400,20/07/2021,8400,1,5700,2700,2700,10/09/2020,"Domaine Leflaive, Chevalier-Montrachet Grand Cru",Burgundy,2007,21/07/2021,10734012007,1073401
3900,20/07/2021,4355,72,3870,30,485,10/07/2021,"Chateau Margaux Premier Cru Classe, Margaux",Bordeaux,2008,21/07/2021,10127812008,1012781
895,20/07/2021,981,10,781,114,200,16/11/2020,"Chateau Calon Segur 3eme Cru Classe, Saint-Estephe",Bordeaux,2008,21/07/2021,10074752008,1007475
9000,20/07/2021,8799,1,5400,3600,3399,13/08/2020,"Domaine Leflaive, Chevalier-Montrachet Grand Cru",Burgundy,2008,21/07/2021,10734012008,1073401
2761,05/07/2021,3030,134,2516,245,514,30/06/2021,"Chateau Angelus Premier Grand Cru Classe A, Saint-Emilion Grand Cru",Bordeaux,2017,06/07/2021,10060452017,1006045
1850,20/07/2021,1812,1,1180,670,632,10/03/2017,"Gaja, Barbaresco",Piedmont,2005,21/07/2021,10996052005,1099605
2500,19/07/2021,2640,3,2400,100,240,18/07/2021,"Gaja, Barbaresco",Piedmont,2001,21/07/2021,10996052001,1099605
2386,20/07/2021,2397,3,2190,196,207,01/05/2021,"Gaja, Barbaresco",Piedmont,2004,21/07/2021,10996052004,1099605
520,20/07/2021,563,3,460,60,103,05/05/2020,"Tua Rita, Giusto di Notri, Toscana",Tuscany,2008,21/07/2021,11058072008,1105807
660,20/07/2021,727,5,390,270,337,18/08/2017,"Tua Rita, Giusto di Notri, Toscana",Tuscany,2006,21/07/2021,11058072006,1105807
1733,20/07/2021,1713,3,1420,313,293,29/06/2021,"Tignanello, Toscana",Tuscany,2004,21/07/2021,10953912004,1095391
1408,20/07/2021,1754,2,882,526,872,26/04/2019,"Tignanello, Toscana",Tuscany,2003,21/07/2021,10953912003,1095391
6400,20/07/2021,7568,55,6188,212,1380,16/07/2021,"Chateau Margaux Premier Cru Classe, Margaux",Bordeaux,2010,21/07/2021,10127812010,1012781
525,02/08/2021,594,399,494,31,100,20/04/2021,"Chateau Batailley 5eme Cru Classe, Pauillac",Bordeaux,2010,03/08/2021,10063222010,1006322
990,20/07/2021,1124,16,990,0,134,16/06/2021,"Chateau Calon Segur 3eme Cru Classe, Saint-Estephe",Bordeaux,2010,21/07/2021,10074752010,1007475
2761,05/07/2021,3023,134,2516,245,507,30/06/2021,"Chateau Angelus Premier Grand Cru Classe A, Saint-Emilion Grand Cru",Bordeaux,2017,07/07/2021,10060452017,1006045
750,20/07/2021,893,29,790,-40,103,01/06/2020,"Chateau Calon Segur 3eme Cru Classe, Saint-Estephe",Bordeaux,2011,21/07/2021,10074752011,1007475
1260,20/07/2021,1628,3,1170,90,458,24/06/2021,"Tignanello, Toscana",Tuscany,2010,21/07/2021,10953912010,1095391
3758,20/07/2021,4355,71,3690,68,665,13/04/2021,"Chateau Margaux Premier Cru Classe, Margaux",Bordeaux,2011,21/07/2021,10127812011,1012781
2761,01/07/2021,3029,134,2516,245,513,30/06/2021,"Chateau Angelus Premier Grand Cru Classe A, Saint-Emilion Grand Cru",Bordeaux,2017,05/07/2021,10060452017,1006045
2761,01/07/2021,3026,155,2516,245,510,30/06/2021,"Chateau Angelus Premier Grand Cru Classe A, Saint-Emilion Grand Cru",Bordeaux,2017,02/07/2021,10060452017,1006045
400,02/08/2021,409,7,408,-8,1,14/07/2021,"Chateau Batailley 5eme Cru Classe, Pauillac",Bordeaux,2012,03/08/2021,10063222012,1006322
820,20/07/2021,924,5,735,85,189,09/09/2020,"Chateau Calon Segur 3eme Cru Classe, Saint-Estephe",Bordeaux,2012,21/07/2021,10074752012,1007475
13200,20/07/2021,12867,1,12850,350,17,30/11/2020,"Jacques-Frederic Mugnier, Chambolle-Musigny Premier Cru, Les Amoureuses",Burgundy,2011,21/07/2021,10496422011,1049642
440,20/07/2021,589,5,342,98,247,21/08/2020,"Tua Rita, Giusto di Notri, Toscana",Tuscany,2011,21/07/2021,11058072011,1105807
6400,20/07/2021,6400,1,4500,1900,1900,08/04/2015,"Domaine Leflaive, Chevalier-Montrachet Grand Cru",Burgundy,2012,21/07/2021,10734012012,1073401
3740,20/07/2021,4095,25,3520,220,575,07/04/2021,"Chateau Margaux Premier Cru Classe, Margaux",Bordeaux,2013,21/07/2021,10127812013,1012781
2628,28/06/2021,3014,155,2400,228,614,26/06/2021,"Chateau Angelus Premier Grand Cru Classe A, Saint-Emilion Grand Cru",Bordeaux,2017,30/06/2021,10060452017,1006045
400,02/08/2021,409,7,408,-8,1,14/07/2021,"Chateau Batailley 5eme Cru Classe, Pauillac",Bordeaux,2012,03/08/2021,10063222012,1006322
1500,20/07/2021,1442,7,1352,148,90,23/09/2020,"Gaja, Barbaresco",Piedmont,2011,21/07/2021,10996052011,1099605
5600,10/05/2021,6815,0,4400,1200,2415,06/11/2017,"Domaine Leflaive, Chevalier-Montrachet Grand Cru",Burgundy,2013,21/07/2021,10734012013,1073401
6282,18/06/2021,10790,1,4000,2282,6790,25/04/2016,"Domaine Denis Mortet, Chambertin Grand Cru",Burgundy,2013,21/07/2021,10490202013,1049020
3800,20/07/2021,4351,120,3480,320,871,17/06/2021,"Chateau Margaux Premier Cru Classe, Margaux",Bordeaux,2014,21/07/2021,10127812014,1012781
320,02/08/2021,320,103,304,16,16,10/01/2021,"Chateau Batailley 5eme Cru Classe, Pauillac",Bordeaux,2013,03/08/2021,10063222013,1006322
1550,20/07/2021,1550,1,1300,250,250,27/04/2021,"Gaja, Barbaresco",Piedmont,2012,21/07/2021,10996052012,1099605
1060,20/07/2021,1140,9,860,200,280,08/03/2021,"Tignanello, Toscana",Tuscany,2013,21/07/2021,10953912013,1095391
984,20/07/2021,1048,7,854,130,194,15/07/2021,"Tignanello, Toscana",Tuscany,2014,21/07/2021,10953912014,1095391
1390,13/07/2021,1522,14,1360,30,162,18/07/2021,"Gaja, Barbaresco",Piedmont,2013,21/07/2021,10996052013,1099605
10800,20/07/2021,10550,1,8000,2800,2550,30/01/2020,"Domaine Leflaive, Chevalier-Montrachet Grand Cru",Burgundy,2014,21/07/2021,10734012014,1073401
940,20/07/2021,1078,79,866,74,212,20/07/2021,"Chateau Calon Segur 3eme Cru Classe, Saint-Estephe",Bordeaux,2015,21/07/2021,10074752015,1007475
10614,07/07/2021,11687,43,9800,814,1887,11/06/2021,"Chateau Margaux Premier Cru Classe, Margaux",Bordeaux,2015,21/07/2021,10127812015,1012781
360,02/08/2021,371,72,360,0,11,14/07/2021,"Chateau Batailley 5eme Cru Classe, Pauillac",Bordeaux,2014,03/08/2021,10063222014,1006322
14520,20/07/2021,14520,1,12000,2520,2520,28/05/2020,"Jacques-Frederic Mugnier, Chambolle-Musigny Premier Cru, Les Amoureuses",Burgundy,2014,21/07/2021,10496422014,1049642
5500,20/07/2021,5870,130,5500,0,370,06/07/2021,"Chateau Margaux Premier Cru Classe, Margaux",Bordeaux,2016,21/07/2021,10127812016,1012781
2628,28/06/2021,3022,150,2400,228,622,26/06/2021,"Chateau Angelus Premier Grand Cru Classe A, Saint-Emilion Grand Cru",Bordeaux,2017,29/06/2021,10060452017,1006045
415,02/08/2021,519,37,364,51,155,12/05/2021,"Chateau Batailley 5eme Cru Classe, Pauillac",Bordeaux,2016,03/08/2021,10063222016,1006322
1240,20/07/2021,1354,58,1220,20,134,14/07/2021,"Tignanello, Toscana",Tuscany,2016,21/07/2021,10953912016,1095391
7906,20/07/2021,7946,1,7124,782,822,15/02/2019,"Domaine Leflaive, Chevalier-Montrachet Grand Cru",Burgundy,2016,21/07/2021,10734012016,1073401
1500,20/07/2021,1674,33,1510,-10,164,18/07/2021,"Gaja, Barbaresco",Piedmont,2016,21/07/2021,10996052016,1099605
2628,28/06/2021,3014,155,2516,112,498,30/06/2021,"Chateau Angelus Premier Grand Cru Classe A, Saint-Emilion Grand Cru",Bordeaux,2017,01/07/2021,10060452017,1006045
780,20/07/2021,938,73,740,40,198,21/05/2021,"Chateau Calon Segur 3eme Cru Classe, Saint-Estephe",Bordeaux,2017,21/07/2021,10074752017,1007475
3800,20/07/2021,4632,188,3950,-150,682,30/06/2021,"Chateau Margaux Premier Cru Classe, Margaux",Bordeaux,2017,21/07/2021,10127812017,1012781
1350,19/07/2021,1479,56,1260,90,219,18/02/2021,"Gaja, Barbaresco",Piedmont,2015,21/07/2021,10996052015,1099605
460,20/07/2021,498,179,420,40,78,28/05/2021,"Tua Rita, Giusto di Notri, Toscana",Tuscany,2016,21/07/2021,11058072016,1105807
8556,14/07/2021,8693,3,6974,1582,1719,14/03/2021,"Domaine Leflaive, Chevalier-Montrachet Grand Cru",Burgundy,2017,21/07/2021,10734012017,1073401
15600,14/07/2021,15175,4,13000,2600,2175,29/04/2021,"Jacques-Frederic Mugnier, Chambolle-Musigny Premier Cru, Les Amoureuses",Burgundy,2017,21/07/2021,10496422017,1049642
2761,24/06/2021,3022,156,2400,361,622,26/06/2021,"Chateau Angelus Premier Grand Cru Classe A, Saint-Emilion Grand Cru",Bordeaux,2017,27/06/2021,10060452017,1006045
1080,20/07/2021,1244,40,1058,22,186,14/07/2021,"Chateau Calon Segur 3eme Cru Classe, Saint-Estephe",Bordeaux,2018,21/07/2021,10074752018,1007475
857,14/07/2021,1010,116,860,-3,150,20/07/2021,"Tignanello, Toscana",Tuscany,2017,21/07/2021,10953912017,1095391
8000,20/07/2021,8594,4,7330,670,1264,02/06/2021,"Domaine Leflaive, Chevalier-Montrachet Grand Cru",Burgundy,2018,21/07/2021,10734012018,1073401
1000,20/07/2021,1122,73,910,90,212,14/07/2021,"Tignanello, Toscana",Tuscany,2018,21/07/2021,10953912018,1095391
415,02/08/2021,538,28,364,51,174,12/05/2021,"Chateau Batailley 5eme Cru Classe, Pauillac",Bordeaux,2016,03/08/2021,10063222016,1006322
1408,08/07/2021,1624,75,1398,10,226,01/07/2021,"Gaja, Barbaresco",Piedmont,2017,21/07/2021,10996052017,1099605
430,20/07/2021,457,102,380,50,77,25/03/2021,"Tua Rita, Giusto di Notri, Toscana",Tuscany,2018,21/07/2021,11058072018,1105807
1624,20/07/2021,1709,23,1572,52,137,19/07/2021,"Gaja, Barbaresco",Piedmont,2018,21/07/2021,10996052018,1099605
750,21/07/2021,892,29,790,-40,102,01/06/2020,"Chateau Calon Segur 3eme Cru Classe, Saint-Estephe",Bordeaux,2011,22/07/2021,10074752011,1007475
1755,31/05/2021,2916,0,1330,425,1586,25/10/2019,"Gaja, Barbaresco",Piedmont,2008,22/07/2021,10996052008,1099605
8240,13/07/2021,9256,1,5960,2280,3296,01/08/2017,"Domaine Leflaive, Chevalier-Montrachet Grand Cru",Burgundy,2010,22/07/2021,10734012010,1073401
1180,21/07/2021,1378,3,1140,40,238,21/07/2021,"Tignanello, Toscana",Tuscany,2009,22/07/2021,10953912009,1095391
1260,21/07/2021,1628,3,1170,90,458,24/06/2021,"Tignanello, Toscana",Tuscany,2010,22/07/2021,10953912010,1095391
3758,21/07/2021,4355,71,3690,68,665,13/04/2021,"Chateau Margaux Premier Cru Classe, Margaux",Bordeaux,2011,22/07/2021,10127812011,1012781
2761,24/06/2021,3023,150,2400,361,623,26/06/2021,"Chateau Angelus Premier Grand Cru Classe A, Saint-Emilion Grand Cru",Bordeaux,2017,28/06/2021,10060452017,1006045
2199,21/07/2021,2229,1,1340,859,889,13/03/2020,"Gaja, Barbaresco",Piedmont,2009,22/07/2021,10996052009,1099605
1050,21/07/2021,1133,7,880,170,253,22/06/2021,"Tignanello, Toscana",Tuscany,2011,22/07/2021,10953912011,1095391
2761,24/06/2021,3022,156,2500,261,522,07/05/2021,"Chateau Angelus Premier Grand Cru Classe A, Saint-Emilion Grand Cru",Bordeaux,2017,25/06/2021,10060452017,1006045
820,21/07/2021,924,5,735,85,189,09/09/2020,"Chateau Calon Segur 3eme Cru Classe, Saint-Estephe",Bordeaux,2012,22/07/2021,10074752012,1007475
13200,21/07/2021,12867,1,12850,350,17,30/11/2020,"Jacques-Frederic Mugnier, Chambolle-Musigny Premier Cru, Les Amoureuses",Burgundy,2011,22/07/2021,10496422011,1049642
3740,21/07/2021,4120,25,3520,220,600,07/04/2021,"Chateau Margaux Premier Cru Classe, Margaux",Bordeaux,2013,22/07/2021,10127812013,1012781
2761,21/06/2021,3022,156,2500,261,522,07/05/2021,"Chateau Angelus Premier Grand Cru Classe A, Saint-Emilion Grand Cru",Bordeaux,2017,23/06/2021,10060452017,1006045
800,21/07/2021,792,19,682,118,110,15/09/2020,"Chateau Calon Segur 3eme Cru Classe, Saint-Estephe",Bordeaux,2013,22/07/2021,10074752013,1007475
960,21/07/2021,1346,11,850,110,496,28/01/2021,"Tignanello, Toscana",Tuscany,2012,22/07/2021,10953912012,1095391
2761,21/06/2021,3025,140,2500,261,525,07/05/2021,"Chateau Angelus Premier Grand Cru Classe A, Saint-Emilion Grand Cru",Bordeaux,2017,22/06/2021,10060452017,1006045
3800,21/07/2021,4351,120,3480,320,871,17/06/2021,"Chateau Margaux Premier Cru Classe, Margaux",Bordeaux,2014,22/07/2021,10127812014,1012781
480,03/08/2021,480,2,465,15,15,04/05/2020,"Chateau Batailley 5eme Cru Classe, Pauillac",Bordeaux,2001,03/08/2021,10063222001,1006322
1550,21/07/2021,1550,1,1300,250,250,27/04/2021,"Gaja, Barbaresco",Piedmont,2012,22/07/2021,10996052012,1099605
1060,21/07/2021,1140,9,860,200,280,08/03/2021,"Tignanello, Toscana",Tuscany,2013,22/07/2021,10953912013,1095391
984,21/07/2021,1048,7,854,130,194,15/07/2021,"Tignanello, Toscana",Tuscany,2014,22/07/2021,10953912014,1095391
1390,13/07/2021,1524,14,1360,30,164,18/07/2021,"Gaja, Barbaresco",Piedmont,2013,22/07/2021,10996052013,1099605
1573,21/07/2021,1579,15,1300,273,279,10/07/2021,"Gaja, Barbaresco",Piedmont,2014,22/07/2021,10996052014,1099605
2751,07/06/2021,3026,167,2500,251,526,07/05/2021,"Chateau Angelus Premier Grand Cru Classe A, Saint-Emilion Grand Cru",Bordeaux,2017,09/06/2021,10060452017,1006045
940,21/07/2021,1078,79,866,74,212,20/07/2021,"Chateau Calon Segur 3eme Cru Classe, Saint-Estephe",Bordeaux,2015,22/07/2021,10074752015,1007475
10620,21/07/2021,11692,42,9800,820,1892,11/06/2021,"Chateau Margaux Premier Cru Classe, Margaux",Bordeaux,2015,22/07/2021,10127812015,1012781
14520,21/07/2021,14520,1,12000,2520,2520,28/05/2020,"Jacques-Frederic Mugnier, Chambolle-Musigny Premier Cru, Les Amoureuses",Burgundy,2014,22/07/2021,10496422014,1049642
1130,21/07/2021,1169,13,1012,118,157,02/07/2021,"Tignanello, Toscana",Tuscany,2015,22/07/2021,10953912015,1095391
5500,21/07/2021,5870,130,5500,0,370,06/07/2021,"Chateau Margaux Premier Cru Classe, Margaux",Bordeaux,2016,22/07/2021,10127812016,1012781
2751,07/06/2021,3007,142,2500,251,507,07/05/2021,"Chateau Angelus Premier Grand Cru Classe A, Saint-Emilion Grand Cru",Bordeaux,2017,21/06/2021,10060452017,1006045
1100,21/07/2021,1219,77,1036,64,183,27/05/2021,"Chateau Calon Segur 3eme Cru Classe, Saint-Estephe",Bordeaux,2016,22/07/2021,10074752016,1007475
450,03/08/2021,532,2,300,150,232,15/12/2019,"Chateau Batailley 5eme Cru Classe, Pauillac",Bordeaux,2004,03/08/2021,10063222004,1006322
1240,21/07/2021,1355,57,1220,20,135,14/07/2021,"Tignanello, Toscana",Tuscany,2016,22/07/2021,10953912016,1095391
1500,16/07/2021,1674,33,1510,-10,164,18/07/2021,"Gaja, Barbaresco",Piedmont,2016,22/07/2021,10996052016,1099605
780,21/07/2021,938,73,740,40,198,21/05/2021,"Chateau Calon Segur 3eme Cru Classe, Saint-Estephe",Bordeaux,2017,22/07/2021,10074752017,1007475
3800,21/07/2021,4632,188,3950,-150,682,30/06/2021,"Chateau Margaux Premier Cru Classe, Margaux",Bordeaux,2017,22/07/2021,10127812017,1012781
1350,21/07/2021,1480,55,1260,90,220,18/02/2021,"Gaja, Barbaresco",Piedmont,2015,22/07/2021,10996052015,1099605
460,21/07/2021,498,179,420,40,78,28/05/2021,"Tua Rita, Giusto di Notri, Toscana",Tuscany,2016,22/07/2021,11058072016,1105807
8556,21/07/2021,8693,3,6974,1582,1719,14/03/2021,"Domaine Leflaive, Chevalier-Montrachet Grand Cru",Burgundy,2017,22/07/2021,10734012017,1073401
15600,21/07/2021,15175,4,13000,2600,2175,29/04/2021,"Jacques-Frederic Mugnier, Chambolle-Musigny Premier Cru, Les Amoureuses",Burgundy,2017,22/07/2021,10496422017,1049642
2751,07/06/2021,3017,151,2500,251,517,07/05/2021,"Chateau Angelus Premier Grand Cru Classe A, Saint-Emilion Grand Cru",Bordeaux,2017,16/06/2021,10060452017,1006045
5415,08/07/2021,5844,107,5254,161,590,26/05/2021,"Chateau Margaux Premier Cru Classe, Margaux",Bordeaux,2018,22/07/2021,10127812018,1012781
1080,21/07/2021,1242,41,1058,22,184,14/07/2021,"Chateau Calon Segur 3eme Cru Classe, Saint-Estephe",Bordeaux,2018,22/07/2021,10074752018,1007475
866,21/07/2021,1010,116,886,-20,124,21/07/2021,"Tignanello, Toscana",Tuscany,2017,22/07/2021,10953912017,1095391
8000,21/07/2021,8594,4,7330,670,1264,02/06/2021,"Domaine Leflaive, Chevalier-Montrachet Grand Cru",Burgundy,2018,22/07/2021,10734012018,1073401
990,21/07/2021,1119,75,910,80,209,14/07/2021,"Tignanello, Toscana",Tuscany,2018,22/07/2021,10953912018,1095391
320,03/08/2021,320,103,304,16,16,10/01/2021,"Chateau Batailley 5eme Cru Classe, Pauillac",Bordeaux,2013,03/08/2021,10063222013,1006322
840,13/07/2021,1037,36,842,-2,195,22/08/2020,"Chateau Calon Segur 3eme Cru Classe, Saint-Estephe",Bordeaux,2019,22/07/2021,10074752019,1007475
5290,19/07/2021,4957,10,4160,1130,797,19/03/2021,"Chateau Margaux Premier Cru Classe, Margaux",Bordeaux,2019,22/07/2021,10127812019,1012781
1624,21/07/2021,1713,22,1580,44,133,21/07/2021,"Gaja, Barbaresco",Piedmont,2018,22/07/2021,10996052018,1099605
1040,21/07/2021,1383,66,940,100,443,18/03/2021,"Chateau Calon Segur 3eme Cru Classe, Saint-Estephe",Bordeaux,2000,22/07/2021,10074752000,1007475
10620,06/08/2021,11970,49,9800,820,2170,11/06/2021,"Chateau Margaux Premier Cru Classe, Margaux",Bordeaux,2015,07/08/2021,10127812015,1012781
360,03/08/2021,371,72,360,0,11,14/07/2021,"Chateau Batailley 5eme Cru Classe, Pauillac",Bordeaux,2014,03/08/2021,10063222014,1006322
3750,05/08/2021,4282,45,3650,100,632,27/07/2021,"Chateau Margaux Premier Cru Classe, Margaux",Bordeaux,2012,08/08/2021,10127812012,1012781
6500,06/08/2021,7518,22,6400,100,1118,22/07/2021,"Chateau Margaux Premier Cru Classe, Margaux",Bordeaux,2005,08/08/2021,10127812005,1012781
6400,06/08/2021,7608,61,6188,212,1420,16/07/2021,"Chateau Margaux Premier Cru Classe, Margaux",Bordeaux,2010,08/08/2021,10127812010,1012781
6930,06/08/2021,7722,59,7086,-156,636,11/06/2021,"Chateau Margaux Premier Cru Classe, Margaux",Bordeaux,2009,08/08/2021,10127812009,1012781
3935,06/08/2021,4659,40,4116,-181,543,25/02/2021,"Chateau Margaux Premier Cru Classe, Margaux",Bordeaux,2004,08/08/2021,10127812004,1012781
996,06/08/2021,1282,38,1026,-30,256,24/06/2021,"Chateau Calon Segur 3eme Cru Classe, Saint-Estephe",Bordeaux,2009,08/08/2021,10074752009,1007475
870,26/07/2021,966,5,705,165,261,01/02/2021,"Chateau Calon Segur 3eme Cru Classe, Saint-Estephe",Bordeaux,2002,27/07/2021,10074752002,1007475
8200,26/07/2021,9028,16,8200,0,828,26/07/2021,"Chateau Margaux Premier Cru Classe, Margaux",Bordeaux,2000,27/07/2021,10127812000,1012781
2751,07/06/2021,3027,167,2500,251,527,07/05/2021,"Chateau Angelus Premier Grand Cru Classe A, Saint-Emilion Grand Cru",Bordeaux,2017,08/06/2021,10060452017,1006045
900,26/07/2021,1115,23,800,100,315,21/11/2019,"Chateau Calon Segur 3eme Cru Classe, Saint-Estephe",Bordeaux,2003,27/07/2021,10074752003,1007475
4450,26/07/2021,4750,24,4400,50,350,29/09/2020,"Chateau Margaux Premier Cru Classe, Margaux",Bordeaux,2001,27/07/2021,10127812001,1012781
3900,26/07/2021,4417,22,3684,216,733,10/06/2020,"Chateau Margaux Premier Cru Classe, Margaux",Bordeaux,2002,27/07/2021,10127812002,1012781
3840,26/07/2021,4582,49,4116,-276,466,25/02/2021,"Chateau Margaux Premier Cru Classe, Margaux",Bordeaux,2004,27/07/2021,10127812004,1012781
5040,26/07/2021,6002,22,4650,390,1352,21/06/2021,"Chateau Margaux Premier Cru Classe, Margaux",Bordeaux,2003,27/07/2021,10127812003,1012781
840,26/07/2021,1059,19,745,95,314,16/11/2020,"Chateau Calon Segur 3eme Cru Classe, Saint-Estephe",Bordeaux,2004,27/07/2021,10074752004,1007475
2751,07/06/2021,3015,151,2500,251,515,07/05/2021,"Chateau Angelus Premier Grand Cru Classe A, Saint-Emilion Grand Cru",Bordeaux,2017,11/06/2021,10060452017,1006045
907,26/07/2021,952,22,805,102,147,20/11/2019,"Chateau Calon Segur 3eme Cru Classe, Saint-Estephe",Bordeaux,2001,27/07/2021,10074752001,1007475
685,04/08/2021,685,1,470,215,215,29/03/2018,"Chateau Batailley 5eme Cru Classe, Pauillac",Bordeaux,2000,05/08/2021,10063222000,1006322
2751,07/06/2021,3017,148,2500,251,517,07/05/2021,"Chateau Angelus Premier Grand Cru Classe A, Saint-Emilion Grand Cru",Bordeaux,2017,19/06/2021,10060452017,1006045
685,04/08/2021,685,1,470,215,215,29/03/2018,"Chateau Batailley 5eme Cru Classe, Pauillac",Bordeaux,2000,05/08/2021,10063222000,1006322
6500,26/07/2021,7517,25,6400,100,1117,22/07/2021,"Chateau Margaux Premier Cru Classe, Margaux",Bordeaux,2005,27/07/2021,10127812005,1012781
2751,25/05/2021,3006,163,2500,251,506,07/05/2021,"Chateau Angelus Premier Grand Cru Classe A, Saint-Emilion Grand Cru",Bordeaux,2017,27/05/2021,10060452017,1006045
990,26/07/2021,1162,64,1029,-39,133,21/07/2021,"Chateau Calon Segur 3eme Cru Classe, Saint-Estephe",Bordeaux,2005,27/07/2021,10074752005,1007475
3900,26/07/2021,4672,89,3822,78,850,20/06/2021,"Chateau Margaux Premier Cru Classe, Margaux",Bordeaux,2006,27/07/2021,10127812006,1012781
480,04/08/2021,480,2,465,15,15,04/05/2020,"Chateau Batailley 5eme Cru Classe, Pauillac",Bordeaux,2001,05/08/2021,10063222001,1006322
3750,26/07/2021,4268,89,3525,225,743,18/06/2021,"Chateau Margaux Premier Cru Classe, Margaux",Bordeaux,2007,27/07/2021,10127812007,1012781
880,26/07/2021,980,7,725,155,255,13/04/2021,"Chateau Calon Segur 3eme Cru Classe, Saint-Estephe",Bordeaux,2007,27/07/2021,10074752007,1007475
2751,25/05/2021,3026,167,2500,251,526,07/05/2021,"Chateau Angelus Premier Grand Cru Classe A, Saint-Emilion Grand Cru",Bordeaux,2017,01/06/2021,10060452017,1006045
2751,25/05/2021,3005,165,2500,251,505,07/05/2021,"Chateau Angelus Premier Grand Cru Classe A, Saint-Emilion Grand Cru",Bordeaux,2017,26/05/2021,10060452017,1006045
3900,26/07/2021,4374,84,3780,120,594,23/07/2021,"Chateau Margaux Premier Cru Classe, Margaux",Bordeaux,2008,27/07/2021,10127812008,1012781
895,26/07/2021,953,8,781,114,172,16/11/2020,"Chateau Calon Segur 3eme Cru Classe, Saint-Estephe",Bordeaux,2008,27/07/2021,10074752008,1007475
6930,26/07/2021,7716,60,7086,-156,630,11/06/2021,"Chateau Margaux Premier Cru Classe, Margaux",Bordeaux,2009,27/07/2021,10127812009,1012781
996,26/07/2021,1218,54,1026,-30,192,24/06/2021,"Chateau Calon Segur 3eme Cru Classe, Saint-Estephe",Bordeaux,2009,27/07/2021,10074752009,1007475
450,04/08/2021,532,2,300,150,232,15/12/2019,"Chateau Batailley 5eme Cru Classe, Pauillac",Bordeaux,2004,05/08/2021,10063222004,1006322
2751,25/05/2021,3026,168,2500,251,526,07/05/2021,"Chateau Angelus Premier Grand Cru Classe A, Saint-Emilion Grand Cru",Bordeaux,2017,04/06/2021,10060452017,1006045
2386,26/07/2021,2397,3,2190,196,207,01/05/2021,"Gaja, Barbaresco",Piedmont,2004,27/07/2021,10996052004,1099605
1700,26/07/2021,1657,4,1378,322,279,29/07/2020,"Tignanello, Toscana",Tuscany,2001,27/07/2021,10953912001,1095391
1299,06/07/2021,1523,5,1010,289,513,18/12/2020,"Tignanello, Toscana",Tuscany,2008,27/07/2021,10953912008,1095391
6400,26/07/2021,7552,56,6188,212,1364,16/07/2021,"Chateau Margaux Premier Cru Classe, Margaux",Bordeaux,2010,27/07/2021,10127812010,1012781
588,04/08/2021,625,46,520,68,105,17/06/2021,"Chateau Batailley 5eme Cru Classe, Pauillac",Bordeaux,2005,06/08/2021,10063222005,1006322
990,26/07/2021,1117,17,990,0,127,16/06/2021,"Chateau Calon Segur 3eme Cru Classe, Saint-Estephe",Bordeaux,2010,27/07/2021,10074752010,1007475
750,26/07/2021,892,29,790,-40,102,01/06/2020,"Chateau Calon Segur 3eme Cru Classe, Saint-Estephe",Bordeaux,2011,27/07/2021,10074752011,1007475
1180,26/07/2021,1353,4,1140,40,213,21/07/2021,"Tignanello, Toscana",Tuscany,2009,27/07/2021,10953912009,1095391
1260,26/07/2021,1602,3,1170,90,432,24/06/2021,"Tignanello, Toscana",Tuscany,2010,27/07/2021,10953912010,1095391
3758,26/07/2021,4367,81,3690,68,677,13/04/2021,"Chateau Margaux Premier Cru Classe, Margaux",Bordeaux,2011,27/07/2021,10127812011,1012781
2751,25/05/2021,3005,164,2500,251,505,07/05/2021,"Chateau Angelus Premier Grand Cru Classe A, Saint-Emilion Grand Cru",Bordeaux,2017,28/05/2021,10060452017,1006045
1000,26/07/2021,1113,8,880,120,233,22/06/2021,"Tignanello, Toscana",Tuscany,2011,27/07/2021,10953912011,1095391
820,26/07/2021,920,4,735,85,185,09/09/2020,"Chateau Calon Segur 3eme Cru Classe, Saint-Estephe",Bordeaux,2012,27/07/2021,10074752012,1007475
588,04/08/2021,625,48,520,68,105,17/06/2021,"Chateau Batailley 5eme Cru Classe, Pauillac",Bordeaux,2005,05/08/2021,10063222005,1006322
2751,25/05/2021,3024,168,2500,251,524,07/05/2021,"Chateau Angelus Premier Grand Cru Classe A, Saint-Emilion Grand Cru",Bordeaux,2017,03/06/2021,10060452017,1006045
3750,26/07/2021,4292,51,3560,190,732,20/11/2020,"Chateau Margaux Premier Cru Classe, Margaux",Bordeaux,2012,27/07/2021,10127812012,1012781
3700,26/07/2021,4171,36,3520,180,651,07/04/2021,"Chateau Margaux Premier Cru Classe, Margaux",Bordeaux,2013,27/07/2021,10127812013,1012781
2751,25/05/2021,3013,164,2500,251,513,07/05/2021,"Chateau Angelus Premier Grand Cru Classe A, Saint-Emilion Grand Cru",Bordeaux,2017,29/05/2021,10060452017,1006045
800,26/07/2021,792,19,682,118,110,15/09/2020,"Chateau Calon Segur 3eme Cru Classe, Saint-Estephe",Bordeaux,2013,27/07/2021,10074752013,1007475
960,26/07/2021,1267,15,850,110,417,28/01/2021,"Tignanello, Toscana",Tuscany,2012,27/07/2021,10953912012,1095391
2751,25/05/2021,3027,167,2500,251,527,07/05/2021,"Chateau Angelus Premier Grand Cru Classe A, Saint-Emilion Grand Cru",Bordeaux,2017,05/06/2021,10060452017,1006045
3800,26/07/2021,4350,130,3480,320,870,17/06/2021,"Chateau Margaux Premier Cru Classe, Margaux",Bordeaux,2014,27/07/2021,10127812014,1012781
790,26/07/2021,877,18,801,-11,76,31/05/2021,"Chateau Calon Segur 3eme Cru Classe, Saint-Estephe",Bordeaux,2014,27/07/2021,10074752014,1007475
1080,23/07/2021,1139,8,860,220,279,08/03/2021,"Tignanello, Toscana",Tuscany,2013,27/07/2021,10953912013,1095391
984,26/07/2021,1048,7,854,130,194,15/07/2021,"Tignanello, Toscana",Tuscany,2014,27/07/2021,10953912014,1095391
940,26/07/2021,1074,79,866,74,208,20/07/2021,"Chateau Calon Segur 3eme Cru Classe, Saint-Estephe",Bordeaux,2015,27/07/2021,10074752015,1007475
10620,26/07/2021,11749,44,9800,820,1949,11/06/2021,"Chateau Margaux Premier Cru Classe, Margaux",Bordeaux,2015,27/07/2021,10127812015,1012781
1040,28/07/2021,1377,68,940,100,437,18/03/2021,"Chateau Calon Segur 3eme Cru Classe, Saint-Estephe",Bordeaux,2000,29/07/2021,10074752000,1007475
870,27/07/2021,966,5,705,165,261,01/02/2021,"Chateau Calon Segur 3eme Cru Classe, Saint-Estephe",Bordeaux,2002,28/07/2021,10074752002,1007475
8200,27/07/2021,9028,16,8200,0,828,26/07/2021,"Chateau Margaux Premier Cru Classe, Margaux",Bordeaux,2000,28/07/2021,10127812000,1012781
2751,11/05/2021,3026,188,2500,251,526,07/05/2021,"Chateau Angelus Premier Grand Cru Classe A, Saint-Emilion Grand Cru",Bordeaux,2017,12/05/2021,10060452017,1006045
4450,27/07/2021,4750,24,4400,50,350,29/09/2020,"Chateau Margaux Premier Cru Classe, Margaux",Bordeaux,2001,28/07/2021,10127812001,1012781
3840,27/07/2021,4583,50,4116,-276,467,25/02/2021,"Chateau Margaux Premier Cru Classe, Margaux",Bordeaux,2004,28/07/2021,10127812004,1012781
5040,27/07/2021,6002,22,4650,390,1352,21/06/2021,"Chateau Margaux Premier Cru Classe, Margaux",Bordeaux,2003,28/07/2021,10127812003,1012781
2751,11/05/2021,3044,177,2500,251,544,07/05/2021,"Chateau Angelus Premier Grand Cru Classe A, Saint-Emilion Grand Cru",Bordeaux,2017,19/05/2021,10060452017,1006045
840,27/07/2021,1059,20,745,95,314,16/11/2020,"Chateau Calon Segur 3eme Cru Classe, Saint-Estephe",Bordeaux,2004,28/07/2021,10074752004,1007475
3900,23/07/2021,4348,71,3780,120,568,23/07/2021,"Chateau Margaux Premier Cru Classe, Margaux",Bordeaux,2008,24/07/2021,10127812008,1012781
895,23/07/2021,981,10,781,114,200,16/11/2020,"Chateau Calon Segur 3eme Cru Classe, Saint-Estephe",Bordeaux,2008,24/07/2021,10074752008,1007475
588,04/08/2021,625,46,520,68,105,17/06/2021,"Chateau Batailley 5eme Cru Classe, Pauillac",Bordeaux,2005,06/08/2021,10063222005,1006322
6930,23/07/2021,7671,50,7086,-156,585,11/06/2021,"Chateau Margaux Premier Cru Classe, Margaux",Bordeaux,2009,24/07/2021,10127812009,1012781
9000,23/07/2021,8799,1,5400,3600,3399,13/08/2020,"Domaine Leflaive, Chevalier-Montrachet Grand Cru",Burgundy,2008,24/07/2021,10734012008,1073401
996,23/07/2021,1218,54,1026,-30,192,24/06/2021,"Chateau Calon Segur 3eme Cru Classe, Saint-Estephe",Bordeaux,2009,24/07/2021,10074752009,1007475
588,04/08/2021,625,48,520,68,105,17/06/2021,"Chateau Batailley 5eme Cru Classe, Pauillac",Bordeaux,2005,05/08/2021,10063222005,1006322
1800,23/07/2021,1700,1,1300,500,400,30/05/2019,"Gaja, Barbaresco",Piedmont,2007,24/07/2021,10996052007,1099605
2426,23/07/2021,2713,1,1768,658,945,22/05/2020,"Gaja, Barbaresco",Piedmont,2000,24/07/2021,10996052000,1099605
2386,23/07/2021,2397,3,2190,196,207,01/05/2021,"Gaja, Barbaresco",Piedmont,2004,24/07/2021,10996052004,1099605
574,23/07/2021,574,1,351,223,223,25/07/2016,"Tua Rita, Giusto di Notri, Toscana",Tuscany,2004,24/07/2021,11058072004,1105807
520,23/07/2021,563,3,460,60,103,05/05/2020,"Tua Rita, Giusto di Notri, Toscana",Tuscany,2008,24/07/2021,11058072008,1105807
660,23/07/2021,727,5,390,270,337,18/08/2017,"Tua Rita, Giusto di Notri, Toscana",Tuscany,2006,24/07/2021,11058072006,1105807
1680,23/07/2021,1705,4,1420,260,285,29/06/2021,"Tignanello, Toscana",Tuscany,2004,24/07/2021,10953912004,1095391
1700,23/07/2021,1657,4,1378,322,279,29/07/2020,"Tignanello, Toscana",Tuscany,2001,24/07/2021,10953912001,1095391
6300,23/07/2021,7547,55,6188,112,1359,16/07/2021,"Chateau Margaux Premier Cru Classe, Margaux",Bordeaux,2010,24/07/2021,10127812010,1012781
465,04/08/2021,458,2,400,65,58,11/05/2021,"Chateau Batailley 5eme Cru Classe, Pauillac",Bordeaux,2006,05/08/2021,10063222006,1006322
990,23/07/2021,1117,17,990,0,127,16/06/2021,"Chateau Calon Segur 3eme Cru Classe, Saint-Estephe",Bordeaux,2010,24/07/2021,10074752010,1007475
2751,11/05/2021,3045,174,2500,251,545,07/05/2021,"Chateau Angelus Premier Grand Cru Classe A, Saint-Emilion Grand Cru",Bordeaux,2017,17/05/2021,10060452017,1006045
750,23/07/2021,892,29,790,-40,102,01/06/2020,"Chateau Calon Segur 3eme Cru Classe, Saint-Estephe",Bordeaux,2011,24/07/2021,10074752011,1007475
1180,23/07/2021,1378,3,1140,40,238,21/07/2021,"Tignanello, Toscana",Tuscany,2009,24/07/2021,10953912009,1095391
1260,23/07/2021,1591,3,1170,90,421,24/06/2021,"Tignanello, Toscana",Tuscany,2010,24/07/2021,10953912010,1095391
3758,23/07/2021,4359,70,3690,68,669,13/04/2021,"Chateau Margaux Premier Cru Classe, Margaux",Bordeaux,2011,24/07/2021,10127812011,1012781
2751,11/05/2021,3027,189,2500,251,527,07/05/2021,"Chateau Angelus Premier Grand Cru Classe A, Saint-Emilion Grand Cru",Bordeaux,2017,13/05/2021,10060452017,1006045
2199,23/07/2021,2229,1,1340,859,889,13/03/2020,"Gaja, Barbaresco",Piedmont,2009,24/07/2021,10996052009,1099605
1000,23/07/2021,1115,8,880,120,235,22/06/2021,"Tignanello, Toscana",Tuscany,2011,24/07/2021,10953912011,1095391
6000,23/07/2021,6116,1,6500,-500,-384,26/05/2021,"Domaine Leflaive, Chevalier-Montrachet Grand Cru",Burgundy,2011,24/07/2021,10734012011,1073401
820,23/07/2021,924,5,735,85,189,09/09/2020,"Chateau Calon Segur 3eme Cru Classe, Saint-Estephe",Bordeaux,2012,24/07/2021,10074752012,1007475
2751,11/05/2021,3042,179,2500,251,542,07/05/2021,"Chateau Angelus Premier Grand Cru Classe A, Saint-Emilion Grand Cru",Bordeaux,2017,14/05/2021,10060452017,1006045
465,04/08/2021,458,2,400,65,58,11/05/2021,"Chateau Batailley 5eme Cru Classe, Pauillac",Bordeaux,2006,05/08/2021,10063222006,1006322
3750,15/07/2021,4269,39,3560,190,709,20/11/2020,"Chateau Margaux Premier Cru Classe, Margaux",Bordeaux,2012,24/07/2021,10127812012,1012781
13200,23/07/2021,12867,1,12850,350,17,30/11/2020,"Jacques-Frederic Mugnier, Chambolle-Musigny Premier Cru, Les Amoureuses",Burgundy,2011,24/07/2021,10496422011,1049642
3700,23/07/2021,4089,26,3520,180,569,07/04/2021,"Chateau Margaux Premier Cru Classe, Margaux",Bordeaux,2013,24/07/2021,10127812013,1012781
2751,11/05/2021,2968,195,2500,251,468,07/05/2021,"Chateau Angelus Premier Grand Cru Classe A, Saint-Emilion Grand Cru",Bordeaux,2017,21/05/2021,10060452017,1006045
450,04/08/2021,446,2,332,118,114,06/10/2020,"Chateau Batailley 5eme Cru Classe, Pauillac",Bordeaux,2008,05/08/2021,10063222008,1006322
800,23/07/2021,792,19,682,118,110,15/09/2020,"Chateau Calon Segur 3eme Cru Classe, Saint-Estephe",Bordeaux,2013,24/07/2021,10074752013,1007475
1500,20/07/2021,1453,6,1352,148,101,23/09/2020,"Gaja, Barbaresco",Piedmont,2011,24/07/2021,10996052011,1099605
960,23/07/2021,1309,13,850,110,459,28/01/2021,"Tignanello, Toscana",Tuscany,2012,24/07/2021,10953912012,1095391
3800,23/07/2021,4349,120,3480,320,869,17/06/2021,"Chateau Margaux Premier Cru Classe, Margaux",Bordeaux,2014,24/07/2021,10127812014,1012781
2751,11/05/2021,2962,199,2500,251,462,07/05/2021,"Chateau Angelus Premier Grand Cru Classe A, Saint-Emilion Grand Cru",Bordeaux,2017,24/05/2021,10060452017,1006045
790,23/07/2021,877,18,801,-11,76,31/05/2021,"Chateau Calon Segur 3eme Cru Classe, Saint-Estephe",Bordeaux,2014,24/07/2021,10074752014,1007475
500,04/08/2021,526,6,450,50,76,25/05/2021,"Chateau Batailley 5eme Cru Classe, Pauillac",Bordeaux,2009,06/08/2021,10063222009,1006322
1550,23/07/2021,1550,1,1300,250,250,27/04/2021,"Gaja, Barbaresco",Piedmont,2012,24/07/2021,10996052012,1099605
1060,23/07/2021,1140,9,860,200,280,08/03/2021,"Tignanello, Toscana",Tuscany,2013,24/07/2021,10953912013,1095391
984,23/07/2021,1048,7,854,130,194,15/07/2021,"Tignanello, Toscana",Tuscany,2014,24/07/2021,10953912014,1095391
940,23/07/2021,1079,77,866,74,213,20/07/2021,"Chateau Calon Segur 3eme Cru Classe, Saint-Estephe",Bordeaux,2015,24/07/2021,10074752015,1007475
10620,23/07/2021,11696,40,9800,820,1896,11/06/2021,"Chateau Margaux Premier Cru Classe, Margaux",Bordeaux,2015,24/07/2021,10127812015,1012781
14520,23/07/2021,14520,1,12000,2520,2520,28/05/2020,"Jacques-Frederic Mugnier, Chambolle-Musigny Premier Cru, Les Amoureuses",Burgundy,2014,24/07/2021,10496422014,1049642
5500,23/07/2021,5880,131,5500,0,380,06/07/2021,"Chateau Margaux Premier Cru Classe, Margaux",Bordeaux,2016,24/07/2021,10127812016,1012781
2751,11/05/2021,2968,194,2500,251,468,07/05/2021,"Chateau Angelus Premier Grand Cru Classe A, Saint-Emilion Grand Cru",Bordeaux,2017,20/05/2021,10060452017,1006045
1100,23/07/2021,1219,77,1036,64,183,27/05/2021,"Chateau Calon Segur 3eme Cru Classe, Saint-Estephe",Bordeaux,2016,24/07/2021,10074752016,1007475
500,04/08/2021,520,7,450,50,70,25/05/2021,"Chateau Batailley 5eme Cru Classe, Pauillac",Bordeaux,2009,05/08/2021,10063222009,1006322
1311,23/07/2021,1363,49,1220,91,143,14/07/2021,"Tignanello, Toscana",Tuscany,2016,24/07/2021,10953912016,1095391
1500,23/07/2021,1681,31,1510,-10,171,18/07/2021,"Gaja, Barbaresco",Piedmont,2016,24/07/2021,10996052016,1099605
2751,11/05/2021,2967,200,2500,251,467,07/05/2021,"Chateau Angelus Premier Grand Cru Classe A, Saint-Emilion Grand Cru",Bordeaux,2017,22/05/2021,10060452017,1006045
780,23/07/2021,938,73,740,40,198,21/05/2021,"Chateau Calon Segur 3eme Cru Classe, Saint-Estephe",Bordeaux,2017,24/07/2021,10074752017,1007475
3820,23/07/2021,4617,193,3950,-130,667,30/06/2021,"Chateau Margaux Premier Cru Classe, Margaux",Bordeaux,2017,24/07/2021,10127812017,1012781
1350,23/07/2021,1480,55,1260,90,220,18/02/2021,"Gaja, Barbaresco",Piedmont,2015,24/07/2021,10996052015,1099605
460,23/07/2021,498,179,420,40,78,28/05/2021,"Tua Rita, Giusto di Notri, Toscana",Tuscany,2016,24/07/2021,11058072016,1105807
2762,10/05/2021,3090,148,2500,262,590,07/05/2021,"Chateau Angelus Premier Grand Cru Classe A, Saint-Emilion Grand Cru",Bordeaux,2017,11/05/2021,10060452017,1006045
1028,23/07/2021,1244,40,1058,-30,186,14/07/2021,"Chateau Calon Segur 3eme Cru Classe, Saint-Estephe",Bordeaux,2018,24/07/2021,10074752018,1007475
500,04/08/2021,520,7,450,50,70,25/05/2021,"Chateau Batailley 5eme Cru Classe, Pauillac",Bordeaux,2009,05/08/2021,10063222009,1006322
866,21/07/2021,986,106,886,-20,100,21/07/2021,"Tignanello, Toscana",Tuscany,2017,24/07/2021,10953912017,1095391
8000,23/07/2021,8594,4,7330,670,1264,02/06/2021,"Domaine Leflaive, Chevalier-Montrachet Grand Cru",Burgundy,2018,24/07/2021,10734012018,1073401
500,04/08/2021,526,6,450,50,76,25/05/2021,"Chateau Batailley 5eme Cru Classe, Pauillac",Bordeaux,2009,06/08/2021,10063222009,1006322
1624,23/07/2021,1713,22,1580,44,133,21/07/2021,"Gaja, Barbaresco",Piedmont,2018,24/07/2021,10996052018,1099605
2762,06/05/2021,3087,148,2500,262,587,07/05/2021,"Chateau Angelus Premier Grand Cru Classe A, Saint-Emilion Grand Cru",Bordeaux,2017,10/05/2021,10060452017,1006045
6500,27/07/2021,7515,26,6400,100,1115,22/07/2021,"Chateau Margaux Premier Cru Classe, Margaux",Bordeaux,2005,28/07/2021,10127812005,1012781
990,26/07/2021,1177,64,1029,-39,148,21/07/2021,"Chateau Calon Segur 3eme Cru Classe, Saint-Estephe",Bordeaux,2005,28/07/2021,10074752005,1007475
525,04/08/2021,595,397,494,31,101,20/04/2021,"Chateau Batailley 5eme Cru Classe, Pauillac",Bordeaux,2010,05/08/2021,10063222010,1006322
3900,27/07/2021,4680,87,3822,78,858,20/06/2021,"Chateau Margaux Premier Cru Classe, Margaux",Bordeaux,2006,28/07/2021,10127812006,1012781
880,27/07/2021,980,7,725,155,255,13/04/2021,"Chateau Calon Segur 3eme Cru Classe, Saint-Estephe",Bordeaux,2007,28/07/2021,10074752007,1007475
2762,06/05/2021,3066,158,2500,262,566,07/05/2021,"Chateau Angelus Premier Grand Cru Classe A, Saint-Emilion Grand Cru",Bordeaux,2017,08/05/2021,10060452017,1006045
3750,27/07/2021,4268,89,3525,225,743,18/06/2021,"Chateau Margaux Premier Cru Classe, Margaux",Bordeaux,2007,28/07/2021,10127812007,1012781
8400,27/07/2021,8400,1,5700,2700,2700,10/09/2020,"Domaine Leflaive, Chevalier-Montrachet Grand Cru",Burgundy,2007,28/07/2021,10734012007,1073401
2762,06/05/2021,3067,159,2500,262,567,06/05/2021,"Chateau Angelus Premier Grand Cru Classe A, Saint-Emilion Grand Cru",Bordeaux,2017,07/05/2021,10060452017,1006045
3900,27/07/2021,4375,83,3780,120,595,23/07/2021,"Chateau Margaux Premier Cru Classe, Margaux",Bordeaux,2008,28/07/2021,10127812008,1012781
895,27/07/2021,953,8,781,114,172,16/11/2020,"Chateau Calon Segur 3eme Cru Classe, Saint-Estephe",Bordeaux,2008,28/07/2021,10074752008,1007475
6930,26/07/2021,7715,60,7086,-156,629,11/06/2021,"Chateau Margaux Premier Cru Classe, Margaux",Bordeaux,2009,28/07/2021,10127812009,1012781
9000,27/07/2021,8799,1,5400,3600,3399,13/08/2020,"Domaine Leflaive, Chevalier-Montrachet Grand Cru",Burgundy,2008,28/07/2021,10734012008,1073401
2762,03/05/2021,3067,159,2300,462,767,27/04/2021,"Chateau Angelus Premier Grand Cru Classe A, Saint-Emilion Grand Cru",Bordeaux,2017,05/05/2021,10060452017,1006045
2386,27/07/2021,2397,3,2190,196,207,01/05/2021,"Gaja, Barbaresco",Piedmont,2004,28/07/2021,10996052004,1099605
520,27/07/2021,563,3,460,60,103,05/05/2020,"Tua Rita, Giusto di Notri, Toscana",Tuscany,2008,28/07/2021,11058072008,1105807
660,27/07/2021,727,5,390,270,337,18/08/2017,"Tua Rita, Giusto di Notri, Toscana",Tuscany,2006,28/07/2021,11058072006,1105807
1299,06/07/2021,1523,5,1150,149,373,27/07/2021,"Tignanello, Toscana",Tuscany,2008,28/07/2021,10953912008,1095391
1700,26/07/2021,1665,4,1378,322,287,29/07/2020,"Tignanello, Toscana",Tuscany,2001,28/07/2021,10953912001,1095391
1680,23/07/2021,1693,2,1420,260,273,29/06/2021,"Tignanello, Toscana",Tuscany,2004,28/07/2021,10953912004,1095391
1624,27/07/2021,1810,2,882,742,928,26/04/2019,"Tignanello, Toscana",Tuscany,2003,28/07/2021,10953912003,1095391
1408,27/07/2021,1310,4,1238,170,72,02/11/2020,"Tignanello, Toscana",Tuscany,2006,28/07/2021,10953912006,1095391
1300,08/07/2021,1412,3,1200,100,212,06/03/2021,"Tignanello, Toscana",Tuscany,2007,28/07/2021,10953912007,1095391
1408,06/07/2021,1443,1,996,412,447,14/06/2019,"Tignanello, Toscana",Tuscany,2000,28/07/2021,10953912000,1095391
6400,27/07/2021,7545,57,6188,212,1357,16/07/2021,"Chateau Margaux Premier Cru Classe, Margaux",Bordeaux,2010,28/07/2021,10127812010,1012781
525,04/08/2021,595,397,494,31,101,20/04/2021,"Chateau Batailley 5eme Cru Classe, Pauillac",Bordeaux,2010,05/08/2021,10063222010,1006322
990,27/07/2021,1117,17,993,-3,124,27/07/2021,"Chateau Calon Segur 3eme Cru Classe, Saint-Estephe",Bordeaux,2010,28/07/2021,10074752010,1007475
8400,27/07/2021,8400,1,5960,2440,2440,01/08/2017,"Domaine Leflaive, Chevalier-Montrachet Grand Cru",Burgundy,2010,28/07/2021,10734012010,1073401
1326,26/07/2021,1602,3,1170,156,432,24/06/2021,"Tignanello, Toscana",Tuscany,2010,28/07/2021,10953912010,1095391
3758,27/07/2021,4370,80,3690,68,680,13/04/2021,"Chateau Margaux Premier Cru Classe, Margaux",Bordeaux,2011,28/07/2021,10127812011,1012781
2762,03/05/2021,3095,173,2300,462,795,27/04/2021,"Chateau Angelus Premier Grand Cru Classe A, Saint-Emilion Grand Cru",Bordeaux,2017,04/05/2021,10060452017,1006045
1050,26/07/2021,1117,9,880,170,237,22/06/2021,"Tignanello, Toscana",Tuscany,2011,28/07/2021,10953912011,1095391
3144,10/08/2021,3445,71,3120,24,325,28/07/2021,"Chateau Angelus Premier Grand Cru Classe A, Saint-Emilion Grand Cru",Bordeaux,2018,11/08/2021,10060452018,1006045
820,27/07/2021,920,4,735,85,185,09/09/2020,"Chateau Calon Segur 3eme Cru Classe, Saint-Estephe",Bordeaux,2012,28/07/2021,10074752012,1007475
3750,26/07/2021,4292,51,3650,100,642,27/07/2021,"Chateau Margaux Premier Cru Classe, Margaux",Bordeaux,2012,28/07/2021,10127812012,1012781
13200,27/07/2021,12867,1,12850,350,17,30/11/2020,"Jacques-Frederic Mugnier, Chambolle-Musigny Premier Cru, Les Amoureuses",Burgundy,2011,28/07/2021,10496422011,1049642
3700,27/07/2021,4171,36,3520,180,651,07/04/2021,"Chateau Margaux Premier Cru Classe, Margaux",Bordeaux,2013,28/07/2021,10127812013,1012781
380,04/08/2021,404,5,320,60,84,09/07/2021,"Chateau Batailley 5eme Cru Classe, Pauillac",Bordeaux,2011,05/08/2021,10063222011,1006322
3144,09/08/2021,3445,71,3120,24,325,28/07/2021,"Chateau Angelus Premier Grand Cru Classe A, Saint-Emilion Grand Cru",Bordeaux,2018,10/08/2021,10060452018,1006045
800,27/07/2021,792,19,682,118,110,15/09/2020,"Chateau Calon Segur 3eme Cru Classe, Saint-Estephe",Bordeaux,2013,28/07/2021,10074752013,1007475
960,26/07/2021,1309,13,850,110,459,28/01/2021,"Tignanello, Toscana",Tuscany,2012,28/07/2021,10953912012,1095391
3800,27/07/2021,4354,129,3480,320,874,17/06/2021,"Chateau Margaux Premier Cru Classe, Margaux",Bordeaux,2014,28/07/2021,10127812014,1012781
790,27/07/2021,877,18,801,-11,76,31/05/2021,"Chateau Calon Segur 3eme Cru Classe, Saint-Estephe",Bordeaux,2014,28/07/2021,10074752014,1007475
380,04/08/2021,404,5,320,60,84,09/07/2021,"Chateau Batailley 5eme Cru Classe, Pauillac",Bordeaux,2011,05/08/2021,10063222011,1006322
1550,27/07/2021,1550,1,1300,250,250,27/04/2021,"Gaja, Barbaresco",Piedmont,2012,28/07/2021,10996052012,1099605
950,27/07/2021,1128,9,960,-10,168,27/07/2021,"Tignanello, Toscana",Tuscany,2013,28/07/2021,10953912013,1095391
984,27/07/2021,1048,7,854,130,194,15/07/2021,"Tignanello, Toscana",Tuscany,2014,28/07/2021,10953912014,1095391
1400,27/07/2021,1524,14,1360,40,164,18/07/2021,"Gaja, Barbaresco",Piedmont,2013,28/07/2021,10996052013,1099605
1573,21/07/2021,1539,11,1300,273,239,10/07/2021,"Gaja, Barbaresco",Piedmont,2014,28/07/2021,10996052014,1099605
940,27/07/2021,1074,79,866,74,208,20/07/2021,"Chateau Calon Segur 3eme Cru Classe, Saint-Estephe",Bordeaux,2015,28/07/2021,10074752015,1007475
10620,27/07/2021,11774,44,9800,820,1974,11/06/2021,"Chateau Margaux Premier Cru Classe, Margaux",Bordeaux,2015,28/07/2021,10127812015,1012781
14520,27/07/2021,14520,1,12000,2520,2520,28/05/2020,"Jacques-Frederic Mugnier, Chambolle-Musigny Premier Cru, Les Amoureuses",Burgundy,2014,28/07/2021,10496422014,1049642
16200,27/07/2021,16327,0,18750,-2550,-2423,29/08/2018,"Jacques-Frederic Mugnier, Chambolle-Musigny Premier Cru, Les Amoureuses",Burgundy,2015,28/07/2021,10496422015,1049642
5500,27/07/2021,5890,135,5500,0,390,06/07/2021,"Chateau Margaux Premier Cru Classe, Margaux",Bordeaux,2016,28/07/2021,10127812016,1012781
3144,06/08/2021,3451,66,3120,24,331,28/07/2021,"Chateau Angelus Premier Grand Cru Classe A, Saint-Emilion Grand Cru",Bordeaux,2018,07/08/2021,10060452018,1006045
1100,27/07/2021,1219,77,1036,64,183,27/05/2021,"Chateau Calon Segur 3eme Cru Classe, Saint-Estephe",Bordeaux,2016,28/07/2021,10074752016,1007475
1280,26/07/2021,1366,50,1220,60,146,14/07/2021,"Tignanello, Toscana",Tuscany,2016,28/07/2021,10953912016,1095391
3144,05/08/2021,3451,65,3120,24,331,28/07/2021,"Chateau Angelus Premier Grand Cru Classe A, Saint-Emilion Grand Cru",Bordeaux,2018,06/08/2021,10060452018,1006045
780,27/07/2021,938,73,740,40,198,21/05/2021,"Chateau Calon Segur 3eme Cru Classe, Saint-Estephe",Bordeaux,2017,28/07/2021,10074752017,1007475
3820,26/07/2021,4622,218,3950,-130,672,30/06/2021,"Chateau Margaux Premier Cru Classe, Margaux",Bordeaux,2017,28/07/2021,10127812017,1012781
460,27/07/2021,498,179,420,40,78,28/05/2021,"Tua Rita, Giusto di Notri, Toscana",Tuscany,2016,28/07/2021,11058072016,1105807
3144,04/08/2021,3448,63,3120,24,328,28/07/2021,"Chateau Angelus Premier Grand Cru Classe A, Saint-Emilion Grand Cru",Bordeaux,2018,05/08/2021,10060452018,1006045
5600,27/07/2021,5844,102,5254,346,590,26/05/2021,"Chateau Margaux Premier Cru Classe, Margaux",Bordeaux,2018,28/07/2021,10127812018,1012781
8000,27/07/2021,8642,4,7330,670,1312,02/06/2021,"Domaine Leflaive, Chevalier-Montrachet Grand Cru",Burgundy,2018,28/07/2021,10734012018,1073401
990,21/07/2021,1156,93,910,80,246,14/07/2021,"Tignanello, Toscana",Tuscany,2018,28/07/2021,10953912018,1095391
380,04/08/2021,402,5,320,60,82,09/07/2021,"Chateau Batailley 5eme Cru Classe, Pauillac",Bordeaux,2011,07/08/2021,10063222011,1006322
920,27/07/2021,1037,36,842,78,195,22/08/2020,"Chateau Calon Segur 3eme Cru Classe, Saint-Estephe",Bordeaux,2019,28/07/2021,10074752019,1007475
1624,27/07/2021,1733,18,1598,26,135,26/07/2021,"Gaja, Barbaresco",Piedmont,2018,28/07/2021,10996052018,1099605
1040,28/07/2021,1381,68,940,100,441,18/03/2021,"Chateau Calon Segur 3eme Cru Classe, Saint-Estephe",Bordeaux,2000,03/08/2021,10074752000,1007475
866,02/08/2021,955,8,705,161,250,01/02/2021,"Chateau Calon Segur 3eme Cru Classe, Saint-Estephe",Bordeaux,2002,03/08/2021,10074752002,1007475
8300,02/08/2021,8830,13,8200,100,630,26/07/2021,"Chateau Margaux Premier Cru Classe, Margaux",Bordeaux,2000,03/08/2021,10127812000,1012781
3144,03/08/2021,3448,63,3120,24,328,28/07/2021,"Chateau Angelus Premier Grand Cru Classe A, Saint-Emilion Grand Cru",Bordeaux,2018,03/08/2021,10060452018,1006045
900,02/08/2021,1103,23,800,100,303,21/11/2019,"Chateau Calon Segur 3eme Cru Classe, Saint-Estephe",Bordeaux,2003,03/08/2021,10074752003,1007475
4450,02/08/2021,4709,15,4400,50,309,29/09/2020,"Chateau Margaux Premier Cru Classe, Margaux",Bordeaux,2001,03/08/2021,10127812001,1012781
3900,02/08/2021,4432,22,3684,216,748,10/06/2020,"Chateau Margaux Premier Cru Classe, Margaux",Bordeaux,2002,03/08/2021,10127812002,1012781
3826,02/08/2021,4640,45,4116,-290,524,25/02/2021,"Chateau Margaux Premier Cru Classe, Margaux",Bordeaux,2004,03/08/2021,10127812004,1012781
5100,02/08/2021,5753,25,4650,450,1103,21/06/2021,"Chateau Margaux Premier Cru Classe, Margaux",Bordeaux,2003,03/08/2021,10127812003,1012781
3150,02/08/2021,3469,59,3120,30,349,28/07/2021,"Chateau Angelus Premier Grand Cru Classe A, Saint-Emilion Grand Cru",Bordeaux,2018,03/08/2021,10060452018,1006045
3150,30/07/2021,3469,59,3120,30,349,28/07/2021,"Chateau Angelus Premier Grand Cru Classe A, Saint-Emilion Grand Cru",Bordeaux,2018,31/07/2021,10060452018,1006045
840,02/08/2021,1060,20,745,95,315,16/11/2020,"Chateau Calon Segur 3eme Cru Classe, Saint-Estephe",Bordeaux,2004,03/08/2021,10074752004,1007475
3150,29/07/2021,3467,59,3120,30,347,28/07/2021,"Chateau Angelus Premier Grand Cru Classe A, Saint-Emilion Grand Cru",Bordeaux,2018,30/07/2021,10060452018,1006045
907,02/08/2021,953,23,805,102,148,20/11/2019,"Chateau Calon Segur 3eme Cru Classe, Saint-Estephe",Bordeaux,2001,03/08/2021,10074752001,1007475
380,04/08/2021,402,5,320,60,82,09/07/2021,"Chateau Batailley 5eme Cru Classe, Pauillac",Bordeaux,2011,07/08/2021,10063222011,1006322
3150,28/07/2021,3445,65,3120,30,325,28/07/2021,"Chateau Angelus Premier Grand Cru Classe A, Saint-Emilion Grand Cru",Bordeaux,2018,29/07/2021,10060452018,1006045
505,04/08/2021,409,7,408,97,1,14/07/2021,"Chateau Batailley 5eme Cru Classe, Pauillac",Bordeaux,2012,05/08/2021,10063222012,1006322
6500,02/08/2021,7573,28,6400,100,1173,22/07/2021,"Chateau Margaux Premier Cru Classe, Margaux",Bordeaux,2005,03/08/2021,10127812005,1012781
3150,27/07/2021,3485,45,3064,86,421,25/06/2021,"Chateau Angelus Premier Grand Cru Classe A, Saint-Emilion Grand Cru",Bordeaux,2018,28/07/2021,10060452018,1006045
990,02/08/2021,1179,63,1029,-39,150,21/07/2021,"Chateau Calon Segur 3eme Cru Classe, Saint-Estephe",Bordeaux,2005,03/08/2021,10074752005,1007475
3150,26/07/2021,3486,45,3064,86,422,25/06/2021,"Chateau Angelus Premier Grand Cru Classe A, Saint-Emilion Grand Cru",Bordeaux,2018,27/07/2021,10060452018,1006045
3900,02/08/2021,4649,99,3822,78,827,20/06/2021,"Chateau Margaux Premier Cru Classe, Margaux",Bordeaux,2006,03/08/2021,10127812006,1012781
505,04/08/2021,409,7,408,97,1,14/07/2021,"Chateau Batailley 5eme Cru Classe, Pauillac",Bordeaux,2012,05/08/2021,10063222012,1006322
3800,02/08/2021,4251,44,3525,275,726,18/06/2021,"Chateau Margaux Premier Cru Classe, Margaux",Bordeaux,2007,03/08/2021,10127812007,1012781
880,02/08/2021,967,9,725,155,242,13/04/2021,"Chateau Calon Segur 3eme Cru Classe, Saint-Estephe",Bordeaux,2007,03/08/2021,10074752007,1007475
3150,23/07/2021,3501,40,3064,86,437,25/06/2021,"Chateau Angelus Premier Grand Cru Classe A, Saint-Emilion Grand Cru",Bordeaux,2018,24/07/2021,10060452018,1006045
3150,22/07/2021,3516,39,3064,86,452,25/06/2021,"Chateau Angelus Premier Grand Cru Classe A, Saint-Emilion Grand Cru",Bordeaux,2018,23/07/2021,10060452018,1006045
3950,02/08/2021,4407,97,3780,170,627,23/07/2021,"Chateau Margaux Premier Cru Classe, Margaux",Bordeaux,2008,03/08/2021,10127812008,1012781
895,02/08/2021,950,9,781,114,169,16/11/2020,"Chateau Calon Segur 3eme Cru Classe, Saint-Estephe",Bordeaux,2008,03/08/2021,10074752008,1007475
6930,02/08/2021,7680,74,7086,-156,594,11/06/2021,"Chateau Margaux Premier Cru Classe, Margaux",Bordeaux,2009,03/08/2021,10127812009,1012781
996,02/08/2021,1258,40,1026,-30,232,24/06/2021,"Chateau Calon Segur 3eme Cru Classe, Saint-Estephe",Bordeaux,2009,03/08/2021,10074752009,1007475
320,04/08/2021,320,103,304,16,16,10/01/2021,"Chateau Batailley 5eme Cru Classe, Pauillac",Bordeaux,2013,05/08/2021,10063222013,1006322
3150,21/07/2021,3554,42,3064,86,490,25/06/2021,"Chateau Angelus Premier Grand Cru Classe A, Saint-Emilion Grand Cru",Bordeaux,2018,22/07/2021,10060452018,1006045
2500,19/07/2021,2541,2,2400,100,141,18/07/2021,"Gaja, Barbaresco",Piedmont,2001,03/08/2021,10996052001,1099605
2386,02/08/2021,2471,2,2190,196,281,01/05/2021,"Gaja, Barbaresco",Piedmont,2004,03/08/2021,10996052004,1099605
1584,02/08/2021,1704,3,1378,206,326,29/07/2020,"Tignanello, Toscana",Tuscany,2001,03/08/2021,10953912001,1095391
6400,02/08/2021,7587,65,6188,212,1399,16/07/2021,"Chateau Margaux Premier Cru Classe, Margaux",Bordeaux,2010,03/08/2021,10127812010,1012781
360,04/08/2021,371,72,360,0,11,14/07/2021,"Chateau Batailley 5eme Cru Classe, Pauillac",Bordeaux,2014,05/08/2021,10063222014,1006322
990,02/08/2021,1119,17,993,-3,126,27/07/2021,"Chateau Calon Segur 3eme Cru Classe, Saint-Estephe",Bordeaux,2010,03/08/2021,10074752010,1007475
3150,20/07/2021,3546,42,3064,86,482,25/06/2021,"Chateau Angelus Premier Grand Cru Classe A, Saint-Emilion Grand Cru",Bordeaux,2018,21/07/2021,10060452018,1006045
750,02/08/2021,899,29,790,-40,109,01/06/2020,"Chateau Calon Segur 3eme Cru Classe, Saint-Estephe",Bordeaux,2011,03/08/2021,10074752011,1007475
1180,02/08/2021,1353,4,1140,40,213,21/07/2021,"Tignanello, Toscana",Tuscany,2009,03/08/2021,10953912009,1095391
1326,02/08/2021,1437,4,1170,156,267,24/06/2021,"Tignanello, Toscana",Tuscany,2010,03/08/2021,10953912010,1095391
3800,28/07/2021,4361,82,3690,110,671,13/04/2021,"Chateau Margaux Premier Cru Classe, Margaux",Bordeaux,2011,03/08/2021,10127812011,1012781
3150,19/07/2021,3458,54,3064,86,394,25/06/2021,"Chateau Angelus Premier Grand Cru Classe A, Saint-Emilion Grand Cru",Bordeaux,2018,20/07/2021,10060452018,1006045
990,02/08/2021,1117,9,880,110,237,22/06/2021,"Tignanello, Toscana",Tuscany,2011,03/08/2021,10953912011,1095391
3150,16/07/2021,3537,43,3064,86,473,25/06/2021,"Chateau Angelus Premier Grand Cru Classe A, Saint-Emilion Grand Cru",Bordeaux,2018,17/07/2021,10060452018,1006045
415,04/08/2021,538,29,364,51,174,12/05/2021,"Chateau Batailley 5eme Cru Classe, Pauillac",Bordeaux,2016,05/08/2021,10063222016,1006322
820,02/08/2021,925,4,735,85,190,09/09/2020,"Chateau Calon Segur 3eme Cru Classe, Saint-Estephe",Bordeaux,2012,03/08/2021,10074752012,1007475
3700,02/08/2021,4158,47,3520,180,638,07/04/2021,"Chateau Margaux Premier Cru Classe, Margaux",Bordeaux,2013,03/08/2021,10127812013,1012781
3150,15/07/2021,3533,44,3064,86,469,25/06/2021,"Chateau Angelus Premier Grand Cru Classe A, Saint-Emilion Grand Cru",Bordeaux,2018,16/07/2021,10060452018,1006045
800,02/08/2021,792,19,682,118,110,15/09/2020,"Chateau Calon Segur 3eme Cru Classe, Saint-Estephe",Bordeaux,2013,03/08/2021,10074752013,1007475
960,02/08/2021,1364,11,850,110,514,28/01/2021,"Tignanello, Toscana",Tuscany,2012,03/08/2021,10953912012,1095391
3150,14/07/2021,3534,42,3064,86,470,25/06/2021,"Chateau Angelus Premier Grand Cru Classe A, Saint-Emilion Grand Cru",Bordeaux,2018,15/07/2021,10060452018,1006045
3800,02/08/2021,4350,126,3600,200,750,02/08/2021,"Chateau Margaux Premier Cru Classe, Margaux",Bordeaux,2014,03/08/2021,10127812014,1012781
790,02/08/2021,868,17,801,-11,67,31/05/2021,"Chateau Calon Segur 3eme Cru Classe, Saint-Estephe",Bordeaux,2014,03/08/2021,10074752014,1007475
950,02/08/2021,1147,8,960,-10,187,27/07/2021,"Tignanello, Toscana",Tuscany,2013,03/08/2021,10953912013,1095391
1030,02/08/2021,1101,7,854,176,247,15/07/2021,"Tignanello, Toscana",Tuscany,2014,03/08/2021,10953912014,1095391
10800,20/07/2021,10860,2,8000,2800,2860,30/01/2020,"Domaine Leflaive, Chevalier-Montrachet Grand Cru",Burgundy,2014,03/08/2021,10734012014,1073401
940,02/08/2021,1073,78,866,74,207,20/07/2021,"Chateau Calon Segur 3eme Cru Classe, Saint-Estephe",Bordeaux,2015,03/08/2021,10074752015,1007475
10620,02/08/2021,11820,48,9800,820,2020,11/06/2021,"Chateau Margaux Premier Cru Classe, Margaux",Bordeaux,2015,03/08/2021,10127812015,1012781
870,29/07/2021,955,6,705,165,250,01/02/2021,"Chateau Calon Segur 3eme Cru Classe, Saint-Estephe",Bordeaux,2002,30/07/2021,10074752002,1007475
8200,29/07/2021,8980,17,8200,0,780,26/07/2021,"Chateau Margaux Premier Cru Classe, Margaux",Bordeaux,2000,30/07/2021,10127812000,1012781
3800,30/07/2021,4252,44,3525,275,727,18/06/2021,"Chateau Margaux Premier Cru Classe, Margaux",Bordeaux,2007,01/08/2021,10127812007,1012781
2386,30/07/2021,2471,2,2190,196,281,01/05/2021,"Gaja, Barbaresco",Piedmont,2004,01/08/2021,10996052004,1099605
550,05/08/2021,603,3,420,130,183,09/07/2019,"Chateau Batailley 5eme Cru Classe, Pauillac",Bordeaux,2003,06/08/2021,10063222003,1006322
3800,28/07/2021,4366,81,3690,110,676,13/04/2021,"Chateau Margaux Premier Cru Classe, Margaux",Bordeaux,2011,01/08/2021,10127812011,1012781
1050,30/07/2021,1132,8,880,170,252,22/06/2021,"Tignanello, Toscana",Tuscany,2011,01/08/2021,10953912011,1095391
870,30/07/2021,968,7,705,165,263,01/02/2021,"Chateau Calon Segur 3eme Cru Classe, Saint-Estephe",Bordeaux,2002,02/08/2021,10074752002,1007475
900,30/07/2021,1108,23,800,100,308,21/11/2019,"Chateau Calon Segur 3eme Cru Classe, Saint-Estephe",Bordeaux,2003,02/08/2021,10074752003,1007475
3826,30/07/2021,4640,45,4116,-290,524,25/02/2021,"Chateau Margaux Premier Cru Classe, Margaux",Bordeaux,2004,02/08/2021,10127812004,1012781
5100,30/07/2021,5781,24,4650,450,1131,21/06/2021,"Chateau Margaux Premier Cru Classe, Margaux",Bordeaux,2003,02/08/2021,10127812003,1012781
900,28/07/2021,1105,24,800,100,305,21/11/2019,"Chateau Calon Segur 3eme Cru Classe, Saint-Estephe",Bordeaux,2003,30/07/2021,10074752003,1007475
3900,28/07/2021,4407,23,3684,216,723,10/06/2020,"Chateau Margaux Premier Cru Classe, Margaux",Bordeaux,2002,30/07/2021,10127812002,1012781
4450,29/07/2021,4693,16,4400,50,293,29/09/2020,"Chateau Margaux Premier Cru Classe, Margaux",Bordeaux,2001,30/07/2021,10127812001,1012781
3826,29/07/2021,4593,48,4116,-290,477,25/02/2021,"Chateau Margaux Premier Cru Classe, Margaux",Bordeaux,2004,30/07/2021,10127812004,1012781
3150,13/07/2021,3534,42,3064,86,470,25/06/2021,"Chateau Angelus Premier Grand Cru Classe A, Saint-Emilion Grand Cru",Bordeaux,2018,14/07/2021,10060452018,1006045
3150,12/07/2021,3534,42,3064,86,470,25/06/2021,"Chateau Angelus Premier Grand Cru Classe A, Saint-Emilion Grand Cru",Bordeaux,2018,13/07/2021,10060452018,1006045
5040,29/07/2021,5919,25,4650,390,1269,21/06/2021,"Chateau Margaux Premier Cru Classe, Margaux",Bordeaux,2003,30/07/2021,10127812003,1012781
840,29/07/2021,1060,20,745,95,315,16/11/2020,"Chateau Calon Segur 3eme Cru Classe, Saint-Estephe",Bordeaux,2004,30/07/2021,10074752004,1007475
3150,09/07/2021,3534,42,3064,86,470,25/06/2021,"Chateau Angelus Premier Grand Cru Classe A, Saint-Emilion Grand Cru",Bordeaux,2018,10/07/2021,10060452018,1006045
6500,29/07/2021,7558,28,6400,100,1158,22/07/2021,"Chateau Margaux Premier Cru Classe, Margaux",Bordeaux,2005,30/07/2021,10127812005,1012781
3150,08/07/2021,3526,44,3064,86,462,25/06/2021,"Chateau Angelus Premier Grand Cru Classe A, Saint-Emilion Grand Cru",Bordeaux,2018,09/07/2021,10060452018,1006045
990,29/07/2021,1179,62,1029,-39,150,21/07/2021,"Chateau Calon Segur 3eme Cru Classe, Saint-Estephe",Bordeaux,2005,30/07/2021,10074752005,1007475
450,05/08/2021,532,2,300,150,232,15/12/2019,"Chateau Batailley 5eme Cru Classe, Pauillac",Bordeaux,2004,06/08/2021,10063222004,1006322
3900,29/07/2021,4649,99,3822,78,827,20/06/2021,"Chateau Margaux Premier Cru Classe, Margaux",Bordeaux,2006,30/07/2021,10127812006,1012781
3800,29/07/2021,4246,44,3525,275,721,18/06/2021,"Chateau Margaux Premier Cru Classe, Margaux",Bordeaux,2007,30/07/2021,10127812007,1012781
3150,07/07/2021,3460,66,3064,86,396,25/06/2021,"Chateau Angelus Premier Grand Cru Classe A, Saint-Emilion Grand Cru",Bordeaux,2018,08/07/2021,10060452018,1006045
880,29/07/2021,967,9,725,155,242,13/04/2021,"Chateau Calon Segur 3eme Cru Classe, Saint-Estephe",Bordeaux,2007,30/07/2021,10074752007,1007475
8400,29/07/2021,8400,1,5700,2700,2700,10/09/2020,"Domaine Leflaive, Chevalier-Montrachet Grand Cru",Burgundy,2007,30/07/2021,10734012007,1073401
3150,06/07/2021,3460,66,3064,86,396,25/06/2021,"Chateau Angelus Premier Grand Cru Classe A, Saint-Emilion Grand Cru",Bordeaux,2018,07/07/2021,10060452018,1006045
3950,29/07/2021,4399,97,3780,170,619,23/07/2021,"Chateau Margaux Premier Cru Classe, Margaux",Bordeaux,2008,30/07/2021,10127812008,1012781
895,29/07/2021,950,9,781,114,169,16/11/2020,"Chateau Calon Segur 3eme Cru Classe, Saint-Estephe",Bordeaux,2008,30/07/2021,10074752008,1007475
6930,29/07/2021,7708,74,7086,-156,622,11/06/2021,"Chateau Margaux Premier Cru Classe, Margaux",Bordeaux,2009,30/07/2021,10127812009,1012781
9000,29/07/2021,8799,1,5400,3600,3399,13/08/2020,"Domaine Leflaive, Chevalier-Montrachet Grand Cru",Burgundy,2008,30/07/2021,10734012008,1073401
996,28/07/2021,1205,53,1026,-30,179,24/06/2021,"Chateau Calon Segur 3eme Cru Classe, Saint-Estephe",Bordeaux,2009,30/07/2021,10074752009,1007475
505,05/08/2021,409,7,408,97,1,14/07/2021,"Chateau Batailley 5eme Cru Classe, Pauillac",Bordeaux,2012,06/08/2021,10063222012,1006322
3150,05/07/2021,3462,66,3064,86,398,25/06/2021,"Chateau Angelus Premier Grand Cru Classe A, Saint-Emilion Grand Cru",Bordeaux,2018,06/07/2021,10060452018,1006045
2386,29/07/2021,2397,3,2190,196,207,01/05/2021,"Gaja, Barbaresco",Piedmont,2004,30/07/2021,10996052004,1099605
520,29/07/2021,563,3,460,60,103,05/05/2020,"Tua Rita, Giusto di Notri, Toscana",Tuscany,2008,30/07/2021,11058072008,1105807
660,29/07/2021,727,5,390,270,337,18/08/2017,"Tua Rita, Giusto di Notri, Toscana",Tuscany,2006,30/07/2021,11058072006,1105807
6400,29/07/2021,7576,68,6188,212,1388,16/07/2021,"Chateau Margaux Premier Cru Classe, Margaux",Bordeaux,2010,30/07/2021,10127812010,1012781
990,29/07/2021,1119,17,993,-3,126,27/07/2021,"Chateau Calon Segur 3eme Cru Classe, Saint-Estephe",Bordeaux,2010,30/07/2021,10074752010,1007475
3150,02/07/2021,3458,67,3064,86,394,25/06/2021,"Chateau Angelus Premier Grand Cru Classe A, Saint-Emilion Grand Cru",Bordeaux,2018,05/07/2021,10060452018,1006045
750,28/07/2021,897,30,790,-40,107,01/06/2020,"Chateau Calon Segur 3eme Cru Classe, Saint-Estephe",Bordeaux,2011,30/07/2021,10074752011,1007475
8400,29/07/2021,8400,1,5960,2440,2440,01/08/2017,"Domaine Leflaive, Chevalier-Montrachet Grand Cru",Burgundy,2010,30/07/2021,10734012010,1073401
1326,28/07/2021,1452,3,1170,156,282,24/06/2021,"Tignanello, Toscana",Tuscany,2010,30/07/2021,10953912010,1095391
3800,28/07/2021,4370,80,3690,110,680,13/04/2021,"Chateau Margaux Premier Cru Classe, Margaux",Bordeaux,2011,30/07/2021,10127812011,1012781
3150,02/07/2021,3433,85,3064,86,369,25/06/2021,"Chateau Angelus Premier Grand Cru Classe A, Saint-Emilion Grand Cru",Bordeaux,2018,03/07/2021,10060452018,1006045
505,05/08/2021,409,7,408,97,1,14/07/2021,"Chateau Batailley 5eme Cru Classe, Pauillac",Bordeaux,2012,06/08/2021,10063222012,1006322
3150,01/07/2021,3436,84,3064,86,372,25/06/2021,"Chateau Angelus Premier Grand Cru Classe A, Saint-Emilion Grand Cru",Bordeaux,2018,02/07/2021,10060452018,1006045
320,05/08/2021,320,103,304,16,16,10/01/2021,"Chateau Batailley 5eme Cru Classe, Pauillac",Bordeaux,2013,06/08/2021,10063222013,1006322
820,29/07/2021,925,4,735,85,190,09/09/2020,"Chateau Calon Segur 3eme Cru Classe, Saint-Estephe",Bordeaux,2012,30/07/2021,10074752012,1007475
3750,26/07/2021,4299,57,3650,100,649,27/07/2021,"Chateau Margaux Premier Cru Classe, Margaux",Bordeaux,2012,30/07/2021,10127812012,1012781
13200,29/07/2021,12867,1,12850,350,17,30/11/2020,"Jacques-Frederic Mugnier, Chambolle-Musigny Premier Cru, Les Amoureuses",Burgundy,2011,30/07/2021,10496422011,1049642
3700,29/07/2021,4159,48,3520,180,639,07/04/2021,"Chateau Margaux Premier Cru Classe, Margaux",Bordeaux,2013,30/07/2021,10127812013,1012781
3150,30/06/2021,3436,84,3064,86,372,25/06/2021,"Chateau Angelus Premier Grand Cru Classe A, Saint-Emilion Grand Cru",Bordeaux,2018,01/07/2021,10060452018,1006045
360,05/08/2021,371,72,360,0,11,14/07/2021,"Chateau Batailley 5eme Cru Classe, Pauillac",Bordeaux,2014,06/08/2021,10063222014,1006322
800,29/07/2021,792,19,682,118,110,15/09/2020,"Chateau Calon Segur 3eme Cru Classe, Saint-Estephe",Bordeaux,2013,30/07/2021,10074752013,1007475
960,28/07/2021,1346,11,850,110,496,28/01/2021,"Tignanello, Toscana",Tuscany,2012,30/07/2021,10953912012,1095391
3150,29/06/2021,3436,84,3064,86,372,25/06/2021,"Chateau Angelus Premier Grand Cru Classe A, Saint-Emilion Grand Cru",Bordeaux,2018,30/06/2021,10060452018,1006045
3800,29/07/2021,4359,131,3480,320,879,17/06/2021,"Chateau Margaux Premier Cru Classe, Margaux",Bordeaux,2014,30/07/2021,10127812014,1012781
790,29/07/2021,877,18,801,-11,76,31/05/2021,"Chateau Calon Segur 3eme Cru Classe, Saint-Estephe",Bordeaux,2014,30/07/2021,10074752014,1007475
1550,29/07/2021,1550,1,1300,250,250,27/04/2021,"Gaja, Barbaresco",Piedmont,2012,30/07/2021,10996052012,1099605
950,29/07/2021,1144,8,960,-10,184,27/07/2021,"Tignanello, Toscana",Tuscany,2013,30/07/2021,10953912013,1095391
1030,28/07/2021,1055,4,854,176,201,15/07/2021,"Tignanello, Toscana",Tuscany,2014,30/07/2021,10953912014,1095391
1400,29/07/2021,1534,13,1360,40,174,18/07/2021,"Gaja, Barbaresco",Piedmont,2013,30/07/2021,10996052013,1099605
940,29/07/2021,1068,83,866,74,202,20/07/2021,"Chateau Calon Segur 3eme Cru Classe, Saint-Estephe",Bordeaux,2015,30/07/2021,10074752015,1007475
10620,29/07/2021,11800,48,9800,820,2000,11/06/2021,"Chateau Margaux Premier Cru Classe, Margaux",Bordeaux,2015,30/07/2021,10127812015,1012781
14520,29/07/2021,14520,1,12000,2520,2520,28/05/2020,"Jacques-Frederic Mugnier, Chambolle-Musigny Premier Cru, Les Amoureuses",Burgundy,2014,30/07/2021,10496422014,1049642
1130,28/07/2021,1186,16,1012,118,174,02/07/2021,"Tignanello, Toscana",Tuscany,2015,30/07/2021,10953912015,1095391
5500,29/07/2021,5891,156,5500,0,391,06/07/2021,"Chateau Margaux Premier Cru Classe, Margaux",Bordeaux,2016,30/07/2021,10127812016,1012781
3150,28/06/2021,3438,84,3064,86,374,25/06/2021,"Chateau Angelus Premier Grand Cru Classe A, Saint-Emilion Grand Cru",Bordeaux,2018,29/06/2021,10060452018,1006045
1100,29/07/2021,1218,78,1036,64,182,27/05/2021,"Chateau Calon Segur 3eme Cru Classe, Saint-Estephe",Bordeaux,2016,30/07/2021,10074752016,1007475
1280,28/07/2021,1368,49,1220,60,148,14/07/2021,"Tignanello, Toscana",Tuscany,2016,30/07/2021,10953912016,1095391
1440,28/07/2021,1674,32,1510,-70,164,18/07/2021,"Gaja, Barbaresco",Piedmont,2016,30/07/2021,10996052016,1099605
780,29/07/2021,937,95,740,40,197,21/05/2021,"Chateau Calon Segur 3eme Cru Classe, Saint-Estephe",Bordeaux,2017,30/07/2021,10074752017,1007475
685,06/08/2021,685,1,470,215,215,29/03/2018,"Chateau Batailley 5eme Cru Classe, Pauillac",Bordeaux,2000,07/08/2021,10063222000,1006322
3820,28/07/2021,4604,220,3950,-130,654,30/06/2021,"Chateau Margaux Premier Cru Classe, Margaux",Bordeaux,2017,30/07/2021,10127812017,1012781
460,29/07/2021,499,180,420,40,79,28/05/2021,"Tua Rita, Giusto di Notri, Toscana",Tuscany,2016,30/07/2021,11058072016,1105807
8098,29/07/2021,9748,3,7290,808,2458,21/08/2020,"Domaine Denis Mortet, Chambertin Grand Cru",Burgundy,2017,30/07/2021,10490202017,1049020
3150,25/06/2021,3462,90,3064,86,398,25/06/2021,"Chateau Angelus Premier Grand Cru Classe A, Saint-Emilion Grand Cru",Bordeaux,2018,26/06/2021,10060452018,1006045
5600,29/07/2021,5878,97,5254,346,624,26/05/2021,"Chateau Margaux Premier Cru Classe, Margaux",Bordeaux,2018,30/07/2021,10127812018,1012781
900,23/07/2021,993,97,864,36,129,26/07/2021,"Tignanello, Toscana",Tuscany,2017,30/07/2021,10953912017,1095391
8568,29/07/2021,8654,4,7330,1238,1324,02/06/2021,"Domaine Leflaive, Chevalier-Montrachet Grand Cru",Burgundy,2018,30/07/2021,10734012018,1073401
1008,29/07/2021,1159,91,998,10,161,28/07/2021,"Tignanello, Toscana",Tuscany,2018,30/07/2021,10953912018,1095391
685,06/08/2021,685,1,470,215,215,29/03/2018,"Chateau Batailley 5eme Cru Classe, Pauillac",Bordeaux,2000,07/08/2021,10063222000,1006322
920,29/07/2021,1034,40,842,78,192,22/08/2020,"Chateau Calon Segur 3eme Cru Classe, Saint-Estephe",Bordeaux,2019,30/07/2021,10074752019,1007475
5290,29/07/2021,5241,7,4160,1130,1081,19/03/2021,"Chateau Margaux Premier Cru Classe, Margaux",Bordeaux,2019,30/07/2021,10127812019,1012781
1480,26/07/2021,1614,84,1398,82,216,01/07/2021,"Gaja, Barbaresco",Piedmont,2017,30/07/2021,10996052017,1099605
1624,29/07/2021,1734,18,1598,26,136,26/07/2021,"Gaja, Barbaresco",Piedmont,2018,30/07/2021,10996052018,1099605
3150,25/06/2021,3433,83,3064,86,369,25/06/2021,"Chateau Angelus Premier Grand Cru Classe A, Saint-Emilion Grand Cru",Bordeaux,2018,28/06/2021,10060452018,1006045
875,22/07/2021,934,46,863,12,71,10/05/2021,"Chateau Calon Segur 3eme Cru Classe, Saint-Estephe",Bordeaux,2006,31/07/2021,10074752006,1007475
3900,30/07/2021,4649,99,3822,78,827,20/06/2021,"Chateau Margaux Premier Cru Classe, Margaux",Bordeaux,2006,31/07/2021,10127812006,1012781
420,06/08/2021,430,3,220,200,210,17/06/2015,"Chateau Batailley 5eme Cru Classe, Pauillac",Bordeaux,2002,10/08/2021,10063222002,1006322
3800,30/07/2021,4246,44,3525,275,721,18/06/2021,"Chateau Margaux Premier Cru Classe, Margaux",Bordeaux,2007,31/07/2021,10127812007,1012781
880,30/07/2021,967,9,725,155,242,13/04/2021,"Chateau Calon Segur 3eme Cru Classe, Saint-Estephe",Bordeaux,2007,31/07/2021,10074752007,1007475
3150,24/06/2021,3460,91,3122,28,338,17/06/2021,"Chateau Angelus Premier Grand Cru Classe A, Saint-Emilion Grand Cru",Bordeaux,2018,25/06/2021,10060452018,1006045
3150,23/06/2021,3470,88,3122,28,348,17/06/2021,"Chateau Angelus Premier Grand Cru Classe A, Saint-Emilion Grand Cru",Bordeaux,2018,24/06/2021,10060452018,1006045
3950,30/07/2021,4407,97,3780,170,627,23/07/2021,"Chateau Margaux Premier Cru Classe, Margaux",Bordeaux,2008,02/08/2021,10127812008,1012781
3150,22/06/2021,3470,88,3122,28,348,17/06/2021,"Chateau Angelus Premier Grand Cru Classe A, Saint-Emilion Grand Cru",Bordeaux,2018,23/06/2021,10060452018,1006045
3700,30/07/2021,4158,47,3520,180,638,07/04/2021,"Chateau Margaux Premier Cru Classe, Margaux",Bordeaux,2013,02/08/2021,10127812013,1012781
3800,30/07/2021,4355,125,3480,320,875,17/06/2021,"Chateau Margaux Premier Cru Classe, Margaux",Bordeaux,2014,02/08/2021,10127812014,1012781
790,30/07/2021,868,17,801,-11,67,31/05/2021,"Chateau Calon Segur 3eme Cru Classe, Saint-Estephe",Bordeaux,2014,02/08/2021,10074752014,1007475
420,06/08/2021,470,4,220,200,250,17/06/2015,"Chateau Batailley 5eme Cru Classe, Pauillac",Bordeaux,2002,07/08/2021,10063222002,1006322
1573,28/07/2021,1677,7,1300,273,377,10/07/2021,"Gaja, Barbaresco",Piedmont,2014,02/08/2021,10996052014,1099605
940,30/07/2021,1073,78,866,74,207,20/07/2021,"Chateau Calon Segur 3eme Cru Classe, Saint-Estephe",Bordeaux,2015,02/08/2021,10074752015,1007475
10620,30/07/2021,11773,46,9800,820,1973,11/06/2021,"Chateau Margaux Premier Cru Classe, Margaux",Bordeaux,2015,02/08/2021,10127812015,1012781
450,06/08/2021,532,2,300,150,232,15/12/2019,"Chateau Batailley 5eme Cru Classe, Pauillac",Bordeaux,2004,07/08/2021,10063222004,1006322
1100,30/07/2021,1218,80,1036,64,182,27/05/2021,"Chateau Calon Segur 3eme Cru Classe, Saint-Estephe",Bordeaux,2016,02/08/2021,10074752016,1007475
588,06/08/2021,625,46,520,68,105,17/06/2021,"Chateau Batailley 5eme Cru Classe, Pauillac",Bordeaux,2005,07/08/2021,10063222005,1006322
1280,30/07/2021,1370,53,1220,60,150,14/07/2021,"Tignanello, Toscana",Tuscany,2016,02/08/2021,10953912016,1095391
1050,30/07/2021,1113,9,880,170,233,22/06/2021,"Tignanello, Toscana",Tuscany,2011,31/07/2021,10953912011,1095391
820,30/07/2021,925,4,735,85,190,09/09/2020,"Chateau Calon Segur 3eme Cru Classe, Saint-Estephe",Bordeaux,2012,31/07/2021,10074752012,1007475
3150,21/06/2021,3469,83,3122,28,347,17/06/2021,"Chateau Angelus Premier Grand Cru Classe A, Saint-Emilion Grand Cru",Bordeaux,2018,22/06/2021,10060452018,1006045
588,06/08/2021,625,46,520,68,105,17/06/2021,"Chateau Batailley 5eme Cru Classe, Pauillac",Bordeaux,2005,07/08/2021,10063222005,1006322
3750,26/07/2021,4318,55,3650,100,668,27/07/2021,"Chateau Margaux Premier Cru Classe, Margaux",Bordeaux,2012,31/07/2021,10127812012,1012781
3700,30/07/2021,4159,48,3520,180,639,07/04/2021,"Chateau Margaux Premier Cru Classe, Margaux",Bordeaux,2013,31/07/2021,10127812013,1012781
3150,18/06/2021,3434,81,3122,28,312,17/06/2021,"Chateau Angelus Premier Grand Cru Classe A, Saint-Emilion Grand Cru",Bordeaux,2018,21/06/2021,10060452018,1006045
800,30/07/2021,792,19,682,118,110,15/09/2020,"Chateau Calon Segur 3eme Cru Classe, Saint-Estephe",Bordeaux,2013,31/07/2021,10074752013,1007475
960,30/07/2021,1346,11,850,110,496,28/01/2021,"Tignanello, Toscana",Tuscany,2012,31/07/2021,10953912012,1095391
3150,18/06/2021,3434,82,3122,28,312,17/06/2021,"Chateau Angelus Premier Grand Cru Classe A, Saint-Emilion Grand Cru",Bordeaux,2018,19/06/2021,10060452018,1006045
3800,30/07/2021,4359,126,3480,320,879,17/06/2021,"Chateau Margaux Premier Cru Classe, Margaux",Bordeaux,2014,31/07/2021,10127812014,1012781
790,30/07/2021,877,18,801,-11,76,31/05/2021,"Chateau Calon Segur 3eme Cru Classe, Saint-Estephe",Bordeaux,2014,31/07/2021,10074752014,1007475
950,30/07/2021,1147,8,960,-10,187,27/07/2021,"Tignanello, Toscana",Tuscany,2013,31/07/2021,10953912013,1095391
1030,30/07/2021,1101,7,854,176,247,15/07/2021,"Tignanello, Toscana",Tuscany,2014,31/07/2021,10953912014,1095391
10800,20/07/2021,10694,1,8000,2800,2694,30/01/2020,"Domaine Leflaive, Chevalier-Montrachet Grand Cru",Burgundy,2014,31/07/2021,10734012014,1073401
940,30/07/2021,1068,82,866,74,202,20/07/2021,"Chateau Calon Segur 3eme Cru Classe, Saint-Estephe",Bordeaux,2015,31/07/2021,10074752015,1007475
10620,30/07/2021,11810,47,9800,820,2010,11/06/2021,"Chateau Margaux Premier Cru Classe, Margaux",Bordeaux,2015,31/07/2021,10127812015,1012781
465,06/08/2021,458,2,400,65,58,11/05/2021,"Chateau Batailley 5eme Cru Classe, Pauillac",Bordeaux,2006,07/08/2021,10063222006,1006322
465,06/08/2021,458,2,400,65,58,11/05/2021,"Chateau Batailley 5eme Cru Classe, Pauillac",Bordeaux,2006,07/08/2021,10063222006,1006322
450,06/08/2021,446,2,332,118,114,06/10/2020,"Chateau Batailley 5eme Cru Classe, Pauillac",Bordeaux,2008,07/08/2021,10063222008,1006322
3800,30/07/2021,4252,44,3525,275,727,18/06/2021,"Chateau Margaux Premier Cru Classe, Margaux",Bordeaux,2007,01/08/2021,10127812007,1012781
500,06/08/2021,545,4,450,50,95,25/05/2021,"Chateau Batailley 5eme Cru Classe, Pauillac",Bordeaux,2009,07/08/2021,10063222009,1006322
780,30/07/2021,938,94,740,40,198,21/05/2021,"Chateau Calon Segur 3eme Cru Classe, Saint-Estephe",Bordeaux,2017,02/08/2021,10074752017,1007475
500,06/08/2021,548,4,450,50,98,25/05/2021,"Chateau Batailley 5eme Cru Classe, Pauillac",Bordeaux,2009,08/08/2021,10063222009,1006322
479,30/07/2021,504,171,390,89,114,01/08/2021,"Tua Rita, Giusto di Notri, Toscana",Tuscany,2016,02/08/2021,11058072016,1105807
1028,23/07/2021,1234,45,1058,-30,176,14/07/2021,"Chateau Calon Segur 3eme Cru Classe, Saint-Estephe",Bordeaux,2018,02/08/2021,10074752018,1007475
500,06/08/2021,545,4,450,50,95,25/05/2021,"Chateau Batailley 5eme Cru Classe, Pauillac",Bordeaux,2009,07/08/2021,10063222009,1006322
8568,30/07/2021,8734,3,7330,1238,1404,02/06/2021,"Domaine Leflaive, Chevalier-Montrachet Grand Cru",Burgundy,2018,02/08/2021,10734012018,1073401
5290,30/07/2021,5240,7,4160,1130,1080,19/03/2021,"Chateau Margaux Premier Cru Classe, Margaux",Bordeaux,2019,02/08/2021,10127812019,1012781
1624,30/07/2021,1734,18,1663,-39,71,01/08/2021,"Gaja, Barbaresco",Piedmont,2018,02/08/2021,10996052018,1099605
870,30/07/2021,968,7,705,165,263,01/02/2021,"Chateau Calon Segur 3eme Cru Classe, Saint-Estephe",Bordeaux,2002,02/08/2021,10074752002,1007475
900,30/07/2021,1108,23,800,100,308,21/11/2019,"Chateau Calon Segur 3eme Cru Classe, Saint-Estephe",Bordeaux,2003,02/08/2021,10074752003,1007475
3826,30/07/2021,4640,45,4116,-290,524,25/02/2021,"Chateau Margaux Premier Cru Classe, Margaux",Bordeaux,2004,02/08/2021,10127812004,1012781
5100,30/07/2021,5781,24,4650,450,1131,21/06/2021,"Chateau Margaux Premier Cru Classe, Margaux",Bordeaux,2003,02/08/2021,10127812003,1012781
2386,30/07/2021,2471,2,2190,196,281,01/05/2021,"Gaja, Barbaresco",Piedmont,2004,01/08/2021,10996052004,1099605
500,06/08/2021,548,4,450,50,98,25/05/2021,"Chateau Batailley 5eme Cru Classe, Pauillac",Bordeaux,2009,08/08/2021,10063222009,1006322
3800,28/07/2021,4366,81,3690,110,676,13/04/2021,"Chateau Margaux Premier Cru Classe, Margaux",Bordeaux,2011,01/08/2021,10127812011,1012781
1050,30/07/2021,1132,8,880,170,252,22/06/2021,"Tignanello, Toscana",Tuscany,2011,01/08/2021,10953912011,1095391
3150,17/06/2021,3434,82,3122,28,312,17/06/2021,"Chateau Angelus Premier Grand Cru Classe A, Saint-Emilion Grand Cru",Bordeaux,2018,18/06/2021,10060452018,1006045
3950,30/07/2021,4407,97,3780,170,627,23/07/2021,"Chateau Margaux Premier Cru Classe, Margaux",Bordeaux,2008,02/08/2021,10127812008,1012781
3150,16/06/2021,3433,85,2648,502,785,08/06/2021,"Chateau Angelus Premier Grand Cru Classe A, Saint-Emilion Grand Cru",Bordeaux,2018,17/06/2021,10060452018,1006045
3700,30/07/2021,4158,47,3520,180,638,07/04/2021,"Chateau Margaux Premier Cru Classe, Margaux",Bordeaux,2013,02/08/2021,10127812013,1012781
3800,30/07/2021,4355,125,3480,320,875,17/06/2021,"Chateau Margaux Premier Cru Classe, Margaux",Bordeaux,2014,02/08/2021,10127812014,1012781
790,30/07/2021,868,17,801,-11,67,31/05/2021,"Chateau Calon Segur 3eme Cru Classe, Saint-Estephe",Bordeaux,2014,02/08/2021,10074752014,1007475
940,30/07/2021,1073,78,866,74,207,20/07/2021,"Chateau Calon Segur 3eme Cru Classe, Saint-Estephe",Bordeaux,2015,02/08/2021,10074752015,1007475
10620,30/07/2021,11773,46,9800,820,1973,11/06/2021,"Chateau Margaux Premier Cru Classe, Margaux",Bordeaux,2015,02/08/2021,10127812015,1012781
1040,28/07/2021,1381,68,940,100,441,18/03/2021,"Chateau Calon Segur 3eme Cru Classe, Saint-Estephe",Bordeaux,2000,03/08/2021,10074752000,1007475
866,02/08/2021,955,8,705,161,250,01/02/2021,"Chateau Calon Segur 3eme Cru Classe, Saint-Estephe",Bordeaux,2002,03/08/2021,10074752002,1007475
2500,19/07/2021,2548,2,2400,100,148,18/07/2021,"Gaja, Barbaresco",Piedmont,2001,06/08/2021,10996052001,1099605
990,05/08/2021,1119,10,880,110,239,22/06/2021,"Tignanello, Toscana",Tuscany,2011,06/08/2021,10953912011,1095391
3150,15/06/2021,3433,85,2648,502,785,08/06/2021,"Chateau Angelus Premier Grand Cru Classe A, Saint-Emilion Grand Cru",Bordeaux,2018,16/06/2021,10060452018,1006045
16200,05/08/2021,16483,0,18750,-2550,-2267,29/08/2018,"Jacques-Frederic Mugnier, Chambolle-Musigny Premier Cru, Les Amoureuses",Burgundy,2015,06/08/2021,10496422015,1049642
1900,05/08/2021,2281,3,2190,-290,91,01/05/2021,"Gaja, Barbaresco",Piedmont,2004,06/08/2021,10996052004,1099605
14520,05/08/2021,14520,1,12000,2520,2520,28/05/2020,"Jacques-Frederic Mugnier, Chambolle-Musigny Premier Cru, Les Amoureuses",Burgundy,2014,06/08/2021,10496422014,1049642
3900,05/08/2021,4639,96,3822,78,817,20/06/2021,"Chateau Margaux Premier Cru Classe, Margaux",Bordeaux,2006,06/08/2021,10127812006,1012781
10620,05/08/2021,11970,49,9800,820,2170,11/06/2021,"Chateau Margaux Premier Cru Classe, Margaux",Bordeaux,2015,06/08/2021,10127812015,1012781
940,05/08/2021,1074,77,866,74,208,20/07/2021,"Chateau Calon Segur 3eme Cru Classe, Saint-Estephe",Bordeaux,2015,06/08/2021,10074752015,1007475
6930,05/08/2021,7720,70,7086,-156,634,11/06/2021,"Chateau Margaux Premier Cru Classe, Margaux",Bordeaux,2009,06/08/2021,10127812009,1012781
9000,05/08/2021,8799,1,5400,3600,3399,13/08/2020,"Domaine Leflaive, Chevalier-Montrachet Grand Cru",Burgundy,2008,06/08/2021,10734012008,1073401
3950,05/08/2021,4469,108,3780,170,689,23/07/2021,"Chateau Margaux Premier Cru Classe, Margaux",Bordeaux,2008,06/08/2021,10127812008,1012781
430,06/08/2021,456,99,380,50,76,25/03/2021,"Tua Rita, Giusto di Notri, Toscana",Tuscany,2018,07/08/2021,11058072018,1105807
820,05/08/2021,925,4,735,85,190,09/09/2020,"Chateau Calon Segur 3eme Cru Classe, Saint-Estephe",Bordeaux,2012,06/08/2021,10074752012,1007475
895,06/08/2021,965,52,863,32,102,10/05/2021,"Chateau Calon Segur 3eme Cru Classe, Saint-Estephe",Bordeaux,2006,08/08/2021,10074752006,1007475
525,06/08/2021,595,397,494,31,101,20/04/2021,"Chateau Batailley 5eme Cru Classe, Pauillac",Bordeaux,2010,07/08/2021,10063222010,1006322
3900,06/08/2021,4652,92,3822,78,830,20/06/2021,"Chateau Margaux Premier Cru Classe, Margaux",Bordeaux,2006,08/08/2021,10127812006,1012781
3900,06/08/2021,4229,46,3690,210,539,13/04/2021,"Chateau Margaux Premier Cru Classe, Margaux",Bordeaux,2011,08/08/2021,10127812011,1012781
3950,06/08/2021,4466,103,3780,170,686,23/07/2021,"Chateau Margaux Premier Cru Classe, Margaux",Bordeaux,2008,08/08/2021,10127812008,1012781
3900,06/08/2021,4446,22,3684,216,762,10/06/2020,"Chateau Margaux Premier Cru Classe, Margaux",Bordeaux,2002,08/08/2021,10127812002,1012781
3150,14/06/2021,3433,85,2648,502,785,08/06/2021,"Chateau Angelus Premier Grand Cru Classe A, Saint-Emilion Grand Cru",Bordeaux,2018,15/06/2021,10060452018,1006045
895,06/08/2021,955,8,781,114,174,16/11/2020,"Chateau Calon Segur 3eme Cru Classe, Saint-Estephe",Bordeaux,2008,08/08/2021,10074752008,1007475
3800,06/08/2021,4535,56,3525,275,1010,18/06/2021,"Chateau Margaux Premier Cru Classe, Margaux",Bordeaux,2007,08/08/2021,10127812007,1012781
895,06/08/2021,965,52,863,32,102,10/05/2021,"Chateau Calon Segur 3eme Cru Classe, Saint-Estephe",Bordeaux,2006,08/08/2021,10074752006,1007475
3150,11/06/2021,3433,85,2648,502,785,08/06/2021,"Chateau Angelus Premier Grand Cru Classe A, Saint-Emilion Grand Cru",Bordeaux,2018,12/06/2021,10060452018,1006045
525,06/08/2021,595,397,494,31,101,20/04/2021,"Chateau Batailley 5eme Cru Classe, Pauillac",Bordeaux,2010,07/08/2021,10063222010,1006322
3150,10/06/2021,3432,86,2648,502,784,08/06/2021,"Chateau Angelus Premier Grand Cru Classe A, Saint-Emilion Grand Cru",Bordeaux,2018,11/06/2021,10060452018,1006045
3150,09/06/2021,3434,87,2648,502,786,08/06/2021,"Chateau Angelus Premier Grand Cru Classe A, Saint-Emilion Grand Cru",Bordeaux,2018,10/06/2021,10060452018,1006045
3860,09/08/2021,4614,217,3950,-90,664,30/06/2021,"Chateau Margaux Premier Cru Classe, Margaux",Bordeaux,2017,10/08/2021,10127812017,1012781
980,09/08/2021,1177,10,910,70,267,04/08/2021,"Tignanello, Toscana",Tuscany,2012,10/08/2021,10953912012,1095391
3150,08/06/2021,3434,87,2648,502,786,08/06/2021,"Chateau Angelus Premier Grand Cru Classe A, Saint-Emilion Grand Cru",Bordeaux,2018,09/06/2021,10060452018,1006045
1250,09/08/2021,1416,60,1220,30,196,14/07/2021,"Tignanello, Toscana",Tuscany,2016,10/08/2021,10953912016,1095391
14520,09/08/2021,14520,1,12000,2520,2520,28/05/2020,"Jacques-Frederic Mugnier, Chambolle-Musigny Premier Cru, Les Amoureuses",Burgundy,2014,10/08/2021,10496422014,1049642
3900,09/08/2021,4644,97,3822,78,822,20/06/2021,"Chateau Margaux Premier Cru Classe, Margaux",Bordeaux,2006,10/08/2021,10127812006,1012781
400,06/08/2021,414,7,408,-8,6,14/07/2021,"Chateau Batailley 5eme Cru Classe, Pauillac",Bordeaux,2012,08/08/2021,10063222012,1006322
895,09/08/2021,963,53,863,32,100,10/05/2021,"Chateau Calon Segur 3eme Cru Classe, Saint-Estephe",Bordeaux,2006,10/08/2021,10074752006,1007475
790,09/08/2021,870,15,801,-11,69,31/05/2021,"Chateau Calon Segur 3eme Cru Classe, Saint-Estephe",Bordeaux,2014,10/08/2021,10074752014,1007475
850,09/08/2021,1072,62,908,-58,164,04/08/2021,"Tignanello, Toscana",Tuscany,2017,10/08/2021,10953912017,1095391
1800,09/07/2021,2400,1,1440,360,960,04/01/2018,"Gaja, Barbaresco",Piedmont,2010,10/08/2021,10996052010,1099605
1350,09/08/2021,1480,55,1260,90,220,18/02/2021,"Gaja, Barbaresco",Piedmont,2015,10/08/2021,10996052015,1099605
4450,09/08/2021,4734,16,4400,50,334,29/09/2020,"Chateau Margaux Premier Cru Classe, Margaux",Bordeaux,2001,10/08/2021,10127812001,1012781
3030,28/05/2021,3412,102,2632,398,780,18/05/2021,"Chateau Angelus Premier Grand Cru Classe A, Saint-Emilion Grand Cru",Bordeaux,2018,31/05/2021,10060452018,1006045
1480,05/08/2021,1627,61,1398,82,229,01/07/2021,"Gaja, Barbaresco",Piedmont,2017,10/08/2021,10996052017,1099605
820,09/08/2021,913,5,735,85,178,09/09/2020,"Chateau Calon Segur 3eme Cru Classe, Saint-Estephe",Bordeaux,2012,10/08/2021,10074752012,1007475
400,06/08/2021,414,7,408,-8,6,14/07/2021,"Chateau Batailley 5eme Cru Classe, Pauillac",Bordeaux,2012,08/08/2021,10063222012,1006322
1400,09/08/2021,1424,8,1360,40,64,18/07/2021,"Gaja, Barbaresco",Piedmont,2013,10/08/2021,10996052013,1099605
660,09/08/2021,727,5,390,270,337,18/08/2017,"Tua Rita, Giusto di Notri, Toscana",Tuscany,2006,10/08/2021,11058072006,1105807
7800,04/08/2021,8982,2,6974,826,2008,14/03/2021,"Domaine Leflaive, Chevalier-Montrachet Grand Cru",Burgundy,2017,10/08/2021,10734012017,1073401
3030,28/05/2021,3416,103,2632,398,784,18/05/2021,"Chateau Angelus Premier Grand Cru Classe A, Saint-Emilion Grand Cru",Bordeaux,2018,08/06/2021,10060452018,1006045
400,06/08/2021,408,8,408,-8,0,14/07/2021,"Chateau Batailley 5eme Cru Classe, Pauillac",Bordeaux,2012,07/08/2021,10063222012,1006322
8400,09/08/2021,8400,1,5960,2440,2440,01/08/2017,"Domaine Leflaive, Chevalier-Montrachet Grand Cru",Burgundy,2010,10/08/2021,10734012010,1073401
5800,09/06/2021,6815,0,4400,1400,2415,06/11/2017,"Domaine Leflaive, Chevalier-Montrachet Grand Cru",Burgundy,2013,10/08/2021,10734012013,1073401
2199,09/08/2021,2153,1,1340,859,813,13/03/2020,"Gaja, Barbaresco",Piedmont,2009,10/08/2021,10996052009,1099605
400,06/08/2021,408,8,408,-8,0,14/07/2021,"Chateau Batailley 5eme Cru Classe, Pauillac",Bordeaux,2012,07/08/2021,10063222012,1006322
3030,28/05/2021,3419,102,2632,398,787,18/05/2021,"Chateau Angelus Premier Grand Cru Classe A, Saint-Emilion Grand Cru",Bordeaux,2018,04/06/2021,10060452018,1006045
320,06/08/2021,320,103,304,16,16,10/01/2021,"Chateau Batailley 5eme Cru Classe, Pauillac",Bordeaux,2013,07/08/2021,10063222013,1006322
1050,09/08/2021,1103,7,1160,-110,-57,09/08/2021,"Tignanello, Toscana",Tuscany,2014,10/08/2021,10953912014,1095391
750,09/08/2021,950,47,790,-40,160,01/06/2020,"Chateau Calon Segur 3eme Cru Classe, Saint-Estephe",Bordeaux,2011,10/08/2021,10074752011,1007475
3030,28/05/2021,3413,103,2632,398,781,18/05/2021,"Chateau Angelus Premier Grand Cru Classe A, Saint-Emilion Grand Cru",Bordeaux,2018,03/06/2021,10060452018,1006045
3800,09/08/2021,4544,54,3525,275,1019,18/06/2021,"Chateau Margaux Premier Cru Classe, Margaux",Bordeaux,2007,10/08/2021,10127812007,1012781
9000,09/08/2021,9000,1,5400,3600,3600,13/08/2020,"Domaine Leflaive, Chevalier-Montrachet Grand Cru",Burgundy,2008,10/08/2021,10734012008,1073401
880,09/08/2021,967,9,725,155,242,13/04/2021,"Chateau Calon Segur 3eme Cru Classe, Saint-Estephe",Bordeaux,2007,10/08/2021,10074752007,1007475
3030,28/05/2021,3410,103,2632,398,778,18/05/2021,"Chateau Angelus Premier Grand Cru Classe A, Saint-Emilion Grand Cru",Bordeaux,2018,29/05/2021,10060452018,1006045
920,09/08/2021,1014,13,842,78,172,22/08/2020,"Chateau Calon Segur 3eme Cru Classe, Saint-Estephe",Bordeaux,2019,10/08/2021,10074752019,1007475
360,06/08/2021,372,70,360,0,12,14/07/2021,"Chateau Batailley 5eme Cru Classe, Pauillac",Bordeaux,2014,07/08/2021,10063222014,1006322
1584,09/08/2021,1670,4,1378,206,292,29/07/2020,"Tignanello, Toscana",Tuscany,2001,10/08/2021,10953912001,1095391
415,06/08/2021,538,29,364,51,174,12/05/2021,"Chateau Batailley 5eme Cru Classe, Pauillac",Bordeaux,2016,07/08/2021,10063222016,1006322
8252,09/08/2021,10029,3,7290,962,2739,21/08/2020,"Domaine Denis Mortet, Chambertin Grand Cru",Burgundy,2017,10/08/2021,10490202017,1049020
1624,09/08/2021,1748,18,1584,40,164,06/08/2021,"Gaja, Barbaresco",Piedmont,2018,10/08/2021,10996052018,1099605
995,09/08/2021,1113,18,993,2,120,27/07/2021,"Chateau Calon Segur 3eme Cru Classe, Saint-Estephe",Bordeaux,2010,10/08/2021,10074752010,1007475
354,06/08/2021,407,35,357,-3,50,06/05/2021,"Chateau Batailley 5eme Cru Classe, Pauillac",Bordeaux,2018,10/08/2021,10063222018,1006322
3140,25/05/2021,3390,94,2632,508,758,18/05/2021,"Chateau Angelus Premier Grand Cru Classe A, Saint-Emilion Grand Cru",Bordeaux,2018,26/05/2021,10060452018,1006045
996,09/08/2021,1282,36,1026,-30,256,24/06/2021,"Chateau Calon Segur 3eme Cru Classe, Saint-Estephe",Bordeaux,2009,10/08/2021,10074752009,1007475
1180,09/08/2021,1331,4,1140,40,191,21/07/2021,"Tignanello, Toscana",Tuscany,2009,10/08/2021,10953912009,1095391
1020,09/08/2021,1213,45,1058,-38,155,14/07/2021,"Chateau Calon Segur 3eme Cru Classe, Saint-Estephe",Bordeaux,2018,10/08/2021,10074752018,1007475
354,06/08/2021,407,27,357,-3,50,06/05/2021,"Chateau Batailley 5eme Cru Classe, Pauillac",Bordeaux,2018,07/08/2021,10063222018,1006322
907,09/08/2021,953,23,805,102,148,20/11/2019,"Chateau Calon Segur 3eme Cru Classe, Saint-Estephe",Bordeaux,2001,10/08/2021,10074752001,1007475
3140,25/05/2021,3419,101,2632,508,787,18/05/2021,"Chateau Angelus Premier Grand Cru Classe A, Saint-Emilion Grand Cru",Bordeaux,2018,28/05/2021,10060452018,1006045
990,09/08/2021,1177,63,1029,-39,148,21/07/2021,"Chateau Calon Segur 3eme Cru Classe, Saint-Estephe",Bordeaux,2005,10/08/2021,10074752005,1007475
3150,24/05/2021,3390,95,2632,518,758,18/05/2021,"Chateau Angelus Premier Grand Cru Classe A, Saint-Emilion Grand Cru",Bordeaux,2018,25/05/2021,10060452018,1006045
6500,09/08/2021,7537,24,6400,100,1137,22/07/2021,"Chateau Margaux Premier Cru Classe, Margaux",Bordeaux,2005,10/08/2021,10127812005,1012781
3150,21/05/2021,3384,114,2632,518,752,18/05/2021,"Chateau Angelus Premier Grand Cru Classe A, Saint-Emilion Grand Cru",Bordeaux,2018,24/05/2021,10060452018,1006045
10620,09/08/2021,12019,47,9800,820,2219,11/06/2021,"Chateau Margaux Premier Cru Classe, Margaux",Bordeaux,2015,10/08/2021,10127812015,1012781
1100,09/08/2021,1220,70,1036,64,184,27/05/2021,"Chateau Calon Segur 3eme Cru Classe, Saint-Estephe",Bordeaux,2016,10/08/2021,10074752016,1007475
8000,09/08/2021,7972,1,7900,100,72,29/04/2019,"Domaine Leflaive, Chevalier-Montrachet Grand Cru",Burgundy,2015,10/08/2021,10734012015,1073401
895,09/08/2021,955,8,781,114,174,16/11/2020,"Chateau Calon Segur 3eme Cru Classe, Saint-Estephe",Bordeaux,2008,10/08/2021,10074752008,1007475
5900,09/08/2021,5272,9,4160,1740,1112,19/03/2021,"Chateau Margaux Premier Cru Classe, Margaux",Bordeaux,2019,10/08/2021,10127812019,1012781
1090,09/08/2021,1136,8,952,138,184,04/08/2021,"Tignanello, Toscana",Tuscany,2013,10/08/2021,10953912013,1095391
3935,09/08/2021,4659,40,4116,-181,543,25/02/2021,"Chateau Margaux Premier Cru Classe, Margaux",Bordeaux,2004,10/08/2021,10127812004,1012781
3150,21/05/2021,3388,116,2632,518,756,18/05/2021,"Chateau Angelus Premier Grand Cru Classe A, Saint-Emilion Grand Cru",Bordeaux,2018,22/05/2021,10060452018,1006045
685,09/08/2021,685,3,470,215,215,29/03/2018,"Chateau Batailley 5eme Cru Classe, Pauillac",Bordeaux,2000,10/08/2021,10063222000,1006322
940,09/08/2021,1076,76,866,74,210,20/07/2021,"Chateau Calon Segur 3eme Cru Classe, Saint-Estephe",Bordeaux,2015,10/08/2021,10074752015,1007475
3900,09/08/2021,4446,23,3684,216,762,10/06/2020,"Chateau Margaux Premier Cru Classe, Margaux",Bordeaux,2002,10/08/2021,10127812002,1012781
6400,09/08/2021,6400,1,4500,1900,1900,08/04/2015,"Domaine Leflaive, Chevalier-Montrachet Grand Cru",Burgundy,2012,10/08/2021,10734012012,1073401
3950,09/08/2021,4468,108,3780,170,688,23/07/2021,"Chateau Margaux Premier Cru Classe, Margaux",Bordeaux,2008,10/08/2021,10127812008,1012781
5100,09/08/2021,5703,19,4650,450,1053,21/06/2021,"Chateau Margaux Premier Cru Classe, Margaux",Bordeaux,2003,10/08/2021,10127812003,1012781
685,09/08/2021,685,3,470,215,215,29/03/2018,"Chateau Batailley 5eme Cru Classe, Pauillac",Bordeaux,2000,10/08/2021,10063222000,1006322
1550,09/08/2021,1550,1,1300,250,250,27/04/2021,"Gaja, Barbaresco",Piedmont,2012,10/08/2021,10996052012,1099605
840,09/08/2021,1050,21,745,95,305,16/11/2020,"Chateau Calon Segur 3eme Cru Classe, Saint-Estephe",Bordeaux,2004,10/08/2021,10074752004,1007475
450,09/08/2021,532,2,300,150,232,15/12/2019,"Chateau Batailley 5eme Cru Classe, Pauillac",Bordeaux,2004,10/08/2021,10063222004,1006322
900,09/08/2021,1099,24,800,100,299,21/11/2019,"Chateau Calon Segur 3eme Cru Classe, Saint-Estephe",Bordeaux,2003,10/08/2021,10074752003,1007475
3150,20/05/2021,3388,116,2632,518,756,18/05/2021,"Chateau Angelus Premier Grand Cru Classe A, Saint-Emilion Grand Cru",Bordeaux,2018,21/05/2021,10060452018,1006045
588,09/08/2021,627,49,520,68,107,17/06/2021,"Chateau Batailley 5eme Cru Classe, Pauillac",Bordeaux,2005,11/08/2021,10063222005,1006322
800,09/08/2021,772,24,682,118,90,15/09/2020,"Chateau Calon Segur 3eme Cru Classe, Saint-Estephe",Bordeaux,2013,10/08/2021,10074752013,1007475
3100,18/05/2021,3374,118,2632,468,742,18/05/2021,"Chateau Angelus Premier Grand Cru Classe A, Saint-Emilion Grand Cru",Bordeaux,2018,19/05/2021,10060452018,1006045
1408,06/07/2021,1548,0,996,412,552,14/06/2019,"Tignanello, Toscana",Tuscany,2000,10/08/2021,10953912000,1095391
1440,09/08/2021,1684,31,1510,-70,174,18/07/2021,"Gaja, Barbaresco",Piedmont,2016,10/08/2021,10996052016,1099605
5600,09/08/2021,6014,50,5254,346,760,26/05/2021,"Chateau Margaux Premier Cru Classe, Margaux",Bordeaux,2018,10/08/2021,10127812018,1012781
520,09/08/2021,571,3,460,60,111,05/05/2020,"Tua Rita, Giusto di Notri, Toscana",Tuscany,2008,10/08/2021,11058072008,1105807
3900,09/08/2021,4229,46,3690,210,539,13/04/2021,"Chateau Margaux Premier Cru Classe, Margaux",Bordeaux,2011,10/08/2021,10127812011,1012781
6400,09/08/2021,7608,61,6188,212,1420,16/07/2021,"Chateau Margaux Premier Cru Classe, Margaux",Bordeaux,2010,10/08/2021,10127812010,1012781
990,09/08/2021,1132,10,880,110,252,22/06/2021,"Tignanello, Toscana",Tuscany,2011,10/08/2021,10953912011,1095391
475,06/08/2021,595,23,388,87,207,29/09/2020,"Tua Rita, Giusto di Notri, Toscana",Tuscany,2015,10/08/2021,11058072015,1105807
8300,09/08/2021,9314,18,8200,100,1114,26/07/2021,"Chateau Margaux Premier Cru Classe, Margaux",Bordeaux,2000,10/08/2021,10127812000,1012781
780,09/08/2021,938,100,740,40,198,21/05/2021,"Chateau Calon Segur 3eme Cru Classe, Saint-Estephe",Bordeaux,2017,10/08/2021,10074752017,1007475
3100,17/05/2021,3377,118,2866,234,511,22/03/2021,"Chateau Angelus Premier Grand Cru Classe A, Saint-Emilion Grand Cru",Bordeaux,2018,18/05/2021,10060452018,1006045
6930,09/08/2021,7721,59,7086,-156,635,11/06/2021,"Chateau Margaux Premier Cru Classe, Margaux",Bordeaux,2009,10/08/2021,10127812009,1012781
8568,09/08/2021,8801,3,7330,1238,1471,02/06/2021,"Domaine Leflaive, Chevalier-Montrachet Grand Cru",Burgundy,2018,10/08/2021,10734012018,1073401
1573,04/08/2021,1677,7,1300,273,377,10/07/2021,"Gaja, Barbaresco",Piedmont,2014,10/08/2021,10996052014,1099605
870,09/08/2021,950,10,705,165,245,01/02/2021,"Chateau Calon Segur 3eme Cru Classe, Saint-Estephe",Bordeaux,2002,10/08/2021,10074752002,1007475
3800,09/08/2021,4350,134,3600,200,750,02/08/2021,"Chateau Margaux Premier Cru Classe, Margaux",Bordeaux,2014,10/08/2021,10127812014,1012781
3700,09/08/2021,4177,57,3520,180,657,07/04/2021,"Chateau Margaux Premier Cru Classe, Margaux",Bordeaux,2013,10/08/2021,10127812013,1012781
1326,09/08/2021,1406,5,1170,156,236,24/06/2021,"Tignanello, Toscana",Tuscany,2010,10/08/2021,10953912010,1095391
1400,10/08/2021,1424,8,1360,40,64,18/07/2021,"Gaja, Barbaresco",Piedmont,2013,11/08/2021,10996052013,1099605
840,10/08/2021,1050,21,745,95,305,16/11/2020,"Chateau Calon Segur 3eme Cru Classe, Saint-Estephe",Bordeaux,2004,11/08/2021,10074752004,1007475
980,09/08/2021,1177,10,910,70,267,04/08/2021,"Tignanello, Toscana",Tuscany,2012,10/08/2021,10953912012,1095391
1900,10/08/2021,2336,4,2190,-290,146,01/05/2021,"Gaja, Barbaresco",Piedmont,2004,11/08/2021,10996052004,1099605
880,10/08/2021,967,9,725,155,242,13/04/2021,"Chateau Calon Segur 3eme Cru Classe, Saint-Estephe",Bordeaux,2007,11/08/2021,10074752007,1007475
996,09/08/2021,1283,36,1026,-30,257,24/06/2021,"Chateau Calon Segur 3eme Cru Classe, Saint-Estephe",Bordeaux,2009,11/08/2021,10074752009,1007475
3100,14/05/2021,3374,118,2866,234,508,22/03/2021,"Chateau Angelus Premier Grand Cru Classe A, Saint-Emilion Grand Cru",Bordeaux,2018,15/05/2021,10060452018,1006045
3100,13/05/2021,3374,118,2866,234,508,22/03/2021,"Chateau Angelus Premier Grand Cru Classe A, Saint-Emilion Grand Cru",Bordeaux,2018,14/05/2021,10060452018,1006045
6930,10/08/2021,7721,59,7086,-156,635,11/06/2021,"Chateau Margaux Premier Cru Classe, Margaux",Bordeaux,2009,11/08/2021,10127812009,1012781
3900,10/08/2021,4229,46,3690,210,539,13/04/2021,"Chateau Margaux Premier Cru Classe, Margaux",Bordeaux,2011,11/08/2021,10127812011,1012781
1090,10/08/2021,1143,8,952,138,191,04/08/2021,"Tignanello, Toscana",Tuscany,2013,11/08/2021,10953912013,1095391
895,10/08/2021,963,53,863,32,100,10/05/2021,"Chateau Calon Segur 3eme Cru Classe, Saint-Estephe",Bordeaux,2006,11/08/2021,10074752006,1007475
840,10/08/2021,1050,21,745,95,305,16/11/2020,"Chateau Calon Segur 3eme Cru Classe, Saint-Estephe",Bordeaux,2004,11/08/2021,10074752004,1007475
3100,12/05/2021,3376,109,2866,234,510,22/03/2021,"Chateau Angelus Premier Grand Cru Classe A, Saint-Emilion Grand Cru",Bordeaux,2018,13/05/2021,10060452018,1006045
895,10/08/2021,949,9,781,114,168,16/11/2020,"Chateau Calon Segur 3eme Cru Classe, Saint-Estephe",Bordeaux,2008,11/08/2021,10074752008,1007475
870,10/08/2021,950,10,705,165,245,01/02/2021,"Chateau Calon Segur 3eme Cru Classe, Saint-Estephe",Bordeaux,2002,11/08/2021,10074752002,1007475
588,09/08/2021,626,49,520,68,106,17/06/2021,"Chateau Batailley 5eme Cru Classe, Pauillac",Bordeaux,2005,10/08/2021,10063222005,1006322
3100,11/05/2021,3375,110,2866,234,509,22/03/2021,"Chateau Angelus Premier Grand Cru Classe A, Saint-Emilion Grand Cru",Bordeaux,2018,12/05/2021,10060452018,1006045
3935,09/08/2021,4659,40,3790,145,869,10/08/2021,"Chateau Margaux Premier Cru Classe, Margaux",Bordeaux,2004,11/08/2021,10127812004,1012781
3900,10/08/2021,4644,97,3822,78,822,20/06/2021,"Chateau Margaux Premier Cru Classe, Margaux",Bordeaux,2006,11/08/2021,10127812006,1012781
820,10/08/2021,913,5,735,85,178,09/09/2020,"Chateau Calon Segur 3eme Cru Classe, Saint-Estephe",Bordeaux,2012,11/08/2021,10074752012,1007475
3100,10/05/2021,3379,89,2866,234,513,22/03/2021,"Chateau Angelus Premier Grand Cru Classe A, Saint-Emilion Grand Cru",Bordeaux,2018,11/05/2021,10060452018,1006045
6400,10/08/2021,7608,61,6188,212,1420,16/07/2021,"Chateau Margaux Premier Cru Classe, Margaux",Bordeaux,2010,11/08/2021,10127812010,1012781
3700,10/08/2021,4184,57,3520,180,664,07/04/2021,"Chateau Margaux Premier Cru Classe, Margaux",Bordeaux,2013,11/08/2021,10127812013,1012781
3100,07/05/2021,3377,88,2866,234,511,22/03/2021,"Chateau Angelus Premier Grand Cru Classe A, Saint-Emilion Grand Cru",Bordeaux,2018,10/05/2021,10060452018,1006045
6500,09/08/2021,7497,25,6400,100,1097,22/07/2021,"Chateau Margaux Premier Cru Classe, Margaux",Bordeaux,2005,11/08/2021,10127812005,1012781
940,10/08/2021,1076,76,866,74,210,20/07/2021,"Chateau Calon Segur 3eme Cru Classe, Saint-Estephe",Bordeaux,2015,11/08/2021,10074752015,1007475
1008,05/08/2021,1177,73,1042,-34,135,06/08/2021,"Tignanello, Toscana",Tuscany,2018,07/08/2021,10953912018,1095391
588,09/08/2021,627,49,520,68,107,17/06/2021,"Chateau Batailley 5eme Cru Classe, Pauillac",Bordeaux,2005,11/08/2021,10063222005,1006322
6500,06/08/2021,7571,28,6400,100,1171,22/07/2021,"Chateau Margaux Premier Cru Classe, Margaux",Bordeaux,2005,07/08/2021,10127812005,1012781
1408,06/07/2021,1729,2,1150,258,579,21/04/2019,"Tignanello, Toscana",Tuscany,2005,07/08/2021,10953912005,1095391
5290,05/08/2021,5272,9,4160,1130,1112,19/03/2021,"Chateau Margaux Premier Cru Classe, Margaux",Bordeaux,2019,07/08/2021,10127812019,1012781
588,09/08/2021,626,49,520,68,106,17/06/2021,"Chateau Batailley 5eme Cru Classe, Pauillac",Bordeaux,2005,10/08/2021,10063222005,1006322
1900,06/08/2021,2336,4,2190,-290,146,01/05/2021,"Gaja, Barbaresco",Piedmont,2004,07/08/2021,10996052004,1099605
3100,07/05/2021,3379,89,2866,234,513,22/03/2021,"Chateau Angelus Premier Grand Cru Classe A, Saint-Emilion Grand Cru",Bordeaux,2018,08/05/2021,10060452018,1006045
3900,06/08/2021,4639,96,3822,78,817,20/06/2021,"Chateau Margaux Premier Cru Classe, Margaux",Bordeaux,2006,07/08/2021,10127812006,1012781
990,06/08/2021,1177,63,1029,-39,148,21/07/2021,"Chateau Calon Segur 3eme Cru Classe, Saint-Estephe",Bordeaux,2005,07/08/2021,10074752005,1007475
3100,06/05/2021,3389,112,2866,234,523,22/03/2021,"Chateau Angelus Premier Grand Cru Classe A, Saint-Emilion Grand Cru",Bordeaux,2018,07/05/2021,10060452018,1006045
5100,06/08/2021,5703,19,4650,450,1053,21/06/2021,"Chateau Margaux Premier Cru Classe, Margaux",Bordeaux,2003,07/08/2021,10127812003,1012781
686,06/08/2021,773,23,682,4,91,15/09/2020,"Chateau Calon Segur 3eme Cru Classe, Saint-Estephe",Bordeaux,2013,07/08/2021,10074752013,1007475
1090,06/08/2021,1136,8,952,138,184,04/08/2021,"Tignanello, Toscana",Tuscany,2013,07/08/2021,10953912013,1095391
8300,06/08/2021,9337,17,8200,100,1137,26/07/2021,"Chateau Margaux Premier Cru Classe, Margaux",Bordeaux,2000,07/08/2021,10127812000,1012781
465,09/08/2021,458,2,400,65,58,11/05/2021,"Chateau Batailley 5eme Cru Classe, Pauillac",Bordeaux,2006,10/08/2021,10063222006,1006322
465,09/08/2021,458,2,400,65,58,11/05/2021,"Chateau Batailley 5eme Cru Classe, Pauillac",Bordeaux,2006,10/08/2021,10063222006,1006322
1380,06/08/2021,1445,4,1352,28,93,23/09/2020,"Gaja, Barbaresco",Piedmont,2011,07/08/2021,10996052011,1099605
6400,06/08/2021,7592,63,6188,212,1404,16/07/2021,"Chateau Margaux Premier Cru Classe, Margaux",Bordeaux,2010,07/08/2021,10127812010,1012781
3800,06/08/2021,4346,129,3600,200,746,02/08/2021,"Chateau Margaux Premier Cru Classe, Margaux",Bordeaux,2014,07/08/2021,10127812014,1012781
3140,06/05/2021,3388,116,2632,508,756,18/05/2021,"Chateau Angelus Premier Grand Cru Classe A, Saint-Emilion Grand Cru",Bordeaux,2018,20/05/2021,10060452018,1006045
1680,06/08/2021,1693,2,1420,260,273,29/06/2021,"Tignanello, Toscana",Tuscany,2004,07/08/2021,10953912004,1095391
10800,06/08/2021,10860,2,8000,2800,2860,30/01/2020,"Domaine Leflaive, Chevalier-Montrachet Grand Cru",Burgundy,2014,07/08/2021,10734012014,1073401
1350,06/08/2021,1480,55,1260,90,220,18/02/2021,"Gaja, Barbaresco",Piedmont,2015,07/08/2021,10996052015,1099605
1100,06/08/2021,1219,71,1036,64,183,27/05/2021,"Chateau Calon Segur 3eme Cru Classe, Saint-Estephe",Bordeaux,2016,07/08/2021,10074752016,1007475
907,06/08/2021,953,23,805,102,148,20/11/2019,"Chateau Calon Segur 3eme Cru Classe, Saint-Estephe",Bordeaux,2001,07/08/2021,10074752001,1007475
840,06/08/2021,1050,21,745,95,305,16/11/2020,"Chateau Calon Segur 3eme Cru Classe, Saint-Estephe",Bordeaux,2004,07/08/2021,10074752004,1007475
14520,06/08/2021,14520,1,12000,2520,2520,28/05/2020,"Jacques-Frederic Mugnier, Chambolle-Musigny Premier Cru, Les Amoureuses",Burgundy,2014,07/08/2021,10496422014,1049642
880,06/08/2021,967,9,725,155,242,13/04/2021,"Chateau Calon Segur 3eme Cru Classe, Saint-Estephe",Bordeaux,2007,07/08/2021,10074752007,1007475
9000,06/08/2021,9000,1,5400,3600,3600,13/08/2020,"Domaine Leflaive, Chevalier-Montrachet Grand Cru",Burgundy,2008,07/08/2021,10734012008,1073401
990,06/08/2021,1119,10,880,110,239,22/06/2021,"Tignanello, Toscana",Tuscany,2011,07/08/2021,10953912011,1095391
1130,04/08/2021,1288,14,1012,118,276,02/07/2021,"Tignanello, Toscana",Tuscany,2015,07/08/2021,10953912015,1095391
1080,06/08/2021,1217,45,1058,22,159,14/07/2021,"Chateau Calon Segur 3eme Cru Classe, Saint-Estephe",Bordeaux,2018,07/08/2021,10074752018,1007475
1299,06/07/2021,1695,4,1150,149,545,27/07/2021,"Tignanello, Toscana",Tuscany,2008,07/08/2021,10953912008,1095391
450,09/08/2021,446,2,332,118,114,06/10/2020,"Chateau Batailley 5eme Cru Classe, Pauillac",Bordeaux,2008,10/08/2021,10063222008,1006322
3100,05/05/2021,3390,112,2866,234,524,22/03/2021,"Chateau Angelus Premier Grand Cru Classe A, Saint-Emilion Grand Cru",Bordeaux,2018,06/05/2021,10060452018,1006045
3100,04/05/2021,3386,112,2866,234,520,22/03/2021,"Chateau Angelus Premier Grand Cru Classe A, Saint-Emilion Grand Cru",Bordeaux,2018,05/05/2021,10060452018,1006045
500,09/08/2021,548,4,450,50,98,25/05/2021,"Chateau Batailley 5eme Cru Classe, Pauillac",Bordeaux,2009,10/08/2021,10063222009,1006322
8000,06/08/2021,7972,1,7900,100,72,29/04/2019,"Domaine Leflaive, Chevalier-Montrachet Grand Cru",Burgundy,2015,07/08/2021,10734012015,1073401
940,06/08/2021,1074,77,866,74,208,20/07/2021,"Chateau Calon Segur 3eme Cru Classe, Saint-Estephe",Bordeaux,2015,07/08/2021,10074752015,1007475
1440,06/08/2021,1679,31,1510,-70,169,18/07/2021,"Gaja, Barbaresco",Piedmont,2016,07/08/2021,10996052016,1099605
500,09/08/2021,548,4,450,50,98,25/05/2021,"Chateau Batailley 5eme Cru Classe, Pauillac",Bordeaux,2009,10/08/2021,10063222009,1006322
520,06/08/2021,563,3,460,60,103,05/05/2020,"Tua Rita, Giusto di Notri, Toscana",Tuscany,2008,07/08/2021,11058072008,1105807
5415,30/07/2021,5878,140,5500,-85,378,06/07/2021,"Chateau Margaux Premier Cru Classe, Margaux",Bordeaux,2016,07/08/2021,10127812016,1012781
3100,03/05/2021,3434,158,2866,234,568,22/03/2021,"Chateau Angelus Premier Grand Cru Classe A, Saint-Emilion Grand Cru",Bordeaux,2018,04/05/2021,10060452018,1006045
3750,05/08/2021,4330,53,3650,100,680,27/07/2021,"Chateau Margaux Premier Cru Classe, Margaux",Bordeaux,2012,07/08/2021,10127812012,1012781
790,06/08/2021,868,17,801,-11,67,31/05/2021,"Chateau Calon Segur 3eme Cru Classe, Saint-Estephe",Bordeaux,2014,07/08/2021,10074752014,1007475
475,06/08/2021,592,25,388,87,204,29/09/2020,"Tua Rita, Giusto di Notri, Toscana",Tuscany,2015,07/08/2021,11058072015,1105807
1550,06/08/2021,1550,1,1300,250,250,27/04/2021,"Gaja, Barbaresco",Piedmont,2012,07/08/2021,10996052012,1099605
8568,06/08/2021,8730,4,7330,1238,1400,02/06/2021,"Domaine Leflaive, Chevalier-Montrachet Grand Cru",Burgundy,2018,07/08/2021,10734012018,1073401
980,06/08/2021,1164,11,910,70,254,04/08/2021,"Tignanello, Toscana",Tuscany,2012,07/08/2021,10953912012,1095391
5600,06/08/2021,6014,50,5254,346,760,26/05/2021,"Chateau Margaux Premier Cru Classe, Margaux",Bordeaux,2018,07/08/2021,10127812018,1012781
3840,06/08/2021,4615,219,3950,-110,665,30/06/2021,"Chateau Margaux Premier Cru Classe, Margaux",Bordeaux,2017,07/08/2021,10127812017,1012781
525,09/08/2021,595,397,494,31,101,20/04/2021,"Chateau Batailley 5eme Cru Classe, Pauillac",Bordeaux,2010,10/08/2021,10063222010,1006322
1030,06/08/2021,1101,7,854,176,247,15/07/2021,"Tignanello, Toscana",Tuscany,2014,07/08/2021,10953912014,1095391
2761,28/07/2021,2824,38,2402,359,422,27/11/2020,"Chateau Angelus Premier Grand Cru Classe A, Saint-Emilion Grand Cru",Bordeaux,2019,29/07/2021,10060452019,1006045
1624,06/08/2021,1748,18,1584,40,164,06/08/2021,"Gaja, Barbaresco",Piedmont,2018,07/08/2021,10996052018,1099605
4450,06/08/2021,4734,16,4400,50,334,29/09/2020,"Chateau Margaux Premier Cru Classe, Margaux",Bordeaux,2001,07/08/2021,10127812001,1012781
2761,28/07/2021,2816,35,2402,359,414,27/11/2020,"Chateau Angelus Premier Grand Cru Classe A, Saint-Emilion Grand Cru",Bordeaux,2019,09/08/2021,10060452019,1006045
995,06/08/2021,1113,18,993,2,120,27/07/2021,"Chateau Calon Segur 3eme Cru Classe, Saint-Estephe",Bordeaux,2010,07/08/2021,10074752010,1007475
750,06/08/2021,950,47,790,-40,160,01/06/2020,"Chateau Calon Segur 3eme Cru Classe, Saint-Estephe",Bordeaux,2011,07/08/2021,10074752011,1007475
1180,06/08/2021,1331,4,1140,40,191,21/07/2021,"Tignanello, Toscana",Tuscany,2009,07/08/2021,10953912009,1095391
895,06/08/2021,966,53,863,32,103,10/05/2021,"Chateau Calon Segur 3eme Cru Classe, Saint-Estephe",Bordeaux,2006,07/08/2021,10074752006,1007475
10620,06/08/2021,11970,49,9800,820,2170,11/06/2021,"Chateau Margaux Premier Cru Classe, Margaux",Bordeaux,2015,07/08/2021,10127812015,1012781
3800,06/08/2021,4527,57,3525,275,1002,18/06/2021,"Chateau Margaux Premier Cru Classe, Margaux",Bordeaux,2007,07/08/2021,10127812007,1012781
3700,06/08/2021,4167,47,3520,180,647,07/04/2021,"Chateau Margaux Premier Cru Classe, Margaux",Bordeaux,2013,07/08/2021,10127812013,1012781
525,09/08/2021,595,397,494,31,101,20/04/2021,"Chateau Batailley 5eme Cru Classe, Pauillac",Bordeaux,2010,10/08/2021,10063222010,1006322
660,06/08/2021,727,5,390,270,337,18/08/2017,"Tua Rita, Giusto di Notri, Toscana",Tuscany,2006,07/08/2021,11058072006,1105807
400,09/08/2021,414,7,408,-8,6,14/07/2021,"Chateau Batailley 5eme Cru Classe, Pauillac",Bordeaux,2012,10/08/2021,10063222012,1006322
6600,15/07/2021,6600,1,5360,1240,1240,18/09/2020,"Domaine Leflaive, Chevalier-Montrachet Grand Cru",Burgundy,2009,07/08/2021,10734012009,1073401
920,06/08/2021,1014,13,842,78,172,22/08/2020,"Chateau Calon Segur 3eme Cru Classe, Saint-Estephe",Bordeaux,2019,07/08/2021,10074752019,1007475
780,06/08/2021,938,101,740,40,198,21/05/2021,"Chateau Calon Segur 3eme Cru Classe, Saint-Estephe",Bordeaux,2017,07/08/2021,10074752017,1007475
2761,28/07/2021,2819,36,2402,359,417,27/11/2020,"Chateau Angelus Premier Grand Cru Classe A, Saint-Emilion Grand Cru",Bordeaux,2019,07/08/2021,10060452019,1006045
2762,15/07/2021,2926,13,2402,360,524,27/11/2020,"Chateau Angelus Premier Grand Cru Classe A, Saint-Emilion Grand Cru",Bordeaux,2019,23/07/2021,10060452019,1006045
6930,06/08/2021,7720,70,7086,-156,634,11/06/2021,"Chateau Margaux Premier Cru Classe, Margaux",Bordeaux,2009,07/08/2021,10127812009,1012781
440,06/08/2021,588,4,342,98,246,21/08/2020,"Tua Rita, Giusto di Notri, Toscana",Tuscany,2011,07/08/2021,11058072011,1105807
820,06/08/2021,925,4,735,85,190,09/09/2020,"Chateau Calon Segur 3eme Cru Classe, Saint-Estephe",Bordeaux,2012,07/08/2021,10074752012,1007475
1400,06/08/2021,1429,9,1360,40,69,18/07/2021,"Gaja, Barbaresco",Piedmont,2013,07/08/2021,10996052013,1099605
1408,06/07/2021,1513,0,996,412,517,14/06/2019,"Tignanello, Toscana",Tuscany,2000,07/08/2021,10953912000,1095391
1300,08/07/2021,1381,3,1200,100,181,06/03/2021,"Tignanello, Toscana",Tuscany,2007,07/08/2021,10953912007,1095391
2762,15/07/2021,2933,14,2402,360,531,27/11/2020,"Chateau Angelus Premier Grand Cru Classe A, Saint-Emilion Grand Cru",Bordeaux,2019,27/07/2021,10060452019,1006045
2590,15/07/2021,2921,15,2402,188,519,27/11/2020,"Chateau Angelus Premier Grand Cru Classe A, Saint-Emilion Grand Cru",Bordeaux,2019,16/07/2021,10060452019,1006045
3935,06/08/2021,4648,43,4116,-181,532,25/02/2021,"Chateau Margaux Premier Cru Classe, Margaux",Bordeaux,2004,07/08/2021,10127812004,1012781
2762,15/07/2021,2915,16,2402,360,513,27/11/2020,"Chateau Angelus Premier Grand Cru Classe A, Saint-Emilion Grand Cru",Bordeaux,2019,17/07/2021,10060452019,1006045
1250,06/08/2021,1417,60,1220,30,197,14/07/2021,"Tignanello, Toscana",Tuscany,2016,07/08/2021,10953912016,1095391
900,06/08/2021,1099,25,800,100,299,21/11/2019,"Chateau Calon Segur 3eme Cru Classe, Saint-Estephe",Bordeaux,2003,07/08/2021,10074752003,1007475
1326,06/08/2021,1406,5,1170,156,236,24/06/2021,"Tignanello, Toscana",Tuscany,2010,07/08/2021,10953912010,1095391
3950,06/08/2021,4469,108,3780,170,689,23/07/2021,"Chateau Margaux Premier Cru Classe, Margaux",Bordeaux,2008,07/08/2021,10127812008,1012781
895,06/08/2021,950,9,781,114,169,16/11/2020,"Chateau Calon Segur 3eme Cru Classe, Saint-Estephe",Bordeaux,2008,07/08/2021,10074752008,1007475
400,09/08/2021,414,7,408,-8,6,14/07/2021,"Chateau Batailley 5eme Cru Classe, Pauillac",Bordeaux,2012,10/08/2021,10063222012,1006322
980,06/08/2021,1077,62,908,72,169,04/08/2021,"Tignanello, Toscana",Tuscany,2017,07/08/2021,10953912017,1095391
3900,06/08/2021,4442,22,3684,216,758,10/06/2020,"Chateau Margaux Premier Cru Classe, Margaux",Bordeaux,2002,07/08/2021,10127812002,1012781
320,09/08/2021,320,103,304,16,16,10/01/2021,"Chateau Batailley 5eme Cru Classe, Pauillac",Bordeaux,2013,10/08/2021,10063222013,1006322
2762,15/07/2021,2884,28,2402,360,482,27/11/2020,"Chateau Angelus Premier Grand Cru Classe A, Saint-Emilion Grand Cru",Bordeaux,2019,20/07/2021,10060452019,1006045
996,06/08/2021,1280,38,1026,-30,254,24/06/2021,"Chateau Calon Segur 3eme Cru Classe, Saint-Estephe",Bordeaux,2009,07/08/2021,10074752009,1007475
360,09/08/2021,372,70,360,0,12,14/07/2021,"Chateau Batailley 5eme Cru Classe, Pauillac",Bordeaux,2014,10/08/2021,10063222014,1006322
530,09/08/2021,546,15,312,218,234,12/03/2021,"Chateau Batailley 5eme Cru Classe, Pauillac",Bordeaux,2015,10/08/2021,10063222015,1006322
415,09/08/2021,538,29,364,51,174,12/05/2021,"Chateau Batailley 5eme Cru Classe, Pauillac",Bordeaux,2016,10/08/2021,10063222016,1006322
2820,14/07/2021,2921,15,2402,418,519,27/11/2020,"Chateau Angelus Premier Grand Cru Classe A, Saint-Emilion Grand Cru",Bordeaux,2019,15/07/2021,10060452019,1006045
2820,12/07/2021,2921,15,2402,418,519,27/11/2020,"Chateau Angelus Premier Grand Cru Classe A, Saint-Emilion Grand Cru",Bordeaux,2019,13/07/2021,10060452019,1006045
2199,06/08/2021,2153,1,1340,859,813,13/03/2020,"Gaja, Barbaresco",Piedmont,2009,07/08/2021,10996052009,1099605
3950,10/08/2021,4468,108,3780,170,688,23/07/2021,"Chateau Margaux Premier Cru Classe, Margaux",Bordeaux,2008,11/08/2021,10127812008,1012781
995,09/08/2021,1117,19,993,2,124,27/07/2021,"Chateau Calon Segur 3eme Cru Classe, Saint-Estephe",Bordeaux,2010,11/08/2021,10074752010,1007475
2820,09/07/2021,2921,15,2402,418,519,27/11/2020,"Chateau Angelus Premier Grand Cru Classe A, Saint-Emilion Grand Cru",Bordeaux,2019,10/07/2021,10060452019,1006045
4450,10/08/2021,4734,16,4400,50,334,29/09/2020,"Chateau Margaux Premier Cru Classe, Margaux",Bordeaux,2001,11/08/2021,10127812001,1012781
1100,27/05/2021,1695,4,1150,-50,545,27/07/2021,"Tignanello, Toscana",Tuscany,2008,11/08/2021,10953912008,1095391
10620,10/08/2021,12019,47,9800,820,2219,11/06/2021,"Chateau Margaux Premier Cru Classe, Margaux",Bordeaux,2015,11/08/2021,10127812015,1012781
1584,10/08/2021,1670,4,1378,206,292,29/07/2020,"Tignanello, Toscana",Tuscany,2001,11/08/2021,10953912001,1095391
5100,10/08/2021,5703,19,4650,450,1053,21/06/2021,"Chateau Margaux Premier Cru Classe, Margaux",Bordeaux,2003,11/08/2021,10127812003,1012781
990,10/08/2021,1176,64,1029,-39,147,21/07/2021,"Chateau Calon Segur 3eme Cru Classe, Saint-Estephe",Bordeaux,2005,11/08/2021,10074752005,1007475
3800,10/08/2021,4350,134,3600,200,750,02/08/2021,"Chateau Margaux Premier Cru Classe, Margaux",Bordeaux,2014,11/08/2021,10127812014,1012781
2820,07/07/2021,2919,15,2402,418,517,27/11/2020,"Chateau Angelus Premier Grand Cru Classe A, Saint-Emilion Grand Cru",Bordeaux,2019,08/07/2021,10060452019,1006045
2820,07/07/2021,2921,15,2402,418,519,27/11/2020,"Chateau Angelus Premier Grand Cru Classe A, Saint-Emilion Grand Cru",Bordeaux,2019,09/07/2021,10060452019,1006045
450,10/08/2021,532,2,300,150,232,15/12/2019,"Chateau Batailley 5eme Cru Classe, Pauillac",Bordeaux,2004,11/08/2021,10063222004,1006322
990,10/08/2021,1132,10,880,110,252,22/06/2021,"Tignanello, Toscana",Tuscany,2011,11/08/2021,10953912011,1095391
2820,05/07/2021,2915,15,2402,418,513,27/11/2020,"Chateau Angelus Premier Grand Cru Classe A, Saint-Emilion Grand Cru",Bordeaux,2019,07/07/2021,10060452019,1006045
3800,06/08/2021,4539,56,3525,275,1014,18/06/2021,"Chateau Margaux Premier Cru Classe, Margaux",Bordeaux,2007,09/08/2021,10127812007,1012781
866,05/08/2021,963,8,705,161,258,01/02/2021,"Chateau Calon Segur 3eme Cru Classe, Saint-Estephe",Bordeaux,2002,09/08/2021,10074752002,1007475
790,06/08/2021,870,15,801,-11,69,31/05/2021,"Chateau Calon Segur 3eme Cru Classe, Saint-Estephe",Bordeaux,2014,09/08/2021,10074752014,1007475
370,10/08/2021,396,6,380,-10,16,10/08/2021,"Chateau Batailley 5eme Cru Classe, Pauillac",Bordeaux,2011,11/08/2021,10063222011,1006322
940,06/08/2021,1076,76,866,74,210,20/07/2021,"Chateau Calon Segur 3eme Cru Classe, Saint-Estephe",Bordeaux,2015,09/08/2021,10074752015,1007475
10800,06/08/2021,10673,2,8000,2800,2673,30/01/2020,"Domaine Leflaive, Chevalier-Montrachet Grand Cru",Burgundy,2014,11/08/2021,10734012014,1073401
1040,04/08/2021,1386,68,940,100,446,18/03/2021,"Chateau Calon Segur 3eme Cru Classe, Saint-Estephe",Bordeaux,2000,09/08/2021,10074752000,1007475
3900,06/08/2021,4654,91,3822,78,832,20/06/2021,"Chateau Margaux Premier Cru Classe, Margaux",Bordeaux,2006,09/08/2021,10127812006,1012781
3800,06/08/2021,4338,124,3600,200,738,02/08/2021,"Chateau Margaux Premier Cru Classe, Margaux",Bordeaux,2014,09/08/2021,10127812014,1012781
1300,08/07/2021,1401,2,1200,100,201,06/03/2021,"Tignanello, Toscana",Tuscany,2007,09/08/2021,10953912007,1095391
2762,22/06/2021,2852,13,2402,360,450,27/11/2020,"Chateau Angelus Premier Grand Cru Classe A, Saint-Emilion Grand Cru",Bordeaux,2019,23/06/2021,10060452019,1006045
790,10/08/2021,870,15,801,-11,69,31/05/2021,"Chateau Calon Segur 3eme Cru Classe, Saint-Estephe",Bordeaux,2014,11/08/2021,10074752014,1007475
800,09/08/2021,776,25,682,118,94,15/09/2020,"Chateau Calon Segur 3eme Cru Classe, Saint-Estephe",Bordeaux,2013,11/08/2021,10074752013,1007475
686,06/08/2021,769,22,682,4,87,15/09/2020,"Chateau Calon Segur 3eme Cru Classe, Saint-Estephe",Bordeaux,2013,09/08/2021,10074752013,1007475
10620,06/08/2021,12032,46,9800,820,2232,11/06/2021,"Chateau Margaux Premier Cru Classe, Margaux",Bordeaux,2015,09/08/2021,10127812015,1012781
900,09/08/2021,1099,24,800,100,299,21/11/2019,"Chateau Calon Segur 3eme Cru Classe, Saint-Estephe",Bordeaux,2003,10/08/2021,10074752003,1007475
2762,22/06/2021,2917,13,2402,360,515,27/11/2020,"Chateau Angelus Premier Grand Cru Classe A, Saint-Emilion Grand Cru",Bordeaux,2019,29/06/2021,10060452019,1006045
1900,09/08/2021,2336,4,2190,-290,146,01/05/2021,"Gaja, Barbaresco",Piedmont,2004,10/08/2021,10996052004,1099605
430,06/08/2021,457,101,380,50,77,25/03/2021,"Tua Rita, Giusto di Notri, Toscana",Tuscany,2018,10/08/2021,11058072018,1105807
1584,09/08/2021,1670,4,1378,206,292,29/07/2020,"Tignanello, Toscana",Tuscany,2001,10/08/2021,10953912001,1095391
1326,09/08/2021,1406,5,1170,156,236,24/06/2021,"Tignanello, Toscana",Tuscany,2010,10/08/2021,10953912010,1095391
6400,09/08/2021,7608,61,6188,212,1420,16/07/2021,"Chateau Margaux Premier Cru Classe, Margaux",Bordeaux,2010,10/08/2021,10127812010,1012781
3800,09/08/2021,4544,54,3525,275,1019,18/06/2021,"Chateau Margaux Premier Cru Classe, Margaux",Bordeaux,2007,10/08/2021,10127812007,1012781
3935,09/08/2021,4659,40,4116,-181,543,25/02/2021,"Chateau Margaux Premier Cru Classe, Margaux",Bordeaux,2004,10/08/2021,10127812004,1012781
2820,21/06/2021,2854,12,2402,418,452,27/11/2020,"Chateau Angelus Premier Grand Cru Classe A, Saint-Emilion Grand Cru",Bordeaux,2019,22/06/2021,10060452019,1006045
370,10/08/2021,396,6,380,-10,16,10/08/2021,"Chateau Batailley 5eme Cru Classe, Pauillac",Bordeaux,2011,11/08/2021,10063222011,1006322
895,09/08/2021,955,8,781,114,174,16/11/2020,"Chateau Calon Segur 3eme Cru Classe, Saint-Estephe",Bordeaux,2008,10/08/2021,10074752008,1007475
4450,09/08/2021,4734,16,4400,50,334,29/09/2020,"Chateau Margaux Premier Cru Classe, Margaux",Bordeaux,2001,10/08/2021,10127812001,1012781
2820,18/06/2021,2848,9,2402,418,446,27/11/2020,"Chateau Angelus Premier Grand Cru Classe A, Saint-Emilion Grand Cru",Bordeaux,2019,19/06/2021,10060452019,1006045
2820,16/06/2021,2848,9,2402,418,446,27/11/2020,"Chateau Angelus Premier Grand Cru Classe A, Saint-Emilion Grand Cru",Bordeaux,2019,17/06/2021,10060452019,1006045
1090,09/08/2021,1136,8,952,138,184,04/08/2021,"Tignanello, Toscana",Tuscany,2013,10/08/2021,10953912013,1095391
800,09/08/2021,772,24,682,118,90,15/09/2020,"Chateau Calon Segur 3eme Cru Classe, Saint-Estephe",Bordeaux,2013,10/08/2021,10074752013,1007475
3900,09/08/2021,4446,23,3684,216,762,10/06/2020,"Chateau Margaux Premier Cru Classe, Margaux",Bordeaux,2002,10/08/2021,10127812002,1012781
400,10/08/2021,414,7,408,-8,6,14/07/2021,"Chateau Batailley 5eme Cru Classe, Pauillac",Bordeaux,2012,11/08/2021,10063222012,1006322
3750,05/08/2021,4282,45,3650,100,632,27/07/2021,"Chateau Margaux Premier Cru Classe, Margaux",Bordeaux,2012,08/08/2021,10127812012,1012781
895,06/08/2021,955,8,781,114,174,16/11/2020,"Chateau Calon Segur 3eme Cru Classe, Saint-Estephe",Bordeaux,2008,08/08/2021,10074752008,1007475
400,10/08/2021,414,7,408,-8,6,14/07/2021,"Chateau Batailley 5eme Cru Classe, Pauillac",Bordeaux,2012,11/08/2021,10063222012,1006322
6500,06/08/2021,7518,22,6400,100,1118,22/07/2021,"Chateau Margaux Premier Cru Classe, Margaux",Bordeaux,2005,08/08/2021,10127812005,1012781
3935,06/08/2021,4659,40,4116,-181,543,25/02/2021,"Chateau Margaux Premier Cru Classe, Margaux",Bordeaux,2004,08/08/2021,10127812004,1012781
320,10/08/2021,320,103,304,16,16,10/01/2021,"Chateau Batailley 5eme Cru Classe, Pauillac",Bordeaux,2013,11/08/2021,10063222013,1006322
2820,14/06/2021,2848,9,2402,418,446,27/11/2020,"Chateau Angelus Premier Grand Cru Classe A, Saint-Emilion Grand Cru",Bordeaux,2019,15/06/2021,10060452019,1006045
996,09/08/2021,1282,36,1026,-30,256,24/06/2021,"Chateau Calon Segur 3eme Cru Classe, Saint-Estephe",Bordeaux,2009,10/08/2021,10074752009,1007475
2820,10/06/2021,2848,9,2402,418,446,27/11/2020,"Chateau Angelus Premier Grand Cru Classe A, Saint-Emilion Grand Cru",Bordeaux,2019,11/06/2021,10060452019,1006045
3950,09/08/2021,4468,108,3780,170,688,23/07/2021,"Chateau Margaux Premier Cru Classe, Margaux",Bordeaux,2008,10/08/2021,10127812008,1012781
5100,09/08/2021,5703,19,4650,450,1053,21/06/2021,"Chateau Margaux Premier Cru Classe, Margaux",Bordeaux,2003,10/08/2021,10127812003,1012781
2820,08/06/2021,2848,9,2402,418,446,27/11/2020,"Chateau Angelus Premier Grand Cru Classe A, Saint-Emilion Grand Cru",Bordeaux,2019,09/06/2021,10060452019,1006045
820,09/08/2021,913,5,735,85,178,09/09/2020,"Chateau Calon Segur 3eme Cru Classe, Saint-Estephe",Bordeaux,2012,10/08/2021,10074752012,1007475
360,10/08/2021,372,70,360,0,12,14/07/2021,"Chateau Batailley 5eme Cru Classe, Pauillac",Bordeaux,2014,11/08/2021,10063222014,1006322
1900,09/08/2021,2336,4,2190,-290,146,01/05/2021,"Gaja, Barbaresco",Piedmont,2004,10/08/2021,10996052004,1099605
2820,03/06/2021,2848,9,2402,418,446,27/11/2020,"Chateau Angelus Premier Grand Cru Classe A, Saint-Emilion Grand Cru",Bordeaux,2019,04/06/2021,10060452019,1006045
3800,09/08/2021,4350,134,3600,200,750,02/08/2021,"Chateau Margaux Premier Cru Classe, Margaux",Bordeaux,2014,10/08/2021,10127812014,1012781
2820,31/05/2021,2848,9,2402,418,446,27/11/2020,"Chateau Angelus Premier Grand Cru Classe A, Saint-Emilion Grand Cru",Bordeaux,2019,02/06/2021,10060452019,1006045
1180,09/08/2021,1331,4,1140,40,191,21/07/2021,"Tignanello, Toscana",Tuscany,2009,10/08/2021,10953912009,1095391
1408,06/07/2021,1548,0,996,412,552,14/06/2019,"Tignanello, Toscana",Tuscany,2000,10/08/2021,10953912000,1095391
10620,09/08/2021,12019,47,9800,820,2219,11/06/2021,"Chateau Margaux Premier Cru Classe, Margaux",Bordeaux,2015,10/08/2021,10127812015,1012781
870,09/08/2021,950,10,705,165,245,01/02/2021,"Chateau Calon Segur 3eme Cru Classe, Saint-Estephe",Bordeaux,2002,10/08/2021,10074752002,1007475
907,09/08/2021,953,23,805,102,148,20/11/2019,"Chateau Calon Segur 3eme Cru Classe, Saint-Estephe",Bordeaux,2001,10/08/2021,10074752001,1007475
6500,09/08/2021,7537,24,6400,100,1137,22/07/2021,"Chateau Margaux Premier Cru Classe, Margaux",Bordeaux,2005,10/08/2021,10127812005,1012781
2816,18/05/2021,2848,9,2402,414,446,27/11/2020,"Chateau Angelus Premier Grand Cru Classe A, Saint-Emilion Grand Cru",Bordeaux,2019,19/05/2021,10060452019,1006045
790,09/08/2021,870,15,801,-11,69,31/05/2021,"Chateau Calon Segur 3eme Cru Classe, Saint-Estephe",Bordeaux,2014,10/08/2021,10074752014,1007475
2816,05/05/2021,2848,9,2402,414,446,27/11/2020,"Chateau Angelus Premier Grand Cru Classe A, Saint-Emilion Grand Cru",Bordeaux,2019,17/05/2021,10060452019,1006045
3800,06/08/2021,4535,56,3525,275,1010,18/06/2021,"Chateau Margaux Premier Cru Classe, Margaux",Bordeaux,2007,08/08/2021,10127812007,1012781
3900,06/08/2021,4446,22,3684,216,762,10/06/2020,"Chateau Margaux Premier Cru Classe, Margaux",Bordeaux,2002,08/08/2021,10127812002,1012781
2816,05/05/2021,2842,10,2402,414,440,27/11/2020,"Chateau Angelus Premier Grand Cru Classe A, Saint-Emilion Grand Cru",Bordeaux,2019,06/05/2021,10060452019,1006045
2816,05/05/2021,2847,10,2402,414,445,27/11/2020,"Chateau Angelus Premier Grand Cru Classe A, Saint-Emilion Grand Cru",Bordeaux,2019,08/05/2021,10060452019,1006045
